matchID,blueChampionKill,blueFirstBlood,blueDragonKill,blueRiftHeraldKill,blueTowerKill,blueTotalGold,blueMinionsKilled,blueJungleMinionsKilled,blueAvgPlayerLevel,blueWin,redChampionKill,redFirstBlood,redDragonKill,redRiftHeraldKill,redTowerKill,redTotalGold,redMinionsKilled,redJungleMinionsKilled,redAvgPlayerLevel,redWin,fullTimeMin,GoldDiff,ChampionKillsDiff,DragonKillsDiff,blueMinionsKilledTotal,redMinionsKilledTotal,MinionsKilledDiff
BR1_2720199652,6,True,0,1,0,17861,224,56,7.2,True,5,False,0,0,0,16001,203,48,7.0,False,27.613183333333332,1860,1,0,280,251,29
BR1_2723969778,5,True,0,1,0,17173,242,56,7.4,True,3,False,1,0,0,14985,198,64,7.2,False,28.830333333333332,2188,2,-1,298,262,36
BR1_2676109971,11,False,1,0,0,19168,186,64,7.4,True,7,True,0,0,0,16797,187,52,7.0,False,27.6315,2371,4,1,250,239,11
BR1_2675751392,3,False,0,1,0,14414,147,44,6.0,False,11,True,1,0,0,16548,135,50,6.8,True,25.629566666666665,-2134,-8,-1,191,185,6
BR1_2714719079,10,False,1,0,0,15559,139,48,6.8,True,3,True,0,0,0,12475,121,44,6.6,False,27.410633333333333,3084,7,1,187,165,22
BR1_2714656629,5,True,0,0,0,14036,133,40,6.4,False,6,False,1,0,0,14626,167,44,6.4,True,26.110466666666667,-590,-1,-1,173,211,-38
BR1_2714616558,4,True,0,0,0,15811,190,40,6.4,False,8,False,1,0,0,15317,105,52,6.6,True,25.80305,494,-4,-1,230,157,73
BR1_2690870654,7,True,1,0,0,17376,199,52,7.4,True,2,False,0,0,0,14539,172,52,6.8,False,28.684783333333332,2837,5,1,251,224,27
BR1_2730790868,3,False,0,0,0,15809,205,52,7.4,False,6,True,1,0,0,16895,223,64,7.2,True,29.551333333333332,-1086,-3,-1,257,287,-30
BR1_2722042087,7,False,0,0,0,16221,160,56,6.4,False,8,True,0,0,0,15959,158,36,6.6,True,25.4384,262,-1,0,216,194,22
BR1_2714379733,8,True,0,0,0,16022,153,46,6.6,True,9,False,0,0,0,17295,204,44,6.6,False,25.751,-1273,-1,0,199,248,-49
BR1_2713797419,5,False,1,0,0,14941,188,64,7.0,True,5,True,0,0,0,15203,147,52,6.8,False,27.337316666666666,-262,0,1,252,199,53
BR1_2712736710,10,False,0,0,0,18115,172,56,7.0,True,11,True,1,0,0,18063,158,43,6.8,False,29.93295,52,-1,-1,228,201,27
BR1_2672149533,3,False,0,0,0,14435,175,50,7.4,False,6,True,1,0,0,16272,218,35,7.4,True,27.688933333333335,-1837,-3,-1,225,253,-28
BR1_2710444988,8,True,0,0,0,16663,187,44,7.6,False,7,False,0,0,0,16611,175,52,7.6,True,29.048033333333333,52,1,0,231,227,4
BR1_2710383938,7,True,0,0,0,18123,196,47,7.4,False,7,False,1,1,0,17669,177,60,7.2,True,28.531233333333333,454,0,-1,243,237,6
BR1_2731603102,6,False,1,0,0,16131,165,55,7.2,False,15,True,0,0,0,21609,262,36,7.4,True,28.574916666666667,-5478,-9,1,220,298,-78
BR1_2708829763,3,False,0,0,0,15437,207,52,7.2,False,5,True,0,0,0,16535,197,68,7.2,True,29.977516666666666,-1098,-2,0,259,265,-6
BR1_2731064894,14,True,0,0,0,18403,171,32,6.4,True,9,False,0,0,0,15654,112,36,6.4,False,25.75015,2749,5,0,203,148,55
BR1_2731051168,5,True,0,0,0,15810,155,52,6.8,True,7,False,0,1,0,16400,204,40,7.2,False,29.332466666666665,-590,-2,0,207,244,-37
BR1_2710271589,8,False,0,0,0,16452,156,51,7.0,True,8,True,1,1,0,17147,175,56,6.8,False,27.54695,-695,0,-1,207,231,-24
BR1_2710255004,5,False,0,0,0,15961,168,52,7.4,False,6,True,1,0,0,16310,196,52,7.4,True,28.8465,-349,-1,-1,220,248,-28
BR1_2710178588,4,False,0,0,0,12837,117,32,6.2,False,8,True,0,0,0,16155,186,52,7.0,True,25.009033333333335,-3318,-4,0,149,238,-89
BR1_2707176533,4,False,1,0,0,13501,135,46,6.4,True,4,True,0,0,0,13913,134,56,6.6,False,27.19205,-412,0,1,181,190,-9
BR1_2675305731,6,False,0,0,0,14599,167,52,6.6,False,10,True,1,0,0,18003,171,56,7.0,True,27.32265,-3404,-4,-1,219,227,-8
BR1_2675012376,8,True,0,0,0,16405,138,54,6.4,False,10,False,1,0,0,16679,145,38,6.4,True,27.010383333333333,-274,-2,-1,192,183,9
BR1_2731629873,4,False,0,0,0,15926,214,60,7.4,False,5,True,1,1,0,16721,234,60,7.6,True,29.195516666666666,-795,-1,-1,274,294,-20
BR1_2731311468,7,True,1,1,0,17050,195,47,6.6,True,1,False,0,0,0,13066,160,64,6.8,False,26.300383333333333,3984,6,1,242,224,18
BR1_2731289828,9,True,1,0,0,19328,231,62,7.8,True,3,False,0,1,0,15195,174,56,7.0,False,27.7494,4133,6,1,293,230,63
BR1_2724403174,3,False,0,0,0,14269,161,40,6.4,False,12,True,1,0,0,19768,220,52,7.2,True,28.845116666666666,-5499,-9,-1,201,272,-71
BR1_2696390946,5,True,0,1,0,16247,174,56,7.0,False,10,False,1,0,0,17855,201,52,7.2,True,29.46945,-1608,-5,-1,230,253,-23
BR1_2731423851,9,True,0,1,0,18591,192,61,7.6,False,5,False,1,0,0,16093,193,60,7.2,True,28.376483333333333,2498,4,-1,253,253,0
BR1_2730834857,5,True,0,0,0,15582,157,34,6.6,False,7,False,0,0,0,17286,192,68,7.0,True,28.96345,-1704,-2,0,191,260,-69
BR1_2730824341,8,True,0,0,0,14907,114,32,6.2,True,4,False,0,0,0,14168,158,48,6.6,False,25.139666666666667,739,4,0,146,206,-60
BR1_2675522552,7,False,0,0,0,16396,183,40,7.0,False,10,True,1,1,0,18087,183,62,7.6,True,28.638583333333333,-1691,-3,-1,223,245,-22
BR1_2727958602,5,True,1,0,0,16680,227,48,7.2,False,10,False,0,0,0,19094,252,48,7.2,True,29.118916666666667,-2414,-5,1,275,300,-25
BR1_2727453306,5,False,1,1,0,15106,161,40,7.0,False,9,True,0,0,0,17973,174,64,7.4,True,28.285716666666666,-2867,-4,1,201,238,-37
BR1_2716052117,8,True,1,1,0,16916,189,52,7.0,True,3,False,0,0,0,13519,188,48,6.4,False,27.392083333333332,3397,5,1,241,236,5
BR1_2731181628,6,False,1,0,0,17620,206,72,7.2,False,9,True,0,0,0,18855,219,48,7.6,True,27.558816666666665,-1235,-3,1,278,267,11
BR1_2728767165,10,False,0,0,0,15414,100,51,6.4,True,8,True,0,0,0,15711,154,36,6.6,False,26.54435,-297,2,0,151,190,-39
BR1_2730719580,4,False,1,0,0,14779,219,52,7.0,True,7,True,0,1,0,17248,229,48,7.0,False,26.672083333333333,-2469,-3,1,271,277,-6
BR1_2730687089,0,False,0,1,0,13177,189,52,6.8,True,5,True,0,0,0,15676,217,56,7.0,False,26.0141,-2499,-5,0,241,273,-32
BR1_2729650701,9,True,1,1,0,17441,190,56,7.0,True,7,False,0,0,0,16121,190,36,6.8,False,25.6913,1320,2,1,246,226,20
BR1_2722363827,5,False,1,1,0,14785,139,48,6.8,False,8,True,0,0,0,16741,159,64,7.2,True,28.973083333333335,-1956,-3,1,187,223,-36
BR1_2718093496,8,False,0,0,0,16013,165,60,6.8,True,5,True,1,0,0,13730,133,36,6.6,False,26.6021,2283,3,-1,225,169,56
BR1_2718064682,6,True,0,0,0,17308,203,36,6.8,True,2,False,0,0,0,13581,150,68,6.0,False,25.659683333333334,3727,4,0,239,218,21
BR1_2696300525,7,False,1,0,0,16823,192,44,6.6,False,7,True,0,0,0,15544,170,40,6.8,True,27.194316666666666,1279,0,1,236,210,26
BR1_2727609893,10,True,1,0,0,16891,200,46,6.8,True,1,False,0,0,0,12520,162,48,6.8,False,27.20703333333333,4371,9,1,246,210,36
BR1_2726175661,5,True,0,0,0,14245,131,60,6.0,True,7,False,0,1,0,15156,135,52,6.6,False,26.91105,-911,-2,0,191,187,4
BR1_2722401552,10,True,1,0,0,16125,143,36,6.2,False,9,False,0,1,0,17753,158,28,6.4,True,25.848566666666667,-1628,1,1,179,186,-7
BR1_2722373980,7,False,0,0,0,15242,166,58,6.4,True,5,True,0,0,0,15383,171,29,6.2,False,25.81255,-141,2,0,224,200,24
BR1_2666671359,2,False,1,1,0,14074,179,56,6.6,True,5,True,0,0,0,14200,143,20,5.6,False,26.93845,-126,-3,1,235,163,72
BR1_2722132365,9,True,0,0,0,15928,190,36,6.6,False,3,False,1,1,0,15076,196,40,6.8,True,27.061316666666666,852,6,-1,226,236,-10
BR1_2731334975,8,True,0,0,0,14937,180,50,6.8,False,9,False,1,0,0,16854,141,64,6.6,True,26.542983333333332,-1917,-1,-1,230,205,25
BR1_2731602254,9,True,1,0,1,18163,168,48,7.2,False,8,False,0,1,1,19255,204,60,7.2,True,29.998316666666668,-1092,1,1,216,264,-48
BR1_2731200341,7,False,0,0,0,16238,160,52,6.8,False,8,True,1,0,0,16762,150,40,6.6,True,29.61938333333333,-524,-1,-1,212,190,22
BR1_2730643910,17,True,1,1,0,20414,149,56,7.0,True,6,False,0,0,0,15731,135,44,6.2,False,29.140016666666668,4683,11,1,205,179,26
BR1_2676525776,10,True,0,0,0,17787,193,39,7.2,True,3,False,0,0,0,15208,185,41,7.4,False,28.761233333333333,2579,7,0,232,226,6
BR1_2676483434,13,False,1,0,0,19597,152,68,7.4,True,9,True,0,0,0,19640,223,36,7.4,False,29.542533333333335,-43,4,1,220,259,-39
BR1_2676179651,0,False,0,0,0,11725,125,55,6.2,False,4,True,1,0,0,15839,201,50,7.0,True,26.608633333333334,-4114,-4,-1,180,251,-71
BR1_2693415792,3,True,1,0,0,14133,176,48,6.6,True,2,False,0,0,0,13134,165,48,6.6,False,26.169083333333333,999,1,1,224,213,11
BR1_2696442900,9,False,0,0,0,19165,198,48,7.2,True,11,True,1,1,0,19370,188,68,7.0,False,28.514883333333334,-205,-2,-1,246,256,-10
BR1_2691273877,5,True,0,0,0,15895,174,56,7.4,False,6,False,1,1,0,16982,193,56,7.2,True,28.150116666666666,-1087,-1,-1,230,249,-19
BR1_2731286705,6,False,1,0,1,15812,149,68,7.0,False,3,True,0,1,0,16000,189,40,6.8,True,25.074583333333333,-188,3,1,217,229,-12
BR1_2726947773,8,False,1,0,0,15942,182,48,6.8,True,2,True,0,0,0,13107,175,40,6.4,False,26.504783333333332,2835,6,1,230,215,15
BR1_2726917168,3,False,0,0,0,14490,176,60,7.2,False,2,True,1,1,0,16343,219,68,7.4,True,27.6179,-1853,1,-1,236,287,-51
BR1_2709133586,6,False,1,0,0,15420,194,28,7.0,False,10,True,0,1,0,18341,173,60,6.8,True,29.067116666666667,-2921,-4,1,222,233,-11
BR1_2690321832,15,True,0,0,0,19493,189,31,7.0,False,9,False,0,1,0,16340,173,67,6.8,True,28.6753,3153,6,0,220,240,-20
BR1_2695689013,7,True,0,1,0,16815,196,56,7.2,True,2,False,1,0,0,13705,146,72,6.8,False,28.335533333333334,3110,5,-1,252,218,34
BR1_2730669107,6,True,0,0,0,15672,189,48,6.8,False,5,False,1,0,0,15963,176,56,7.0,True,28.5029,-291,1,-1,237,232,5
BR1_2730607739,13,True,0,0,0,18955,175,59,7.0,False,5,False,0,0,0,14776,153,64,6.4,True,26.9579,4179,8,0,234,217,17
BR1_2702849161,6,False,1,1,0,16489,189,48,6.8,False,4,True,0,0,0,15523,178,56,7.4,True,29.147166666666667,966,2,1,237,234,3
BR1_2729070586,9,True,1,0,0,16444,179,40,6.4,True,5,False,0,1,0,15110,167,44,6.4,False,27.49041666666667,1334,4,1,219,211,8
BR1_2730778192,11,True,0,1,0,17775,149,40,7.2,False,10,False,0,0,0,18375,178,40,7.2,True,29.706633333333333,-600,1,0,189,218,-29
BR1_2715507610,2,False,0,0,0,10790,71,35,4.8,False,4,True,0,0,0,15147,193,32,6.4,True,26.541366666666665,-4357,-2,0,106,225,-119
BR1_2682395901,4,True,0,0,0,13767,173,40,6.8,False,5,False,0,0,0,14971,163,56,7.0,True,25.999416666666665,-1204,-1,0,213,219,-6
BR1_2731341939,9,False,1,1,0,17893,167,52,7.2,True,7,True,0,0,0,17368,187,39,6.8,False,28.33325,525,2,1,219,226,-7
BR1_2721036625,7,True,1,0,0,15892,183,59,6.8,True,8,False,0,0,0,17053,185,64,7.4,False,28.002566666666667,-1161,-1,1,242,249,-7
BR1_2718103677,7,True,1,0,0,15420,151,52,6.4,False,9,False,0,0,0,16267,162,52,6.6,True,25.7772,-847,-2,1,203,214,-11
BR1_2727348268,4,False,0,0,0,15155,202,38,6.8,False,4,True,0,1,0,16862,226,76,7.4,True,29.255666666666666,-1707,0,0,240,302,-62
BR1_2688651375,6,False,0,0,0,16862,186,36,6.8,True,9,True,0,1,0,18202,200,76,7.4,False,28.181183333333333,-1340,-3,0,222,276,-54
BR1_2688388626,4,False,0,0,0,13548,144,44,6.8,False,6,True,1,0,0,15371,187,72,6.8,True,26.01955,-1823,-2,-1,188,259,-71
BR1_2702212861,8,False,1,0,0,17607,197,68,7.2,True,5,True,0,1,0,16677,186,52,6.8,False,28.32095,930,3,1,265,238,27
BR1_2694139320,3,True,0,1,0,15784,201,68,7.4,True,4,False,1,0,0,16867,235,56,7.0,False,28.6702,-1083,-1,-1,269,291,-22
BR1_2694113334,6,True,1,0,0,15616,185,56,6.8,True,3,False,0,0,0,15908,180,64,7.4,False,27.645416666666666,-292,3,1,241,244,-3
BR1_2728762805,10,True,0,0,0,17837,185,52,7.0,True,10,False,1,1,0,18340,190,60,7.2,False,28.858316666666667,-503,0,-1,237,250,-13
BR1_2731605223,12,False,1,0,0,20236,170,36,7.0,True,4,True,0,0,0,14848,172,56,6.6,False,27.57495,5388,8,1,206,228,-22
BR1_2725459982,4,True,0,0,0,14839,167,48,7.0,False,9,False,1,1,0,18223,198,80,7.6,True,28.56945,-3384,-5,-1,215,278,-63
BR1_2707656329,3,False,1,0,0,13452,148,40,6.2,False,12,True,0,1,0,17893,184,40,6.6,True,25.862066666666667,-4441,-9,1,188,224,-36
BR1_2666204743,9,True,1,1,0,18366,198,64,7.4,True,2,False,0,0,0,14011,138,52,6.4,False,27.695966666666667,4355,7,1,262,190,72
BR1_2731364281,10,False,1,1,0,18995,200,60,7.2,True,5,True,0,0,0,14941,144,49,6.6,False,27.57265,4054,5,1,260,193,67
BR1_2682704850,7,True,1,0,0,17100,196,55,7.4,False,9,False,0,0,0,18146,176,55,7.2,True,29.1257,-1046,-2,1,251,231,20
BR1_2704876254,6,True,0,1,0,16402,182,56,7.4,True,2,False,0,0,0,15460,183,56,7.4,False,28.1108,942,4,0,238,239,-1
BR1_2704867910,14,False,1,0,0,21054,180,72,7.4,True,10,True,0,0,0,17714,189,44,6.6,False,28.84176666666667,3340,4,1,252,233,19
BR1_2704666671,5,False,0,0,0,15343,166,72,7.2,True,6,True,0,0,0,17083,206,48,7.2,False,28.561116666666667,-1740,-1,0,238,254,-16
BR1_2668408707,11,True,0,0,0,19848,199,52,7.4,False,9,False,1,0,0,18853,220,56,7.6,True,27.7392,995,2,-1,251,276,-25
BR1_2668170281,4,True,0,0,0,13502,149,28,6.4,True,3,False,1,0,0,12425,123,56,6.0,False,26.06735,1077,1,-1,177,179,-2
BR1_2667991348,8,True,0,0,0,16456,186,62,6.8,False,3,False,0,0,0,14016,177,36,6.6,True,25.673883333333333,2440,5,0,248,213,35
BR1_2676640275,10,False,1,1,0,18277,175,62,7.4,True,9,True,0,0,0,17274,155,53,7.2,False,29.0857,1003,1,1,237,208,29
BR1_2729953853,7,False,0,0,0,17338,224,44,7.0,False,7,True,1,0,0,16151,170,56,6.6,True,25.693966666666668,1187,0,-1,268,226,42
BR1_2708481258,3,False,0,1,0,15282,181,50,7.2,True,9,True,1,0,0,18078,220,60,7.6,False,28.3875,-2796,-6,-1,231,280,-49
BR1_2698734335,9,True,1,0,1,19565,245,60,7.4,True,3,False,0,1,0,16398,171,72,6.8,False,29.3109,3167,6,1,305,243,62
BR1_2709138492,9,True,1,0,0,16584,171,54,7.4,True,10,False,0,0,0,18439,198,48,7.2,False,29.552016666666667,-1855,-1,1,225,246,-21
BR1_2708624090,2,False,0,0,0,14928,203,46,7.2,False,6,True,1,0,0,16056,172,66,7.0,True,29.104933333333335,-1128,-4,-1,249,238,11
BR1_2669552982,6,False,0,0,0,16744,214,48,7.2,False,8,True,1,1,0,20019,259,60,8.0,True,27.8325,-3275,-2,-1,262,319,-57
BR1_2703298220,2,False,0,1,0,15805,206,60,7.4,True,6,True,1,0,0,16732,203,68,7.4,False,29.057033333333333,-927,-4,-1,266,271,-5
BR1_2701248826,6,True,0,0,0,15928,152,44,7.6,False,9,False,0,0,0,18115,193,60,7.8,True,29.380416666666665,-2187,-3,0,196,253,-57
BR1_2721448346,16,True,0,0,0,20306,190,48,7.0,True,12,False,0,0,0,18445,158,48,7.0,False,28.56886666666667,1861,4,0,238,206,32
BR1_2717019128,3,False,1,0,0,14339,180,56,6.6,False,9,True,0,0,0,17626,204,60,7.2,True,27.3874,-3287,-6,1,236,264,-28
BR1_2716482748,5,True,1,0,0,14819,156,36,6.4,True,2,False,0,0,0,13511,181,48,6.8,False,25.701516666666667,1308,3,1,192,229,-37
BR1_2725487961,10,True,1,1,0,18796,199,68,7.6,True,6,False,0,0,0,16023,172,40,6.8,False,28.393333333333334,2773,4,1,267,212,55
BR1_2705722374,10,False,0,0,0,16413,161,36,6.4,False,6,True,0,0,0,14388,145,36,6.2,True,25.194233333333333,2025,4,0,197,181,16
BR1_2701915104,8,False,0,0,0,16243,185,52,6.8,False,8,True,1,0,0,16672,198,55,7.0,True,26.1538,-429,0,-1,237,253,-16
BR1_2672183785,6,False,0,0,0,16550,194,54,7.2,False,11,True,1,0,0,18080,172,48,7.4,True,28.65748333333333,-1530,-5,-1,248,220,28
BR1_2667870554,4,True,0,0,0,14085,176,44,6.8,False,4,False,0,1,0,15569,207,60,7.0,True,26.5394,-1484,0,0,220,267,-47
BR1_2684435610,10,False,1,0,0,17448,160,60,6.8,True,7,True,0,0,0,14290,127,36,6.4,False,27.082366666666665,3158,3,1,220,163,57
BR1_2681734635,1,False,0,1,0,13129,186,50,6.8,False,2,True,1,0,0,13463,152,66,6.6,True,26.704866666666668,-334,-1,-1,236,218,18
BR1_2679032073,5,True,0,0,0,14130,155,44,7.2,False,8,False,1,0,0,16703,171,44,7.2,True,29.70845,-2573,-3,-1,199,215,-16
BR1_2724216591,7,False,0,0,0,17158,195,52,7.0,True,8,True,1,0,0,16283,159,60,6.8,False,25.36628333333333,875,-1,-1,247,219,28
BR1_2724195651,11,True,1,0,0,20431,222,59,7.4,True,6,False,0,0,0,16885,145,56,6.8,False,28.095966666666666,3546,5,1,281,201,80
BR1_2726983173,6,False,0,0,0,14688,120,52,6.6,False,5,True,0,0,0,14839,181,40,6.8,True,25.2783,-151,1,0,172,221,-49
BR1_2726901539,3,False,0,0,0,15590,182,56,6.8,True,5,True,1,0,0,14586,139,68,7.2,False,29.857583333333334,1004,-2,-1,238,207,31
BR1_2692013810,7,False,0,0,0,15980,176,48,6.8,False,10,True,1,0,0,17137,174,36,6.8,True,26.142866666666666,-1157,-3,-1,224,210,14
BR1_2687867597,7,False,1,0,0,16705,158,64,7.4,True,9,True,0,1,0,18447,177,60,7.2,False,29.878583333333335,-1742,-2,1,222,237,-15
BR1_2724888505,4,False,1,0,0,14069,160,64,6.4,False,5,True,0,1,0,15097,153,44,6.6,True,25.819683333333334,-1028,-1,1,224,197,27
BR1_2724870171,4,False,0,0,0,14444,177,56,6.4,False,8,True,0,0,0,17301,224,52,7.0,True,25.321733333333334,-2857,-4,0,233,276,-43
BR1_2714155109,6,True,0,1,0,17779,209,60,7.2,True,1,False,0,0,0,14865,222,52,7.2,False,29.665333333333333,2914,5,0,269,274,-5
BR1_2730765826,10,True,1,0,0,17953,195,52,7.2,True,4,False,0,1,0,14308,151,40,6.8,False,29.16818333333333,3645,6,1,247,191,56
BR1_2730708752,10,False,0,0,1,17189,171,52,7.2,False,5,True,0,0,0,17658,173,72,7.2,True,28.8758,-469,5,0,223,245,-22
BR1_2731634634,3,True,0,0,0,15548,200,58,6.8,False,6,False,1,0,0,18549,224,56,7.2,True,29.448766666666668,-3001,-3,-1,258,280,-22
BR1_2682992553,4,True,0,0,0,15393,172,44,7.0,True,8,False,0,0,0,17744,183,64,7.2,False,29.85865,-2351,-4,0,216,247,-31
BR1_2700277402,6,False,0,0,0,15279,146,44,6.8,True,8,True,0,0,0,15915,163,44,6.4,False,26.5247,-636,-2,0,190,207,-17
BR1_2731158176,8,True,0,0,0,17485,222,48,7.2,False,10,False,0,1,0,19882,225,56,7.6,True,28.148483333333335,-2397,-2,0,270,281,-11
BR1_2684807814,6,True,0,0,0,16874,180,44,6.6,True,8,False,1,0,0,17753,182,68,7.0,False,27.722166666666666,-879,-2,-1,224,250,-26
BR1_2684669375,9,False,1,0,0,19174,186,48,7.6,False,12,True,0,0,0,19762,187,60,7.4,True,29.093016666666667,-588,-3,1,234,247,-13
BR1_2715184991,3,False,1,0,0,13500,152,64,6.6,False,3,True,0,1,0,14468,188,56,6.8,True,27.233883333333335,-968,0,1,216,244,-28
BR1_2730626851,11,False,1,0,0,20274,221,52,7.6,True,5,True,0,1,0,15404,155,56,6.8,False,28.933433333333333,4870,6,1,273,211,62
BR1_2713905979,6,True,0,1,0,14716,151,44,6.6,False,9,False,1,0,0,15822,130,44,6.4,True,25.307483333333334,-1106,-3,-1,195,174,21
BR1_2713842448,4,False,0,0,0,16101,179,52,6.4,False,16,True,1,0,0,18739,128,52,5.8,True,29.991066666666665,-2638,-12,-1,231,180,51
BR1_2726276950,8,True,1,0,0,17820,214,53,7.6,True,3,False,0,1,0,15822,162,68,6.8,False,27.741766666666667,1998,5,1,267,230,37
BR1_2726226455,6,True,1,1,0,16486,164,64,7.6,True,2,False,0,0,0,13733,176,44,6.8,False,27.686416666666666,2753,4,1,228,220,8
BR1_2689473999,5,True,0,0,0,14962,182,40,6.8,True,4,False,0,0,0,14335,175,56,6.6,False,27.07115,627,1,0,222,231,-9
BR1_2689151187,12,False,1,0,0,19422,167,52,7.2,True,9,True,0,0,0,17148,158,44,6.6,False,28.018983333333335,2274,3,1,219,202,17
BR1_2689121108,10,True,1,0,0,16955,136,59,7.0,True,4,False,0,0,0,14673,131,48,6.6,False,29.023716666666665,2282,6,1,195,179,16
BR1_2731480171,15,False,0,0,0,19763,162,64,7.4,True,8,True,1,1,0,17657,179,52,6.8,False,29.7095,2106,7,-1,226,231,-5
BR1_2719303040,4,False,0,1,0,14644,160,48,6.6,False,7,True,1,0,0,15503,183,60,6.6,True,25.551883333333333,-859,-3,-1,208,243,-35
BR1_2719270226,4,False,0,1,0,14977,171,42,7.0,False,8,True,1,0,0,17104,195,45,7.0,True,28.76405,-2127,-4,-1,213,240,-27
BR1_2730918601,3,False,0,1,0,13730,139,56,6.2,False,8,True,0,0,0,16294,214,42,6.8,True,27.081316666666666,-2564,-5,0,195,256,-61
BR1_2726235385,9,True,0,0,0,17424,200,36,7.0,True,7,False,0,0,0,16077,165,56,7.2,False,28.378383333333332,1347,2,0,236,221,15
BR1_2726212073,7,False,1,1,0,16772,168,52,7.4,True,3,True,0,0,0,15893,215,52,7.0,False,29.741716666666665,879,4,1,220,267,-47
BR1_2662058596,11,True,1,0,0,18349,195,36,7.4,True,5,False,0,0,0,15231,199,52,7.0,False,28.257316666666668,3118,6,1,231,251,-20
BR1_2731430286,6,False,0,0,0,14697,175,28,6.4,False,8,True,1,0,0,16157,141,48,6.6,True,26.636433333333333,-1460,-2,-1,203,189,14
BR1_2731322597,2,True,0,0,0,13372,170,40,6.4,False,6,False,1,0,0,14369,135,52,6.4,True,25.989233333333335,-997,-4,-1,210,187,23
BR1_2730580789,11,True,0,0,0,18293,194,40,7.0,True,8,False,1,1,0,18763,203,52,7.4,False,28.550933333333333,-470,3,-1,234,255,-21
BR1_2684387427,6,False,1,0,0,14724,176,52,7.0,True,5,True,0,0,0,15072,171,44,6.8,False,25.093433333333333,-348,1,1,228,215,13
BR1_2683238539,11,True,0,0,0,17349,165,44,7.6,True,3,False,0,0,0,14420,181,36,7.0,False,26.11425,2929,8,0,209,217,-8
BR1_2662929530,11,True,0,0,0,18144,181,52,7.2,True,3,False,0,0,0,13601,146,52,6.4,False,27.104516666666665,4543,8,0,233,198,35
BR1_2688183417,6,True,1,0,0,16869,218,62,7.0,False,3,False,0,0,0,16613,241,60,7.8,True,29.228233333333332,256,3,1,280,301,-21
BR1_2729579025,11,False,1,0,0,17922,161,55,7.2,False,11,True,0,1,0,19381,179,48,7.2,True,29.903,-1459,0,1,216,227,-11
BR1_2676839515,12,True,1,0,0,18469,193,40,7.0,True,6,False,0,0,0,16102,188,36,7.2,False,29.391183333333334,2367,6,1,233,224,9
BR1_2676214340,4,True,0,0,0,14840,189,44,7.0,False,9,False,0,1,0,17881,199,60,7.6,True,28.181,-3041,-5,0,233,259,-26
BR1_2727207714,5,False,1,0,0,16458,197,48,6.8,True,3,True,0,1,0,16123,197,68,7.2,False,27.62995,335,2,1,245,265,-20
BR1_2672580306,4,False,0,0,0,16162,222,61,7.6,False,3,True,0,0,0,14838,189,54,7.2,True,29.096266666666665,1324,1,0,283,243,40
BR1_2691886526,6,True,0,0,0,15294,146,60,7.0,True,4,False,0,0,0,15187,169,32,7.0,False,29.76065,107,2,0,206,201,5
BR1_2731499160,5,False,0,0,0,14069,169,48,6.2,False,6,True,1,0,0,16155,180,52,6.4,True,26.068166666666666,-2086,-1,-1,217,232,-15
BR1_2731099500,8,True,1,1,0,16485,167,48,7.0,True,2,False,0,0,0,14752,196,59,7.2,False,28.65865,1733,6,1,215,255,-40
BR1_2730659863,8,False,0,1,0,17746,203,56,7.4,False,6,True,1,0,0,17188,159,60,7.2,True,28.664833333333334,558,2,-1,259,219,40
BR1_2730859410,5,False,1,1,0,15704,165,52,6.6,True,6,True,0,0,0,15124,149,48,6.6,False,27.137216666666667,580,-1,1,217,197,20
BR1_2709275766,5,True,1,0,0,16211,193,60,7.2,False,9,False,0,1,0,18827,196,56,7.4,True,29.44065,-2616,-4,1,253,252,1
BR1_2681775602,7,True,1,0,0,16203,164,52,7.0,True,5,False,0,0,0,14534,157,56,6.8,False,25.255233333333333,1669,2,1,216,213,3
BR1_2681753022,9,True,0,1,0,19133,212,56,7.4,True,7,False,1,0,0,17379,217,56,7.4,False,27.656783333333333,1754,2,-1,268,273,-5
BR1_2720323661,6,True,0,0,0,15720,149,56,6.2,False,9,False,1,1,0,16193,184,60,7.2,True,26.411133333333332,-473,-3,-1,205,244,-39
BR1_2705019306,2,False,0,0,0,13736,149,52,6.4,False,15,True,1,1,1,21611,196,56,7.4,True,27.567616666666666,-7875,-13,-1,201,252,-51
BR1_2704978564,9,True,1,0,0,17484,107,72,6.6,False,9,False,0,1,0,17334,154,46,7.0,True,29.6887,150,0,1,179,200,-21
BR1_2704481800,2,False,0,0,0,11402,102,40,6.0,False,6,True,0,0,0,15509,173,48,6.8,True,26.5965,-4107,-4,0,142,221,-79
BR1_2726864885,6,True,0,0,0,16384,190,56,6.8,False,8,False,1,0,0,16960,167,60,6.6,True,25.32515,-576,-2,-1,246,227,19
BR1_2726849326,2,True,0,0,0,12552,134,44,5.6,False,4,False,0,0,0,14896,191,32,6.8,True,25.960616666666667,-2344,-2,0,178,223,-45
BR1_2719185855,6,False,0,0,0,16003,175,39,7.2,False,6,True,1,1,0,16919,214,57,7.2,True,29.8862,-916,0,-1,214,271,-57
BR1_2719173540,5,True,1,1,0,16210,181,64,7.0,True,4,False,0,0,0,13970,147,48,6.8,False,25.1477,2240,1,1,245,195,50
BR1_2682416551,7,True,1,0,0,15706,175,52,7.0,True,1,False,0,0,0,13089,174,52,6.8,False,27.0083,2617,6,1,227,226,1
BR1_2688794898,9,False,1,1,0,16842,149,40,6.8,True,7,True,0,0,0,17200,186,60,7.0,False,29.8667,-358,2,1,189,246,-57
BR1_2662564433,4,True,0,0,0,14601,180,48,6.4,False,10,False,1,1,0,19178,201,60,7.4,True,26.0148,-4577,-6,-1,228,261,-33
BR1_2661900378,5,True,0,0,0,15415,135,50,7.2,False,6,False,1,0,0,17212,206,74,7.4,True,29.880183333333335,-1797,-1,-1,185,280,-95
BR1_2677630756,6,True,1,0,0,14823,133,48,6.4,False,1,False,0,0,0,12961,160,36,6.4,True,26.661033333333332,1862,5,1,181,196,-15
BR1_2680283085,6,True,1,0,0,17518,204,60,7.4,True,3,False,0,1,0,14482,175,56,7.2,False,27.663416666666667,3036,3,1,264,231,33
BR1_2684546070,4,False,0,0,0,13247,146,31,6.2,False,8,True,1,1,0,17292,150,40,6.4,True,27.2167,-4045,-4,-1,177,190,-13
BR1_2723208596,14,True,0,1,0,20745,205,56,7.4,True,9,False,0,0,0,16837,152,44,7.0,False,29.561183333333332,3908,5,0,261,196,65
BR1_2710816187,7,False,1,1,0,16514,209,64,7.0,True,4,True,0,0,0,15020,161,56,7.0,False,25.916716666666666,1494,3,1,273,217,56
BR1_2730300346,4,False,0,0,0,15175,196,40,6.6,False,8,True,1,0,0,16789,160,76,6.6,True,25.61775,-1614,-4,-1,236,236,0
BR1_2689378693,6,True,0,0,0,14687,166,40,6.4,False,7,False,0,0,0,16503,191,60,6.8,True,27.414833333333334,-1816,-1,0,206,251,-45
BR1_2689349610,2,False,1,0,0,12158,129,56,6.0,False,13,True,0,0,0,18608,175,42,7.0,True,25.575633333333332,-6450,-11,1,185,217,-32
BR1_2683556835,8,False,1,0,0,17700,189,72,7.6,False,10,True,0,0,0,18019,212,52,7.6,True,29.518366666666665,-319,-2,1,261,264,-3
BR1_2710903504,9,True,0,1,0,18737,181,64,7.4,True,2,False,1,0,0,14380,206,51,7.0,False,28.450766666666667,4357,7,-1,245,257,-12
BR1_2706290545,10,True,1,1,0,16849,157,56,6.6,True,7,False,0,0,0,15003,175,40,6.6,False,27.045583333333333,1846,3,1,213,215,-2
BR1_2706259496,10,False,1,1,0,18414,194,48,6.8,True,4,True,0,0,0,16240,208,48,6.8,False,29.704216666666667,2174,6,1,242,256,-14
BR1_2706231837,5,False,0,0,0,15730,183,52,7.0,False,12,True,1,1,0,18763,180,56,7.8,True,28.494616666666666,-3033,-7,-1,235,236,-1
BR1_2700044608,1,False,0,0,0,12468,154,44,6.4,False,3,True,0,0,0,15114,194,48,6.8,True,25.9714,-2646,-2,0,198,242,-44
BR1_2697556085,9,True,0,0,0,16766,181,36,6.4,False,9,False,1,0,0,15909,159,40,6.4,True,25.8109,857,0,-1,217,199,18
BR1_2727046680,2,True,1,0,0,14365,184,44,7.0,True,3,False,0,1,0,16317,228,52,7.6,False,29.125916666666665,-1952,-1,1,228,280,-52
BR1_2731456231,6,True,0,1,0,17568,204,56,7.4,True,7,False,0,0,0,15639,179,56,7.0,False,27.634866666666667,1929,-1,0,260,235,25
BR1_2730938783,14,True,1,1,0,19960,175,56,7.2,False,12,False,0,0,0,20086,193,52,7.4,True,28.728633333333335,-126,2,1,231,245,-14
BR1_2699304792,8,False,0,0,0,15924,178,55,6.6,True,10,True,1,0,0,16504,162,44,6.6,False,25.836833333333335,-580,-2,-1,233,206,27
BR1_2669041684,6,True,0,0,0,14960,190,32,6.6,False,12,False,1,0,0,18600,165,60,7.0,True,27.124316666666665,-3640,-6,-1,222,225,-3
BR1_2709436416,4,True,0,0,0,13563,162,40,6.2,False,5,False,0,1,0,13817,143,44,6.4,True,25.029333333333334,-254,-1,0,202,187,15
BR1_2731565086,7,False,1,0,0,15569,155,44,6.6,False,6,True,0,0,0,15216,162,48,6.4,True,25.625366666666668,353,1,1,199,210,-11
BR1_2731178898,11,True,0,0,0,18649,191,52,6.4,True,5,False,1,0,0,15129,167,56,6.2,False,26.910016666666667,3520,6,-1,243,223,20
BR1_2730685025,5,False,0,0,0,16402,196,52,7.0,False,10,True,1,1,0,18703,183,68,6.8,True,29.315516666666667,-2301,-5,-1,248,251,-3
BR1_2669473659,7,True,0,0,0,16008,167,52,6.8,False,6,False,1,1,0,16663,206,60,7.2,True,25.474816666666666,-655,1,-1,219,266,-47
BR1_2669448206,3,False,0,0,0,16891,251,52,7.4,True,2,True,1,0,0,15525,244,72,7.6,False,29.260783333333332,1366,1,-1,303,316,-13
BR1_2668835784,8,True,0,0,0,16366,168,36,6.6,False,8,False,0,1,0,15758,174,36,6.8,True,25.55955,608,0,0,204,210,-6
BR1_2668803180,6,True,1,0,0,17427,227,60,7.4,True,2,False,0,0,0,16043,213,56,7.4,False,28.6148,1384,4,1,287,269,18
BR1_2720648808,9,True,1,0,0,15963,154,40,6.4,True,2,False,0,0,0,11938,116,48,6.2,False,25.59495,4025,7,1,194,164,30
BR1_2726409770,7,True,1,0,0,16611,186,52,7.0,True,1,False,0,0,0,13206,174,44,6.8,False,28.6392,3405,6,1,238,218,20
BR1_2673796455,6,True,0,0,0,17420,181,48,7.0,False,7,False,1,0,0,16960,197,52,7.2,True,28.645516666666666,460,-1,-1,229,249,-20
BR1_2698310451,7,False,0,0,0,15946,136,54,6.8,False,8,True,1,0,0,18358,211,56,7.2,True,28.286316666666668,-2412,-1,-1,190,267,-77
BR1_2730816155,4,False,0,1,0,16052,165,48,7.2,False,13,True,1,0,0,18461,160,53,7.2,True,28.070716666666666,-2409,-9,-1,213,213,0
BR1_2723922444,7,True,1,0,0,16632,167,47,6.8,True,5,False,0,0,0,15488,175,49,6.6,False,29.8417,1144,2,1,214,224,-10
BR1_2695301277,8,True,0,0,0,17841,203,64,7.4,False,7,False,1,1,0,17320,186,60,7.2,True,28.617716666666666,521,1,-1,267,246,21
BR1_2688560729,4,False,0,0,0,15547,198,68,7.4,False,5,True,0,0,0,15005,202,22,6.6,True,28.56051666666667,542,-1,0,266,224,42
BR1_2723075599,7,False,1,0,0,17681,184,72,7.6,True,5,True,0,1,0,16641,187,72,7.0,False,28.639883333333334,1040,2,1,256,259,-3
BR1_2727363576,3,True,0,0,0,15355,184,48,7.0,False,7,False,1,0,0,16875,196,52,7.2,True,29.305333333333333,-1520,-4,-1,232,248,-16
BR1_2727346300,10,False,0,0,0,17618,203,36,7.0,False,11,True,0,1,0,19554,185,56,7.0,True,27.67015,-1936,-1,0,239,241,-2
BR1_2727324006,7,False,0,0,0,16766,193,60,7.4,True,4,True,1,1,0,15244,164,46,6.6,False,27.783333333333335,1522,3,-1,253,210,43
BR1_2727645286,11,True,0,0,0,18090,186,40,7.0,True,6,False,1,1,0,15676,164,40,6.8,False,27.11265,2414,5,-1,226,204,22
BR1_2727630110,9,False,1,0,0,17016,141,60,7.0,True,8,True,0,0,0,17796,235,44,7.0,False,28.079616666666666,-780,1,1,201,279,-78
BR1_2700179136,9,True,1,1,0,17102,166,55,6.8,True,7,False,0,0,0,14915,156,56,6.8,False,26.98065,2187,2,1,221,212,9
BR1_2697133520,6,False,0,0,0,15116,135,44,6.8,False,7,True,0,0,0,19156,227,56,7.2,True,28.578383333333335,-4040,-1,0,179,283,-104
BR1_2693369734,5,False,0,0,0,15682,190,52,6.8,True,5,True,0,0,0,13537,157,36,6.4,False,27.02638333333333,2145,0,0,242,193,49
BR1_2731356645,4,False,1,0,0,13684,158,44,6.6,True,6,True,0,0,0,13900,90,71,5.8,False,26.7923,-216,-2,1,202,161,41
BR1_2713815055,7,False,0,0,0,14158,107,32,5.4,False,7,True,1,1,0,15822,138,46,6.4,True,27.476583333333334,-1664,0,-1,139,184,-45
BR1_2729200127,6,True,0,0,0,16682,191,67,7.2,True,6,False,0,0,0,15232,140,48,7.0,False,29.993566666666666,1450,0,0,258,188,70
BR1_2710759656,7,True,1,0,0,14695,142,33,6.2,False,11,False,0,0,0,17554,173,54,6.8,True,25.536166666666666,-2859,-4,1,175,227,-52
BR1_2718703937,5,False,0,1,0,17303,177,52,7.0,False,17,True,1,0,0,21436,223,46,7.6,True,28.410383333333332,-4133,-12,-1,229,269,-40
BR1_2680960906,6,True,1,0,0,16986,192,72,7.2,False,8,False,0,0,0,17121,214,56,7.8,True,29.217666666666666,-135,-2,1,264,270,-6
BR1_2680955197,4,True,0,0,0,14162,175,48,6.4,False,9,False,1,1,0,16579,185,56,7.4,True,25.701016666666668,-2417,-5,-1,223,241,-18
BR1_2680945505,5,False,0,1,0,15980,198,48,7.0,False,12,True,1,0,0,21200,271,68,8.2,True,28.183483333333335,-5220,-7,-1,246,339,-93
BR1_2729469744,3,False,0,1,0,14841,164,56,6.8,False,7,True,1,0,0,17057,180,60,7.0,True,28.1684,-2216,-4,-1,220,240,-20
BR1_2688491452,1,True,0,1,0,14181,215,52,6.6,True,2,False,1,0,0,13564,171,60,6.8,False,25.361766666666668,617,-1,-1,267,231,36
BR1_2671637168,12,False,1,1,0,18639,158,48,7.6,False,8,True,0,0,0,17438,210,48,7.0,True,28.942566666666668,1201,4,1,206,258,-52
BR1_2661428678,7,False,0,1,0,15688,147,60,7.0,False,6,True,1,0,0,16599,181,56,7.4,True,27.98015,-911,1,-1,207,237,-30
BR1_2661306365,3,False,0,0,0,14089,154,45,6.4,False,14,True,0,0,0,19141,179,54,7.2,True,26.698983333333334,-5052,-11,0,199,233,-34
BR1_2661270437,8,True,0,0,0,16258,180,43,7.0,False,7,False,0,0,0,15246,166,52,6.8,True,26.224633333333333,1012,1,0,223,218,5
BR1_2727957603,9,False,1,1,2,20023,236,50,7.6,True,5,True,0,0,0,15644,167,44,7.0,False,27.995316666666668,4379,4,1,286,211,75
BR1_2731122504,8,True,0,1,0,18405,193,56,7.4,True,6,False,1,0,0,16404,185,64,7.2,False,28.638783333333333,2001,2,-1,249,249,0
BR1_2714862668,7,True,1,1,0,16361,197,68,7.2,True,2,False,0,0,0,13477,182,48,6.2,False,25.70825,2884,5,1,265,230,35
BR1_2724078656,12,True,0,1,0,19214,195,60,7.0,False,8,False,1,0,0,16763,183,32,6.8,True,27.539566666666666,2451,4,-1,255,215,40
BR1_2723656368,13,True,1,0,0,19616,237,55,7.2,True,2,False,0,0,0,13196,183,15,6.6,False,28.0573,6420,11,1,292,198,94
BR1_2730788328,2,True,0,1,0,14593,190,56,7.0,True,3,False,1,0,0,13372,169,52,7.0,False,26.641666666666666,1221,-1,-1,246,221,25
BR1_2730765088,12,True,1,0,0,18246,202,52,6.8,True,3,False,0,0,0,14004,155,48,6.6,False,25.42815,4242,9,1,254,203,51
BR1_2727063614,3,False,1,1,0,15199,196,60,7.2,True,2,True,0,0,0,13589,166,62,7.0,False,25.663483333333332,1610,1,1,256,228,28
BR1_2726780821,4,False,0,0,0,16554,216,56,7.2,False,6,True,0,1,0,17717,189,48,7.2,True,28.030783333333332,-1163,-2,0,272,237,35
BR1_2708992480,7,False,1,0,0,16929,182,60,7.0,True,5,True,0,1,0,17262,217,56,7.4,False,29.974633333333333,-333,2,1,242,273,-31
BR1_2730722089,7,True,0,0,0,15924,181,48,6.8,False,6,False,1,1,0,16338,186,60,7.0,True,29.18338333333333,-414,1,-1,229,246,-17
BR1_2726893543,6,True,1,0,0,14532,142,56,6.6,False,4,False,0,0,0,14238,175,28,6.4,True,27.1276,294,2,1,198,203,-5
BR1_2687955491,6,False,0,0,0,14925,152,40,6.8,True,7,True,0,0,0,16472,193,40,6.8,False,27.461866666666666,-1547,-1,0,192,233,-41
BR1_2668846254,6,True,0,0,0,15126,174,39,6.8,True,4,False,0,1,0,14773,182,60,6.8,False,25.3403,353,2,0,213,242,-29
BR1_2668269551,2,False,0,1,0,14376,183,55,7.0,False,10,True,1,0,0,18335,182,64,7.6,True,29.077716666666667,-3959,-8,-1,238,246,-8
BR1_2723377104,5,True,0,1,0,15470,193,44,7.0,False,1,False,0,0,0,14229,183,80,7.0,True,25.9896,1241,4,0,237,263,-26
BR1_2691632915,13,True,0,0,0,16890,155,44,6.8,True,4,False,1,1,0,13160,156,48,6.4,False,26.907516666666666,3730,9,-1,199,204,-5
BR1_2730106088,10,False,1,0,0,19976,218,40,7.2,True,9,True,0,1,0,18028,182,64,6.8,False,29.930983333333334,1948,1,1,258,246,12
BR1_2730065829,8,False,0,0,0,16834,194,40,7.0,True,7,True,1,1,0,15672,187,44,6.4,False,25.76,1162,1,-1,234,231,3
BR1_2686331838,7,False,1,0,0,16950,210,52,7.2,False,2,True,0,1,0,15399,186,68,6.8,True,29.588916666666666,1551,5,1,262,254,8
BR1_2686312503,4,False,0,1,0,13187,113,56,6.6,False,8,True,0,0,0,17322,211,52,7.2,True,25.626083333333334,-4135,-4,0,169,263,-94
BR1_2731160645,4,False,1,0,0,13529,141,48,7.0,False,3,True,0,0,0,14009,187,38,7.0,True,26.83775,-480,1,1,189,225,-36
BR1_2730732159,7,False,0,1,0,18236,201,60,7.4,False,10,True,1,0,0,19535,220,61,7.6,True,27.671216666666666,-1299,-3,-1,261,281,-20
BR1_2730677183,4,False,0,0,0,14070,127,56,6.6,False,10,True,0,0,0,18101,219,44,6.8,True,26.716616666666667,-4031,-6,0,183,263,-80
BR1_2695565176,8,False,1,0,0,17906,194,52,7.4,True,12,True,0,1,0,19412,174,60,7.2,False,29.898833333333332,-1506,-4,1,246,234,12
BR1_2725312009,14,True,0,0,0,19765,179,40,7.0,True,11,False,1,0,0,18427,179,46,6.6,False,28.222516666666667,1338,3,-1,219,225,-6
BR1_2702739159,4,False,0,0,0,12966,131,52,6.6,False,4,True,0,0,0,15046,181,52,6.8,True,27.128783333333335,-2080,0,0,183,233,-50
BR1_2704330326,2,False,1,0,0,12462,135,40,6.6,False,3,True,0,1,0,14828,212,56,7.2,True,27.480066666666666,-2366,-1,1,175,268,-93
BR1_2730983096,14,False,1,1,0,20803,184,60,7.4,True,6,True,0,0,0,15787,156,52,6.8,False,29.554033333333333,5016,8,1,244,208,36
BR1_2731322464,8,True,0,1,0,16499,135,48,7.2,True,5,False,1,0,0,16609,199,56,7.2,False,29.895166666666668,-110,3,-1,183,255,-72
BR1_2700969599,3,False,0,0,0,14169,173,44,7.0,False,9,True,1,0,0,18790,178,68,7.4,True,27.777266666666666,-4621,-6,-1,217,246,-29
BR1_2675566768,4,True,0,0,0,16501,179,64,7.4,False,1,False,0,0,0,15615,238,76,7.4,True,27.92045,886,3,0,243,314,-71
BR1_2730814341,4,False,0,0,0,15148,161,52,7.2,False,9,True,1,1,0,18112,170,56,7.2,True,28.301683333333333,-2964,-5,-1,213,226,-13
BR1_2714919218,8,False,0,0,0,16251,172,48,6.8,False,12,True,1,0,0,17706,158,56,6.8,True,26.98925,-1455,-4,-1,220,214,6
BR1_2730396123,2,True,0,0,0,14059,169,48,6.6,False,3,False,0,0,0,14805,201,52,6.6,True,26.6415,-746,-1,0,217,253,-36
BR1_2700193940,3,False,0,0,0,14885,180,101,7.2,False,4,True,0,0,0,14244,182,36,7.0,True,25.543883333333333,641,-1,0,281,218,63
BR1_2699769370,8,True,1,0,0,15956,165,48,6.8,True,2,False,0,0,0,13717,170,44,6.6,False,25.837933333333332,2239,6,1,213,214,-1
BR1_2725349641,3,True,0,0,0,15370,188,40,7.2,False,12,False,1,1,0,18333,167,56,7.4,True,28.121683333333333,-2963,-9,-1,228,223,5
BR1_2719487041,8,False,1,1,0,17864,163,68,7.8,True,5,True,0,0,0,16089,183,40,6.8,False,29.5349,1775,3,1,231,223,8
BR1_2729379021,13,False,0,0,0,18513,171,41,6.6,True,7,True,0,0,0,14388,99,32,5.6,False,26.97375,4125,6,0,212,131,81
BR1_2703580063,4,True,1,0,0,14842,167,68,7.0,True,5,False,0,0,0,14729,158,40,7.0,False,27.11616666666667,113,-1,1,235,198,37
BR1_2691032457,5,False,0,0,0,15682,190,56,7.2,True,5,True,1,1,0,16212,184,52,7.2,False,28.002983333333333,-530,0,-1,246,236,10
BR1_2729161198,9,False,0,0,0,17068,193,60,7.0,True,12,True,0,0,0,16916,155,24,6.8,False,29.162166666666668,152,-3,0,253,179,74
BR1_2720002526,4,False,0,0,0,14860,158,68,7.2,False,6,True,1,1,0,17517,188,56,7.6,True,28.5623,-2657,-2,-1,226,244,-18
BR1_2686117512,7,True,0,0,0,16303,149,40,6.8,False,4,False,0,0,0,14222,165,48,6.4,True,27.134316666666667,2081,3,0,189,213,-24
BR1_2730932531,8,True,1,0,0,16654,130,68,7.2,True,4,False,0,1,0,15852,174,36,7.0,False,28.678483333333332,802,4,1,198,210,-12
BR1_2730476767,8,True,1,0,0,17252,186,56,7.0,True,6,False,0,0,0,14693,158,40,6.2,False,25.752283333333335,2559,2,1,242,198,44
BR1_2730450613,13,False,1,0,0,19212,199,46,7.2,True,11,True,0,1,0,21254,253,72,7.8,False,28.89705,-2042,2,1,245,325,-80
BR1_2730191845,8,False,1,0,0,18257,200,76,7.4,False,11,True,0,0,0,19013,176,52,7.4,True,28.519216666666665,-756,-3,1,276,228,48
BR1_2713893141,8,True,0,0,0,16416,148,56,6.6,False,11,False,0,0,0,17803,162,48,6.8,True,27.19783333333333,-1387,-3,0,204,210,-6
BR1_2713453907,2,False,0,0,0,12895,139,50,5.8,False,6,True,0,0,0,15532,157,48,6.6,True,25.585983333333335,-2637,-4,0,189,205,-16
BR1_2712441079,6,True,0,0,0,15689,174,48,6.8,True,1,False,1,0,0,13343,181,64,6.8,False,26.542883333333332,2346,5,-1,222,245,-23
BR1_2727497108,16,False,1,0,0,21361,176,75,7.4,True,16,True,0,1,0,21294,185,60,7.2,False,29.847533333333335,67,0,1,251,245,6
BR1_2727461978,10,False,0,1,0,17913,173,44,7.0,False,13,True,1,0,0,21149,214,56,7.4,True,29.652616666666667,-3236,-3,-1,217,270,-53
BR1_2725505869,8,True,0,0,0,16097,160,41,6.4,False,11,False,0,1,0,16940,145,69,7.0,True,26.3899,-843,-3,0,201,214,-13
BR1_2731615173,8,True,0,0,0,16012,155,40,6.8,True,3,False,1,0,0,13783,151,64,6.6,False,25.936983333333334,2229,5,-1,195,215,-20
BR1_2731116937,10,True,1,0,0,17736,175,48,7.0,True,6,False,0,0,0,15965,162,28,6.6,False,27.508816666666668,1771,4,1,223,190,33
BR1_2731002720,5,False,1,0,0,15748,182,52,7.0,True,7,True,0,0,0,15969,172,60,7.0,False,27.533,-221,-2,1,234,232,2
BR1_2686888161,5,False,0,0,0,15461,163,48,6.8,False,5,True,1,1,0,16945,201,60,7.0,True,29.307066666666667,-1484,0,-1,211,261,-50
BR1_2731608851,6,False,0,0,0,16931,172,55,7.0,True,3,True,1,0,0,14525,145,60,6.8,False,28.280916666666666,2406,3,-1,227,205,22
BR1_2730706866,7,False,0,0,0,17115,190,41,6.8,True,4,True,1,0,0,14510,144,48,6.2,False,26.0765,2605,3,-1,231,192,39
BR1_2670172293,11,True,0,0,0,17698,172,56,7.4,False,13,False,0,0,0,18429,180,40,7.8,True,28.607333333333333,-731,-2,0,228,220,8
BR1_2676770610,4,False,0,0,0,15065,179,56,7.2,True,8,True,0,0,0,16089,185,32,6.8,False,27.407916666666665,-1024,-4,0,235,217,18
BR1_2676662722,5,True,0,0,0,14807,167,50,6.8,False,5,False,1,0,0,15069,190,37,6.8,True,25.076416666666667,-262,0,-1,217,227,-10
BR1_2731377140,7,False,0,0,0,14317,158,40,6.8,False,6,True,0,0,0,15270,177,56,6.6,True,27.4803,-953,1,0,198,233,-35
BR1_2730881530,6,False,1,1,0,16261,196,52,7.6,True,10,True,0,0,0,18815,222,59,7.4,False,28.1684,-2554,-4,1,248,281,-33
BR1_2730311736,4,False,0,0,0,14202,186,55,6.6,False,5,True,1,0,0,14205,153,44,7.0,True,26.8614,-3,-1,-1,241,197,44
BR1_2727760771,10,True,0,1,0,16417,152,40,6.6,True,5,False,0,0,0,15084,157,56,6.6,False,26.531066666666668,1333,5,0,192,213,-21
BR1_2672069330,14,True,1,0,0,19131,188,56,7.0,False,7,False,0,0,0,16285,210,36,6.8,True,29.508116666666666,2846,7,1,244,246,-2
BR1_2680623563,3,True,0,0,0,14528,178,60,7.2,True,2,False,0,0,0,13894,203,60,6.6,False,26.7594,634,1,0,238,263,-25
BR1_2680167211,4,True,0,0,0,15563,189,60,7.2,False,5,False,1,1,1,17992,211,64,7.4,True,29.217916666666667,-2429,-1,-1,249,275,-26
BR1_2724585374,8,True,1,1,0,18400,228,68,7.4,True,2,False,0,0,0,14622,182,56,7.0,False,28.151816666666665,3778,6,1,296,238,58
BR1_2706968059,5,False,1,0,0,16109,208,40,7.2,False,5,True,0,1,0,15581,189,48,6.6,True,29.951966666666667,528,0,1,248,237,11
BR1_2730333148,9,False,1,0,0,17589,191,46,7.6,True,3,True,0,0,0,16010,219,48,7.0,False,28.049033333333334,1579,6,1,237,267,-30
BR1_2723692280,8,True,0,0,0,17847,196,64,7.2,False,7,False,1,0,0,16561,143,60,7.0,True,28.752833333333335,1286,1,-1,260,203,57
BR1_2730730438,2,False,0,0,0,14492,227,44,6.8,False,4,True,1,0,0,15395,219,64,7.0,True,25.729816666666668,-903,-2,-1,271,283,-12
BR1_2730278134,10,True,1,0,0,18117,188,51,6.8,True,5,False,0,1,1,16144,203,48,6.4,False,26.459883333333334,1973,5,1,239,251,-12
BR1_2664580366,7,False,0,0,0,17724,191,49,7.4,True,3,True,0,1,0,14886,177,54,7.0,False,29.89145,2838,4,0,240,231,9
BR1_2692902633,11,True,1,0,0,16420,170,36,6.6,False,7,False,0,0,0,15233,162,60,6.8,True,26.60845,1187,4,1,206,222,-16
BR1_2727916297,9,True,0,0,0,17532,196,56,7.0,False,7,False,1,1,0,16828,167,48,6.6,True,28.022783333333333,704,2,-1,252,215,37
BR1_2724030299,2,False,1,0,0,12838,146,48,6.2,False,9,True,0,0,0,16279,172,44,6.8,True,25.041433333333334,-3441,-7,1,194,216,-22
BR1_2723995821,2,False,0,0,0,15231,200,48,7.0,True,10,True,0,0,0,17309,176,48,7.2,False,29.494766666666667,-2078,-8,0,248,224,24
BR1_2677576293,5,True,1,0,0,15456,166,56,7.0,False,5,False,0,1,0,16426,173,47,7.0,True,29.15915,-970,0,1,222,220,2
BR1_2731321064,8,False,0,1,0,17957,180,48,7.2,False,8,True,1,0,1,18651,199,64,7.4,True,27.65935,-694,0,-1,228,263,-35
BR1_2701584607,5,True,0,0,0,16437,207,40,7.2,False,4,False,1,1,0,16506,216,71,7.6,True,27.87761666666667,-69,1,-1,247,287,-40
BR1_2726314638,6,True,0,0,1,16972,177,56,6.6,False,6,False,1,0,0,16077,184,64,7.0,True,27.00995,895,0,-1,233,248,-15
BR1_2708476116,7,True,0,0,0,16890,208,44,7.2,False,7,False,0,0,0,16873,190,46,7.0,True,28.408633333333334,17,0,0,252,236,16
BR1_2729625538,6,True,0,0,0,14973,175,44,6.6,False,7,False,1,0,0,16298,189,56,6.8,True,27.01165,-1325,-1,-1,219,245,-26
BR1_2729572749,10,True,0,0,0,17299,160,48,7.0,True,2,False,1,0,0,14351,181,52,6.8,False,28.06835,2948,8,-1,208,233,-25
BR1_2671394025,6,False,1,0,0,16780,195,50,7.0,True,8,True,0,1,0,17353,147,64,7.4,False,27.503083333333333,-573,-2,1,245,211,34
BR1_2671021865,3,True,0,0,0,15113,184,64,7.2,False,3,False,1,0,0,15854,207,48,7.4,True,29.035183333333332,-741,0,-1,248,255,-7
BR1_2684867131,4,True,0,0,0,14076,189,36,6.4,False,4,False,0,0,0,15065,207,44,6.8,True,25.272083333333335,-989,0,0,225,251,-26
BR1_2689162342,5,True,0,0,0,16001,183,54,7.2,False,10,False,0,1,0,17576,172,49,7.2,True,28.032466666666668,-1575,-5,0,237,221,16
BR1_2684108314,7,True,0,0,0,16429,190,44,6.8,True,9,False,0,0,0,15558,144,28,6.8,False,27.447433333333333,871,-2,0,234,172,62
BR1_2687989550,7,True,1,1,0,15946,148,64,6.4,False,4,False,0,0,0,14245,168,60,6.6,True,27.250183333333332,1701,3,1,212,228,-16
BR1_2727351968,8,True,0,0,0,17876,179,52,7.0,False,5,False,1,1,0,16304,165,72,7.2,True,29.672516666666667,1572,3,-1,231,237,-6
BR1_2721942395,6,False,1,0,0,14347,164,44,6.6,False,6,True,0,1,0,16448,176,48,7.0,True,25.207083333333333,-2101,0,1,208,224,-16
BR1_2721774126,6,True,1,0,0,17134,231,52,7.6,True,5,False,0,0,0,15557,176,44,7.0,False,29.63005,1577,1,1,283,220,63
BR1_2724935419,3,True,0,0,0,14266,202,44,6.8,False,6,False,0,0,0,15860,214,40,6.8,True,26.715566666666668,-1594,-3,0,246,254,-8
BR1_2686168975,7,False,0,0,0,17761,241,48,7.8,True,5,True,1,0,0,16882,196,64,7.4,False,27.691266666666667,879,2,-1,289,260,29
BR1_2685925778,1,False,0,0,0,13031,157,60,6.6,False,8,True,1,0,0,16610,179,56,7.0,True,26.3712,-3579,-7,-1,217,235,-18
BR1_2730037562,5,True,0,1,0,16192,161,64,7.0,True,5,False,1,0,0,15102,160,48,7.2,False,27.57685,1090,0,-1,225,208,17
BR1_2730437138,6,True,1,0,0,14883,179,55,6.6,True,6,False,0,0,0,14540,174,25,6.4,False,26.45605,343,0,1,234,199,35
BR1_2706436808,2,True,0,0,0,13352,159,51,6.6,True,3,False,0,0,0,13496,151,52,6.4,False,26.287,-144,-1,0,210,203,7
BR1_2727808079,11,False,1,0,0,19568,225,63,7.4,True,4,True,0,0,0,15566,189,60,7.0,False,28.063883333333333,4002,7,1,288,249,39
BR1_2729545124,8,True,0,0,0,15687,178,44,7.0,True,5,False,0,0,0,15582,162,59,6.6,False,27.16195,105,3,0,222,221,1
BR1_2729517181,9,False,1,0,0,16681,141,64,6.2,True,7,True,0,0,0,16047,171,31,6.2,False,29.033366666666666,634,2,1,205,202,3
BR1_2716849228,9,True,0,1,0,15587,147,44,6.4,True,5,False,1,0,0,14431,172,36,6.6,False,26.976,1156,4,-1,191,208,-17
BR1_2690500340,2,False,0,0,0,13931,150,56,6.8,False,10,True,0,1,0,19189,199,76,7.6,True,29.16565,-5258,-8,0,206,275,-69
BR1_2728163982,5,True,1,0,0,16706,206,68,7.4,True,2,False,0,1,0,14822,201,52,6.8,False,29.8527,1884,3,1,274,253,21
BR1_2730155824,8,False,0,1,0,17425,160,60,7.4,False,6,True,1,0,0,15922,172,48,6.8,True,29.507433333333335,1503,2,-1,220,220,0
BR1_2730834077,12,True,1,1,0,18204,205,36,6.8,True,3,False,0,0,0,15142,178,64,7.0,False,28.199716666666667,3062,9,1,241,242,-1
BR1_2705936202,4,False,0,0,0,15554,178,28,6.8,False,9,True,1,0,0,17060,200,43,6.8,True,28.901966666666667,-1506,-5,-1,206,243,-37
BR1_2705885663,12,False,0,0,0,18047,152,36,6.8,True,14,True,1,0,1,20836,160,56,6.8,False,28.0747,-2789,-2,-1,188,216,-28
BR1_2729153950,8,False,0,1,0,15564,135,36,6.8,False,12,True,1,0,0,19562,169,56,7.2,True,29.488166666666668,-3998,-4,-1,171,225,-54
BR1_2699234405,3,False,0,1,0,13696,147,44,6.4,False,9,True,1,0,0,17792,189,44,6.8,True,25.521,-4096,-6,-1,191,233,-42
BR1_2698486925,9,True,0,0,0,18735,219,52,7.0,True,6,False,1,0,0,15951,151,52,6.8,False,29.52755,2784,3,-1,271,203,68
BR1_2731310290,7,True,1,0,0,17003,197,57,7.6,True,4,False,0,0,0,15435,171,32,7.2,False,29.292416666666668,1568,3,1,254,203,51
BR1_2730760870,11,True,1,1,0,17349,198,48,7.6,True,1,False,0,0,0,13433,166,40,6.6,False,29.7188,3916,10,1,246,206,40
BR1_2675952623,6,False,0,0,0,16468,176,52,7.2,False,8,True,1,0,0,17915,206,68,7.6,True,28.709083333333332,-1447,-2,-1,228,274,-46
BR1_2675928467,6,True,0,0,0,16076,196,42,6.8,False,7,False,1,0,0,18306,204,60,7.6,True,28.50455,-2230,-1,-1,238,264,-26
BR1_2678839160,6,False,1,0,0,13407,116,40,6.0,False,11,True,0,0,0,16800,142,56,6.8,True,25.985733333333332,-3393,-5,1,156,198,-42
BR1_2708649232,9,True,0,0,0,16411,193,48,6.4,False,5,False,1,0,0,14758,163,44,6.6,True,25.1767,1653,4,-1,241,207,34
BR1_2707623435,7,True,0,0,0,15140,147,56,6.6,False,6,False,0,0,0,17885,205,44,7.0,True,28.769133333333333,-2745,1,0,203,249,-46
BR1_2707590024,12,True,1,0,0,19748,198,69,7.6,True,5,False,0,0,0,15809,178,42,6.8,False,28.629366666666666,3939,7,1,267,220,47
BR1_2730119493,7,True,1,0,0,16367,165,52,6.6,False,12,False,0,0,0,17634,165,52,6.6,True,26.012366666666665,-1267,-5,1,217,217,0
BR1_2683465720,7,False,1,0,0,14103,138,42,6.6,False,11,True,0,0,0,18111,189,42,6.8,True,27.27745,-4008,-4,1,180,231,-51
BR1_2722013849,3,True,1,0,0,16885,273,68,7.4,True,5,False,0,0,0,17304,246,52,7.0,False,28.040333333333333,-419,-2,1,341,298,43
BR1_2721972600,2,False,0,0,0,14020,187,36,7.0,False,9,True,1,0,0,17950,204,60,7.6,True,28.010116666666665,-3930,-7,-1,223,264,-41
BR1_2685324653,6,True,1,0,0,15622,187,44,7.0,True,6,False,0,1,0,14692,168,63,7.0,False,26.5964,930,0,1,231,231,0
BR1_2685274333,2,False,0,0,0,13357,180,45,6.8,False,3,True,1,0,0,14714,195,54,6.8,True,26.18785,-1357,-1,-1,225,249,-24
BR1_2729960364,5,True,1,0,0,17026,217,49,7.2,True,4,False,0,1,0,15177,179,54,7.0,False,28.863466666666667,1849,1,1,266,233,33
BR1_2690270051,7,True,0,0,0,15242,162,44,6.8,False,10,False,0,0,0,18061,223,40,7.0,True,27.67915,-2819,-3,0,206,263,-57
BR1_2696951607,12,True,0,1,0,17922,148,44,6.6,True,10,False,0,0,0,16853,133,48,6.6,False,26.174533333333333,1069,2,0,192,181,11
BR1_2696016680,5,False,1,1,0,14530,169,40,6.8,False,7,True,0,0,0,15807,184,56,7.0,True,26.7252,-1277,-2,1,209,240,-31
BR1_2709961007,10,True,1,0,0,17126,180,56,6.8,True,3,False,0,0,0,13312,148,40,6.4,False,26.996916666666667,3814,7,1,236,188,48
BR1_2729515486,3,True,0,1,0,15163,159,72,7.0,False,4,False,1,0,0,16836,206,56,7.6,True,28.1,-1673,-1,-1,231,262,-31
BR1_2725830526,5,True,0,0,0,15086,156,52,6.8,False,3,False,0,1,0,16298,181,64,7.2,True,29.101383333333334,-1212,2,0,208,245,-37
BR1_2666868152,8,True,0,1,0,15748,157,40,6.8,True,3,False,0,0,0,14111,169,52,7.0,False,26.4462,1637,5,0,197,221,-24
BR1_2729925820,5,False,0,0,0,14432,144,40,6.2,False,9,True,1,1,0,16074,167,52,6.6,True,26.291,-1642,-4,-1,184,219,-35
BR1_2731555174,9,False,0,0,0,18491,201,56,7.4,True,5,True,0,0,0,17184,233,4,6.8,False,29.935833333333335,1307,4,0,257,237,20
BR1_2670680090,6,False,0,0,0,16745,229,55,7.6,True,6,True,0,0,0,15930,183,48,7.4,False,29.959433333333333,815,0,0,284,231,53
BR1_2669364133,6,False,0,0,0,14482,149,44,6.4,False,8,True,0,0,0,16446,173,64,6.8,True,26.700783333333334,-1964,-2,0,193,237,-44
BR1_2729546780,5,False,0,1,0,16911,195,56,7.0,False,7,True,1,0,0,17502,206,60,7.2,True,28.08485,-591,-2,-1,251,266,-15
BR1_2731623881,10,False,0,1,0,17568,158,52,6.8,False,11,True,1,0,0,19702,213,51,7.2,True,27.6208,-2134,-1,-1,210,264,-54
BR1_2731514938,7,True,1,0,0,15065,157,31,6.2,True,8,False,0,0,0,15917,170,48,6.6,False,27.3841,-852,-1,1,188,218,-30
BR1_2722285540,8,True,1,0,0,16416,163,59,6.8,True,3,False,0,0,0,14275,171,44,6.8,False,29.899716666666666,2141,5,1,222,215,7
BR1_2731340630,11,False,0,0,0,17976,183,44,6.4,False,10,True,0,0,0,18179,168,55,6.6,True,27.355133333333335,-203,1,0,227,223,4
BR1_2731309406,2,False,0,1,0,12300,126,30,6.0,False,16,True,1,0,0,18726,186,48,6.6,True,25.239133333333335,-6426,-14,-1,156,234,-78
BR1_2671570839,2,False,1,0,0,14847,219,48,7.0,True,6,True,0,1,0,17100,225,52,7.8,False,29.61965,-2253,-4,1,267,277,-10
BR1_2710392945,10,True,1,0,0,17622,184,48,6.8,True,4,False,0,0,0,12978,143,44,6.4,False,27.237816666666667,4644,6,1,232,187,45
BR1_2730824191,8,True,1,0,0,16347,178,40,7.0,True,4,False,0,0,0,16243,188,64,7.2,False,27.86645,104,4,1,218,252,-34
BR1_2730222644,4,True,1,0,0,15282,171,48,6.6,False,6,False,0,0,0,15065,157,40,6.4,True,25.9571,217,-2,1,219,197,22
BR1_2693125396,5,False,1,1,0,14871,153,64,6.8,True,4,True,0,0,0,13755,167,52,6.6,False,26.246116666666666,1116,1,1,217,219,-2
BR1_2693104495,12,True,1,0,0,18253,168,52,6.6,True,6,False,0,0,0,15010,129,48,6.6,False,25.392916666666668,3243,6,1,220,177,43
BR1_2692922859,8,True,0,0,0,16095,162,48,6.6,True,3,False,1,0,0,13389,162,48,6.2,False,27.085916666666666,2706,5,-1,210,210,0
BR1_2721314648,2,False,0,0,0,13080,170,48,6.2,False,11,True,1,0,0,17081,158,52,7.0,True,26.12376666666667,-4001,-9,-1,218,210,8
BR1_2721292100,6,True,0,0,0,15319,151,44,6.8,False,4,False,1,0,0,14874,193,56,7.0,True,25.823916666666666,445,2,-1,195,249,-54
BR1_2670033223,6,True,0,1,0,17134,202,52,7.4,False,7,False,1,0,0,16758,192,60,7.2,True,29.6147,376,-1,-1,254,252,2
BR1_2703195911,7,False,0,0,0,15697,180,44,6.6,False,7,True,0,0,0,16780,183,52,6.8,True,26.60515,-1083,0,0,224,235,-11
BR1_2687574317,6,False,0,0,0,14776,137,36,6.4,False,9,True,0,0,0,16775,189,40,6.8,True,25.321883333333332,-1999,-3,0,173,229,-56
BR1_2678437981,7,False,0,1,0,17184,199,40,7.4,False,6,True,1,0,0,17532,226,52,7.4,True,27.542066666666667,-348,1,-1,239,278,-39
BR1_2678414395,7,True,1,0,0,16936,198,48,7.0,False,12,False,0,1,0,19866,166,48,7.4,True,29.95005,-2930,-5,1,246,214,32
BR1_2684928653,6,False,0,0,0,15911,146,56,7.2,False,8,True,1,0,0,17505,186,56,7.4,True,29.152666666666665,-1594,-2,-1,202,242,-40
BR1_2672184178,6,False,1,1,0,18425,221,74,7.8,True,5,True,0,0,0,16933,223,48,7.4,False,29.440433333333335,1492,1,1,295,271,24
BR1_2707761443,9,False,0,0,0,17602,169,48,7.0,False,9,True,1,0,0,17977,214,60,7.2,True,29.081516666666666,-375,0,-1,217,274,-57
BR1_2707263147,11,True,0,1,0,19066,189,52,7.2,True,5,False,1,0,0,15551,168,48,6.8,False,28.139033333333334,3515,6,-1,241,216,25
BR1_2709024376,7,True,0,1,0,16572,182,52,7.0,False,8,False,1,0,0,17688,208,67,7.2,True,29.591683333333332,-1116,-1,-1,234,275,-41
BR1_2688221994,14,False,1,0,0,20762,207,58,7.4,True,9,True,0,0,0,18304,164,48,7.2,False,28.79005,2458,5,1,265,212,53
BR1_2710607404,8,True,0,1,0,19206,210,76,7.2,True,5,False,1,0,0,16486,190,68,7.0,False,29.184333333333335,2720,3,-1,286,258,28
BR1_2712945472,15,True,1,0,0,19913,176,48,7.0,True,8,False,0,0,0,16652,171,44,6.4,False,29.160733333333333,3261,7,1,224,215,9
BR1_2699411789,5,False,0,0,0,13825,173,52,6.8,True,6,True,0,0,0,15448,182,44,6.4,False,26.75946666666667,-1623,-1,0,225,226,-1
BR1_2724582377,14,True,0,0,0,18659,180,40,6.8,True,5,False,0,0,0,15335,204,30,6.4,False,25.3394,3324,9,0,220,234,-14
BR1_2685459627,8,True,1,1,0,16703,138,48,6.8,True,7,False,0,0,0,14875,156,44,6.8,False,26.396366666666665,1828,1,1,186,200,-14
BR1_2731469627,4,False,0,0,0,16396,194,60,7.0,False,13,True,1,0,0,19484,160,52,7.0,True,28.070566666666668,-3088,-9,-1,254,212,42
BR1_2730455210,6,False,0,0,0,17227,163,60,7.0,False,11,True,1,1,0,18943,202,56,7.6,True,29.098883333333333,-1716,-5,-1,223,258,-35
BR1_2717546414,12,True,0,1,0,21122,227,44,7.4,True,6,False,0,0,0,14870,177,56,6.6,False,29.90835,6252,6,0,271,233,38
BR1_2685705161,10,True,0,1,0,18868,195,44,7.4,False,11,False,1,0,0,19370,216,52,7.4,True,28.89085,-502,-1,-1,239,268,-29
BR1_2685664376,11,False,1,0,0,18344,225,48,6.8,True,4,True,0,0,0,14173,162,52,6.4,False,25.580783333333333,4171,7,1,273,214,59
BR1_2685635871,8,True,1,1,0,16083,168,40,7.0,True,3,False,0,0,0,14142,170,56,6.4,False,27.331333333333333,1941,5,1,208,226,-18
BR1_2729893453,5,False,0,0,0,15975,183,56,7.0,False,11,True,1,1,0,17688,155,60,7.2,True,29.178266666666666,-1713,-6,-1,239,215,24
BR1_2728369324,8,True,1,0,0,16935,201,48,7.0,False,7,False,0,0,0,17313,207,46,7.4,True,28.699516666666668,-378,1,1,249,253,-4
BR1_2725378558,15,False,1,0,0,20292,163,52,7.2,True,4,True,0,0,0,15422,175,28,6.4,False,28.612833333333334,4870,11,1,215,203,12
BR1_2724493016,2,True,1,0,0,15705,245,72,8.0,True,3,False,0,0,0,15927,259,68,7.6,False,28.031033333333333,-222,-1,1,317,327,-10
BR1_2722281535,4,False,0,0,0,15439,179,71,7.0,False,9,True,1,1,0,19221,196,52,7.6,True,29.486833333333333,-3782,-5,-1,250,248,2
BR1_2724232206,6,False,0,0,0,16432,178,60,7.0,True,10,True,0,0,0,17944,193,32,7.0,False,28.2477,-1512,-4,0,238,225,13
BR1_2724224698,5,True,1,1,0,16548,190,60,7.2,True,4,False,0,0,0,15312,173,42,6.8,False,29.389833333333332,1236,1,1,250,215,35
BR1_2730620499,10,False,1,0,0,17581,173,48,6.8,True,5,True,0,0,0,14930,190,36,6.4,False,25.74695,2651,5,1,221,226,-5
BR1_2731642350,5,False,0,0,0,14818,163,20,6.0,False,8,True,0,0,0,14959,131,28,5.8,True,26.5638,-141,-3,0,183,159,24
BR1_2713693918,5,False,1,0,0,15604,164,72,7.2,False,6,True,0,1,0,17884,239,51,7.6,True,29.749833333333335,-2280,-1,1,236,290,-54
BR1_2713666561,7,False,1,0,0,15951,178,48,7.0,False,9,True,0,0,0,17526,208,44,7.0,True,29.60943333333333,-1575,-2,1,226,252,-26
BR1_2678407115,5,False,1,1,0,16662,176,64,7.4,True,6,True,0,0,0,15109,144,64,7.4,False,29.9255,1553,-1,1,240,208,32
BR1_2726013773,5,True,0,1,0,15316,150,56,6.4,False,11,False,1,0,0,18587,177,52,6.8,True,26.183316666666666,-3271,-6,-1,206,229,-23
BR1_2726005147,12,False,1,0,0,17896,150,40,6.4,False,9,True,0,0,0,17873,188,40,6.4,True,27.87548333333333,23,3,1,190,228,-38
BR1_2724379660,7,True,0,1,0,15581,166,44,6.6,False,7,False,0,0,0,16567,200,36,7.2,True,28.0282,-986,0,0,210,236,-26
BR1_2716369320,8,True,0,1,0,18039,214,52,7.0,True,7,False,1,0,0,16954,192,39,7.2,False,27.81755,1085,1,-1,266,231,35
BR1_2710432591,8,True,0,0,0,16502,178,28,6.4,True,10,False,0,0,0,16834,172,40,6.4,False,26.710083333333333,-332,-2,0,206,212,-6
BR1_2731496537,11,False,1,0,0,16638,154,56,6.6,True,6,True,0,0,0,15045,176,46,6.4,False,27.089966666666665,1593,5,1,210,222,-12
BR1_2715306293,11,True,0,0,0,18655,177,48,7.0,True,2,False,0,0,0,12802,153,56,6.4,False,25.1933,5853,9,0,225,209,16
BR1_2712882016,14,True,1,0,0,19206,191,60,6.8,True,6,False,0,0,0,14453,123,44,6.2,False,25.2147,4753,8,1,251,167,84
BR1_2710173639,10,True,0,1,0,19823,210,56,7.4,False,8,False,0,0,0,18200,203,32,7.2,True,29.3635,1623,2,0,266,235,31
BR1_2723615457,5,False,1,0,0,14122,138,47,6.2,False,8,True,0,1,0,16983,172,60,7.0,True,25.12915,-2861,-3,1,185,232,-47
BR1_2718986320,6,True,0,0,0,15919,211,52,6.8,False,9,False,0,1,0,19149,239,64,7.6,True,29.557716666666668,-3230,-3,0,263,303,-40
BR1_2731596671,2,False,0,0,0,13711,154,44,7.2,False,5,True,0,1,0,16195,194,68,7.2,True,27.680933333333332,-2484,-3,0,198,262,-64
BR1_2723236215,4,False,0,0,0,15409,165,44,6.8,False,8,True,1,1,0,18056,187,80,7.6,True,28.488183333333332,-2647,-4,-1,209,267,-58
BR1_2730815120,8,False,0,1,0,15256,141,48,6.4,False,5,True,1,0,0,15206,165,47,6.6,True,25.1467,50,3,-1,189,212,-23
BR1_2730288802,6,True,0,1,0,16043,194,60,7.2,True,3,False,0,0,0,13584,136,40,6.4,False,26.7788,2459,3,0,254,176,78
BR1_2730259541,14,False,0,0,0,18839,161,46,6.6,False,14,True,1,0,0,18957,172,50,6.8,True,29.5305,-118,0,-1,207,222,-15
BR1_2727019381,7,False,1,0,0,17600,182,56,7.0,True,3,True,0,1,0,15951,177,32,6.8,False,28.684216666666668,1649,4,1,238,209,29
BR1_2711713517,9,True,1,0,0,16873,194,48,6.6,True,2,False,0,0,0,13650,194,56,6.4,False,25.817066666666665,3223,7,1,242,250,-8
BR1_2731576981,7,True,0,0,0,16614,174,71,7.4,True,9,False,0,0,0,17669,191,40,7.4,False,29.908916666666666,-1055,-2,0,245,231,14
BR1_2731470805,9,False,0,0,0,16291,136,56,6.8,True,7,True,1,1,0,15254,132,52,6.4,False,27.090433333333333,1037,2,-1,192,184,8
BR1_2731417855,4,False,0,0,0,14850,165,45,6.8,False,9,True,0,1,0,19102,229,57,7.2,True,29.62595,-4252,-5,0,210,286,-76
BR1_2730920871,6,True,1,0,0,15822,200,56,7.2,True,3,False,0,0,0,15139,189,46,7.2,False,29.172016666666668,683,3,1,256,235,21
BR1_2727684576,4,False,0,1,0,14951,153,48,6.8,False,3,True,1,0,0,15824,192,52,7.0,True,29.337416666666666,-873,1,-1,201,244,-43
BR1_2712242413,6,False,1,0,0,16657,179,58,7.0,False,9,True,0,0,0,18388,189,56,7.2,True,27.67481666666667,-1731,-3,1,237,245,-8
BR1_2730255084,8,False,0,1,1,17775,185,52,7.0,True,3,True,1,0,0,13265,153,44,6.2,False,26.306433333333334,4510,5,-1,237,197,40
BR1_2716618428,7,True,1,0,0,14407,132,35,6.2,False,8,False,0,1,0,16043,167,56,6.6,True,25.88205,-1636,-1,1,167,223,-56
BR1_2711423407,7,True,1,0,0,15396,134,48,6.8,True,5,False,0,0,0,14479,145,47,6.6,False,29.978716666666667,917,2,1,182,192,-10
BR1_2723838122,3,True,1,0,0,16441,229,64,7.2,True,6,False,0,0,0,16673,210,44,6.8,False,28.4124,-232,-3,1,293,254,39
BR1_2729670914,10,True,1,0,0,15582,127,48,6.0,True,4,False,0,0,0,14079,174,40,6.2,False,25.47908333333333,1503,6,1,175,214,-39
BR1_2728942502,3,False,0,0,0,16004,176,44,7.0,False,13,True,1,0,0,18424,145,64,7.2,True,29.190883333333332,-2420,-10,-1,220,209,11
BR1_2687239573,7,False,1,1,0,17934,215,64,7.8,True,2,True,0,0,0,14565,177,52,7.2,False,29.954983333333335,3369,5,1,279,229,50
BR1_2731625120,6,False,0,0,0,15679,191,40,6.8,False,8,True,1,0,0,17337,180,72,7.4,True,28.817483333333332,-1658,-2,-1,231,252,-21
BR1_2731136567,3,False,0,0,0,14681,161,40,6.6,False,9,True,1,1,0,17958,193,60,7.4,True,28.539783333333332,-3277,-6,-1,201,253,-52
BR1_2730745161,2,False,0,0,0,12783,152,36,6.6,False,4,True,1,0,0,14226,141,60,6.6,True,26.4631,-1443,-2,-1,188,201,-13
BR1_2731583357,6,False,0,0,0,14099,131,28,6.4,False,4,True,0,1,0,15296,168,50,6.4,True,26.819316666666666,-1197,2,0,159,218,-59
BR1_2731041667,7,True,1,0,0,16604,174,48,7.0,True,11,False,0,1,0,19091,181,48,7.2,False,29.31405,-2487,-4,1,222,229,-7
BR1_2682928080,9,False,1,0,0,18538,172,40,7.2,False,14,True,0,0,0,18593,148,56,7.4,True,28.5926,-55,-5,1,212,204,8
BR1_2712851786,4,True,1,1,0,15582,202,60,6.6,True,1,False,0,0,0,12119,119,56,6.4,False,27.1649,3463,3,1,262,175,87
BR1_2700430211,6,False,0,0,0,14447,134,40,6.6,False,12,True,1,0,0,18376,165,40,6.8,True,27.187183333333333,-3929,-6,-1,174,205,-31
BR1_2700332430,5,False,0,0,0,15344,163,40,6.4,False,4,True,1,1,0,15927,177,68,7.0,True,27.62911666666667,-583,1,-1,203,245,-42
BR1_2723071387,3,True,1,1,0,14097,188,43,6.8,True,2,False,0,0,0,13723,198,45,6.6,False,25.057266666666667,374,1,1,231,243,-12
BR1_2730744572,12,True,0,0,0,20633,206,44,7.2,True,9,False,1,0,0,17968,178,59,7.0,False,28.700483333333334,2665,3,-1,250,237,13
BR1_2692572656,3,True,1,0,1,14692,173,65,6.8,True,3,False,0,0,0,15321,175,56,6.6,False,26.961333333333332,-629,0,1,238,231,7
BR1_2672613925,9,True,0,0,0,16805,172,44,7.2,True,3,False,1,1,0,14810,185,56,7.2,False,28.089966666666665,1995,6,-1,216,241,-25
BR1_2689198514,3,False,0,1,0,16736,230,57,7.2,True,6,True,0,0,0,16444,185,55,7.2,False,29.993583333333333,292,-3,0,287,240,47
BR1_2730215982,6,True,0,1,0,16297,213,52,7.0,True,3,False,1,0,0,14234,179,60,6.4,False,26.6866,2063,3,-1,265,239,26
BR1_2730188636,11,True,0,1,0,18917,182,52,6.8,False,8,False,0,0,0,17764,210,48,7.0,True,25.478833333333334,1153,3,0,234,258,-24
BR1_2730167117,9,True,0,0,0,17210,174,48,7.0,True,3,False,0,0,0,13498,158,56,6.4,False,25.0015,3712,6,0,222,214,8
BR1_2729395183,5,False,0,1,0,17243,185,64,7.4,True,3,True,0,0,0,14186,162,44,7.0,False,28.78248333333333,3057,2,0,249,206,43
BR1_2717657049,8,False,1,0,0,16664,176,48,6.8,True,6,True,0,0,0,16161,171,48,7.0,False,28.926266666666667,503,2,1,224,219,5
BR1_2717631242,7,True,1,0,0,14539,149,52,6.6,True,5,False,0,0,0,15283,174,42,6.4,False,27.195566666666668,-744,2,1,201,216,-15
BR1_2680178978,8,False,1,0,0,16379,152,48,7.0,False,10,True,0,1,0,19126,207,48,7.2,True,29.260083333333334,-2747,-2,1,200,255,-55
BR1_2672579046,4,True,1,0,0,13813,187,36,7.0,True,1,False,0,0,0,13532,179,48,6.6,False,26.132733333333334,281,3,1,223,227,-4
BR1_2731299120,7,True,0,0,0,16085,191,40,7.0,False,5,False,1,0,0,16368,178,60,7.2,True,29.109066666666667,-283,2,-1,231,238,-7
BR1_2690632228,2,False,0,0,0,13349,174,52,6.6,False,6,True,1,1,0,15638,166,56,7.0,True,26.668783333333334,-2289,-4,-1,226,222,4
BR1_2731522398,8,True,0,0,0,16115,172,48,6.8,True,4,False,0,0,0,14658,148,52,6.6,False,25.309083333333334,1457,4,0,220,200,20
BR1_2729275160,9,True,0,0,0,17585,192,46,6.8,True,11,False,1,0,0,17662,192,36,6.6,False,28.355383333333332,-77,-2,-1,238,228,10
BR1_2729257656,4,True,0,1,0,14217,154,59,6.8,True,2,False,0,0,0,12944,171,36,6.4,False,27.0213,1273,2,0,213,207,6
BR1_2705017393,10,False,1,1,0,18291,161,60,7.4,True,4,True,0,0,0,15022,168,56,7.0,False,29.090533333333333,3269,6,1,221,224,-3
BR1_2726088522,4,False,0,0,0,14523,158,48,6.8,False,8,True,1,1,0,16693,176,48,7.0,True,27.7648,-2170,-4,-1,206,224,-18
BR1_2701664170,5,False,0,0,0,15426,160,48,6.6,False,10,True,1,0,0,18172,185,44,6.8,True,28.418166666666668,-2746,-5,-1,208,229,-21
BR1_2725656150,8,True,0,0,0,16824,209,40,7.0,False,8,False,1,0,0,17418,167,71,7.2,True,29.188416666666665,-594,0,-1,249,238,11
BR1_2725631571,2,False,0,0,0,13182,164,44,6.4,False,10,True,0,1,0,18709,194,40,6.6,True,25.2046,-5527,-8,0,208,234,-26
BR1_2727909947,7,True,0,0,0,16954,217,62,7.2,False,5,False,1,1,0,15625,193,48,7.2,True,29.91725,1329,2,-1,279,241,38
BR1_2730009940,6,False,0,0,0,16607,224,44,7.0,False,4,True,1,1,0,17111,192,64,7.2,True,29.682033333333333,-504,2,-1,268,256,12
BR1_2731548881,9,True,1,0,0,16285,160,52,6.8,True,6,False,0,1,0,14691,157,44,6.6,False,27.058283333333332,1594,3,1,212,201,11
BR1_2725297973,8,True,1,0,0,16374,195,36,6.6,False,9,False,0,0,0,17327,145,40,6.6,True,25.553466666666665,-953,-1,1,231,185,46
BR1_2721412226,12,True,1,1,0,17516,175,52,6.8,True,1,False,0,0,0,12844,166,32,6.6,False,25.531883333333333,4672,11,1,227,198,29
BR1_2725114164,4,True,0,0,0,13854,176,40,6.4,False,4,False,0,0,0,14083,147,46,6.4,True,25.38425,-229,0,0,216,193,23
BR1_2723503385,10,False,0,0,0,17921,176,52,7.0,False,7,True,0,0,0,17596,158,56,7.2,True,28.607066666666668,325,3,0,228,214,14
BR1_2723077511,6,True,1,0,0,15912,173,40,6.6,False,5,False,0,0,0,15803,181,48,7.0,True,29.813783333333333,109,1,1,213,229,-16
BR1_2728087235,3,False,0,1,0,14113,152,44,6.4,False,6,True,1,0,0,15189,156,36,6.2,True,25.448233333333334,-1076,-3,-1,196,192,4
BR1_2731372223,10,False,1,1,0,17578,141,48,6.4,True,9,True,0,0,0,16558,178,48,6.8,False,27.102033333333335,1020,1,1,189,226,-37
BR1_2731359920,4,True,1,0,0,14872,174,51,6.4,True,8,False,0,0,0,17839,210,61,7.0,False,26.369316666666666,-2967,-4,1,225,271,-46
BR1_2731366246,6,False,1,0,0,17255,197,57,7.0,False,8,True,0,1,0,18674,242,44,7.2,True,29.393616666666667,-1419,-2,1,254,286,-32
BR1_2723820522,4,False,0,0,0,14473,148,44,6.6,False,8,True,1,0,0,16501,192,52,6.6,True,25.757366666666666,-2028,-4,-1,192,244,-52
BR1_2726261931,16,True,0,0,0,21012,157,52,7.4,False,12,False,1,0,0,18914,145,60,6.8,True,28.608816666666666,2098,4,-1,209,205,4
BR1_2731140994,7,False,0,0,0,15978,184,44,7.2,False,7,True,1,1,0,17037,189,44,7.0,True,28.924333333333333,-1059,0,-1,228,233,-5
BR1_2731109843,3,False,0,0,0,15255,186,80,7.4,True,6,True,1,0,0,16906,206,52,7.4,False,29.787333333333333,-1651,-3,-1,266,258,8
BR1_2668218217,1,False,1,0,0,11787,113,43,6.2,False,5,True,0,0,0,15382,153,60,6.6,True,27.244783333333334,-3595,-4,1,156,213,-57
BR1_2713491996,9,True,0,0,0,17697,181,40,7.0,True,8,False,1,1,0,17735,203,76,7.4,False,27.87265,-38,1,-1,221,279,-58
BR1_2683600459,12,True,0,0,0,19762,233,68,7.2,True,4,False,0,0,0,15243,161,36,6.6,False,29.1213,4519,8,0,301,197,104
BR1_2673710719,1,False,0,0,0,12291,153,48,6.4,False,2,True,1,0,0,14750,202,52,6.6,True,25.174266666666668,-2459,-1,-1,201,254,-53
BR1_2672339199,9,False,0,0,0,17241,184,28,7.0,False,13,True,0,0,0,19947,169,40,7.6,True,28.401916666666665,-2706,-4,0,212,209,3
BR1_2680226873,7,True,1,0,0,15396,163,48,6.8,True,5,False,0,0,0,13301,129,40,6.6,False,27.309233333333335,2095,2,1,211,169,42
BR1_2720465633,4,False,1,0,0,15794,168,40,6.6,False,6,True,0,0,0,15571,166,44,6.4,True,29.863716666666665,223,-2,1,208,210,-2
BR1_2730017667,9,True,0,0,0,16700,171,52,6.8,True,3,False,1,0,0,13055,150,32,6.4,False,26.777316666666668,3645,6,-1,223,182,41
BR1_2721919214,11,False,1,1,0,19157,179,80,7.4,True,11,True,0,0,0,18877,159,48,7.0,False,28.590033333333334,280,0,1,259,207,52
BR1_2721894089,9,True,0,0,0,16865,192,40,6.6,True,3,False,1,0,0,13471,139,40,6.2,False,27.05175,3394,6,-1,232,179,53
BR1_2726508814,9,True,0,0,0,16931,196,53,7.0,True,2,False,1,1,0,13846,169,58,6.4,False,25.453283333333335,3085,7,-1,249,227,22
BR1_2722829845,10,False,1,0,0,18057,174,48,6.6,True,10,True,0,0,0,18479,179,56,7.2,False,29.571083333333334,-422,0,1,222,235,-13
BR1_2722735730,8,False,0,0,0,17107,159,53,6.8,False,14,True,1,0,0,18823,187,44,7.4,True,29.3663,-1716,-6,-1,212,231,-19
BR1_2729559515,10,True,1,1,0,17926,183,60,7.0,True,2,False,0,0,0,14879,202,44,7.0,False,29.365066666666667,3047,8,1,243,246,-3
BR1_2726992591,15,True,1,0,0,19621,156,56,7.0,True,5,False,0,1,0,15540,146,56,6.8,False,28.050083333333333,4081,10,1,212,202,10
BR1_2726900448,13,True,1,0,0,18492,172,56,7.2,True,7,False,0,0,0,15371,176,36,6.4,False,25.152033333333332,3121,6,1,228,212,16
BR1_2697580454,3,True,0,0,0,13497,157,40,6.2,False,5,False,0,0,0,15191,182,60,6.6,True,27.113166666666668,-1694,-2,0,197,242,-45
BR1_2731200947,8,True,1,1,0,18267,202,60,7.2,True,2,False,0,0,0,12925,121,52,6.4,False,25.577033333333333,5342,6,1,262,173,89
BR1_2729277462,7,True,1,0,0,16510,195,44,6.6,True,7,False,0,0,0,15170,128,60,6.6,False,26.153016666666666,1340,0,1,239,188,51
BR1_2690430486,3,False,0,1,0,15283,182,44,7.0,False,10,True,1,0,0,18614,193,60,7.6,True,27.6808,-3331,-7,-1,226,253,-27
BR1_2730480659,5,True,1,0,0,14380,149,44,6.8,True,4,False,0,1,0,13771,145,52,6.8,False,25.964066666666668,609,1,1,193,197,-4
BR1_2730461829,8,False,0,1,0,17700,183,44,7.4,False,7,True,1,0,0,17195,195,52,7.2,True,29.6893,505,1,-1,227,247,-20
BR1_2729903130,10,True,1,0,0,16338,132,64,6.4,False,9,False,0,1,0,16327,152,56,6.8,True,26.132616666666667,11,1,1,196,208,-12
BR1_2729587196,3,True,0,0,0,15929,221,68,7.2,False,6,False,1,1,1,19579,241,68,7.2,True,28.963016666666668,-3650,-3,-1,289,309,-20
BR1_2725696111,12,False,1,1,0,19879,185,64,7.6,True,7,True,0,0,0,14802,130,36,6.4,False,29.07668333333333,5077,5,1,249,166,83
BR1_2731433269,2,False,0,0,0,14317,191,48,7.2,True,7,True,1,0,0,16554,214,60,7.6,False,29.030116666666668,-2237,-5,-1,239,274,-35
BR1_2674858313,8,True,0,0,0,16277,169,47,7.2,True,4,False,1,0,0,13444,140,56,6.6,False,27.33955,2833,4,-1,216,196,20
BR1_2674818933,12,False,1,0,0,18291,182,48,7.8,True,3,True,0,1,0,16593,217,56,7.4,False,29.154533333333333,1698,9,1,230,273,-43
BR1_2723965418,6,False,0,0,1,15530,137,40,6.6,True,13,True,1,1,0,20267,181,56,7.2,False,28.323083333333333,-4737,-7,-1,177,237,-60
BR1_2731054398,9,False,0,1,0,16949,151,46,7.0,False,14,True,1,0,0,21321,236,53,7.4,True,29.916616666666666,-4372,-5,-1,197,289,-92
BR1_2731161848,7,True,1,1,0,17684,216,68,7.0,False,4,False,0,0,0,15827,235,36,7.2,True,27.653766666666666,1857,3,1,284,271,13
BR1_2721037913,4,False,0,0,0,15230,173,48,6.8,False,6,True,0,0,0,17894,236,68,7.2,True,29.69935,-2664,-2,0,221,304,-83
BR1_2701721787,4,True,0,0,0,13434,132,44,6.2,False,2,False,0,0,0,12427,184,32,6.4,True,27.451883333333335,1007,2,0,176,216,-40
BR1_2720975663,3,False,0,0,0,15047,202,58,7.4,False,8,True,1,0,0,18042,208,51,7.4,True,29.731983333333332,-2995,-5,-1,260,259,1
BR1_2728003630,7,True,1,0,0,16165,175,44,6.8,False,5,False,0,1,1,17593,214,60,7.2,True,27.502983333333333,-1428,2,1,219,274,-55
BR1_2725842024,6,False,0,0,0,16582,173,60,7.0,True,8,True,1,1,1,19056,214,52,7.2,False,29.7007,-2474,-2,-1,233,266,-33
BR1_2730949019,3,False,1,0,0,14062,164,56,6.4,True,6,True,0,1,0,15559,157,48,6.6,False,25.716483333333333,-1497,-3,1,220,205,15
BR1_2710898143,8,True,1,0,1,17974,171,64,6.6,True,5,False,0,0,0,15392,185,32,6.6,False,26.575083333333332,2582,3,1,235,217,18
BR1_2730130047,6,False,0,0,0,16597,142,48,6.8,False,12,True,0,0,0,18537,173,52,7.4,True,27.655266666666666,-1940,-6,0,190,225,-35
BR1_2730030746,7,False,0,0,0,16558,163,36,7.2,True,4,True,1,0,1,16949,192,52,7.0,False,29.687333333333335,-391,3,-1,199,244,-45
BR1_2729073450,8,False,0,0,0,16918,175,48,7.0,True,6,True,1,1,0,16480,173,60,6.8,False,28.884666666666668,438,2,-1,223,233,-10
BR1_2721260364,5,False,1,0,0,15622,184,56,7.0,False,9,True,0,1,0,18174,192,56,7.0,True,29.840916666666665,-2552,-4,1,240,248,-8
BR1_2726404257,8,False,0,0,0,16108,135,44,6.6,False,10,True,1,0,0,18790,167,56,7.0,True,29.306616666666667,-2682,-2,-1,179,223,-44
BR1_2726372844,11,False,0,0,0,17873,152,28,6.0,False,15,True,1,0,0,17922,118,39,5.6,True,26.15055,-49,-4,-1,180,157,23
BR1_2730282206,6,False,1,0,0,15618,158,48,6.6,True,6,True,0,0,0,15978,173,63,6.8,False,25.04515,-360,0,1,206,236,-30
BR1_2708625777,3,True,1,0,0,13621,180,68,6.8,True,1,False,0,0,0,11890,105,60,6.0,False,27.174516666666666,1731,2,1,248,165,83
BR1_2727847550,6,True,0,0,0,15287,146,52,6.6,True,5,False,1,1,0,14308,128,52,6.4,False,27.330666666666666,979,1,-1,198,180,18
BR1_2724293225,5,False,0,0,0,15427,187,48,7.2,False,11,True,1,1,0,19544,182,68,7.2,True,28.194216666666666,-4117,-6,-1,235,250,-15
BR1_2705061864,6,True,1,1,0,16620,187,48,6.6,True,3,False,0,0,0,12815,127,52,6.2,False,26.965683333333335,3805,3,1,235,179,56
BR1_2712476936,2,False,0,0,0,13340,165,47,6.4,False,9,True,1,0,0,16230,159,50,6.6,True,26.10575,-2890,-7,-1,212,209,3
BR1_2730127952,10,True,0,0,0,18241,206,40,6.6,True,4,False,0,0,0,14599,173,48,6.8,False,26.635316666666668,3642,6,0,246,221,25
BR1_2730091455,8,False,1,1,0,17064,198,68,7.0,True,3,True,0,0,0,14810,212,58,7.0,False,26.657733333333333,2254,5,1,266,270,-4
BR1_2731339375,9,True,0,0,0,15601,162,44,6.8,False,5,False,0,0,0,15233,196,48,6.6,True,25.3111,368,4,0,206,244,-38
BR1_2731291620,7,True,0,1,0,15174,157,52,6.6,False,4,False,1,0,0,15337,183,56,6.4,True,26.89695,-163,3,-1,209,239,-30
BR1_2730336470,7,True,1,0,0,15773,160,52,6.6,True,5,False,0,0,0,14854,166,52,6.4,False,25.49825,919,2,1,212,218,-6
BR1_2726314966,11,True,1,0,0,17713,183,43,6.6,True,3,False,0,0,0,14591,178,58,6.8,False,27.10175,3122,8,1,226,236,-10
BR1_2668907413,10,True,1,0,0,18500,192,63,7.8,True,11,False,0,0,0,17340,168,44,7.8,False,29.50635,1160,-1,1,255,212,43
BR1_2710764511,4,True,0,0,0,14713,193,40,6.4,False,6,False,1,0,0,15057,185,52,6.8,True,26.194866666666666,-344,-2,-1,233,237,-4
BR1_2728026991,9,True,1,1,1,18948,214,28,7.2,True,9,False,0,0,0,17618,163,64,7.0,False,28.157866666666667,1330,0,1,242,227,15
BR1_2730977381,12,False,0,0,0,17290,191,40,6.6,False,7,True,1,0,0,15480,197,56,6.6,True,26.9758,1810,5,-1,231,253,-22
BR1_2730392418,6,True,1,1,0,16434,189,60,7.0,True,0,False,0,0,0,12779,164,56,6.4,False,26.046366666666668,3655,6,1,249,220,29
BR1_2730601679,7,True,0,0,0,16250,174,20,6.6,True,7,False,0,0,0,14535,155,20,6.0,False,26.738766666666667,1715,0,0,194,175,19
BR1_2693637525,7,True,1,0,0,14966,112,64,6.0,False,7,False,0,1,0,16376,188,45,6.2,True,26.613183333333332,-1410,0,1,176,233,-57
BR1_2688757845,2,True,0,0,0,16464,232,64,7.4,True,5,False,1,0,0,16924,238,68,7.6,False,29.102816666666666,-460,-3,-1,296,306,-10
BR1_2731573055,3,False,0,0,0,14312,164,53,6.4,False,7,True,0,0,0,16553,180,40,7.0,True,27.038383333333332,-2241,-4,0,217,220,-3
BR1_2731483653,7,True,0,0,0,16630,188,54,7.2,False,3,False,0,1,0,15007,155,42,6.8,True,29.0886,1623,4,0,242,197,45
BR1_2731434768,7,True,1,0,0,15684,169,52,6.6,True,7,False,0,1,0,13640,111,36,6.0,False,27.06275,2044,0,1,221,147,74
BR1_2710409719,3,False,1,0,0,15822,212,68,7.4,False,6,True,0,0,0,16952,191,59,7.4,True,29.47511666666667,-1130,-3,1,280,250,30
BR1_2699396823,5,False,0,0,0,14795,147,48,6.2,True,13,True,0,0,0,17321,151,32,6.6,False,26.1039,-2526,-8,0,195,183,12
BR1_2730277441,8,False,1,0,0,15972,150,52,6.4,True,5,True,0,1,0,14294,153,51,6.4,False,27.197916666666668,1678,3,1,202,204,-2
BR1_2719763364,16,True,0,1,0,18306,137,38,6.6,True,3,False,1,0,0,12812,133,36,6.2,False,27.2606,5494,13,-1,175,169,6
BR1_2690185207,11,True,0,1,0,16922,172,56,7.0,True,2,False,1,0,0,13326,146,60,6.2,False,27.010916666666667,3596,9,-1,228,206,22
BR1_2701729815,5,False,1,1,0,15469,188,68,6.8,True,5,True,0,0,0,15452,183,40,6.2,False,25.84095,17,0,1,256,223,33
BR1_2713042376,6,True,1,0,0,16006,207,60,7.4,False,4,False,0,1,0,16615,214,60,7.6,True,28.790033333333334,-609,2,1,267,274,-7
BR1_2698471493,10,True,1,1,0,19270,194,65,7.2,True,5,False,0,0,0,15990,161,68,7.4,False,28.468233333333334,3280,5,1,259,229,30
BR1_2698446645,6,False,0,1,0,15504,174,40,6.2,False,11,True,1,0,0,19539,221,52,7.2,True,27.944633333333332,-4035,-5,-1,214,273,-59
BR1_2715551352,3,False,0,0,0,13210,153,28,6.2,False,8,True,1,0,0,15767,173,40,6.8,True,26.184516666666667,-2557,-5,-1,181,213,-32
BR1_2714616240,7,False,0,0,0,17193,226,52,7.2,False,7,True,0,1,0,17988,200,56,7.2,True,28.974666666666668,-795,0,0,278,256,22
BR1_2696970892,4,False,0,0,0,15101,179,56,7.0,False,7,True,1,0,0,17920,184,64,7.2,True,27.56605,-2819,-3,-1,235,248,-13
BR1_2703014851,8,False,1,0,0,18294,204,44,7.0,True,4,True,0,1,0,15869,174,60,7.0,False,28.631933333333333,2425,4,1,248,234,14
BR1_2730086531,12,True,1,0,0,17797,205,76,7.0,True,1,False,0,0,0,13803,203,34,6.6,False,27.1273,3994,11,1,281,237,44
BR1_2730066232,11,False,1,0,0,17879,156,47,6.8,False,12,True,0,0,0,17984,138,47,6.8,True,27.636966666666666,-105,-1,1,203,185,18
BR1_2729464995,6,False,0,1,0,17018,164,56,7.2,False,7,True,1,0,0,17179,190,44,7.0,True,28.6518,-161,-1,-1,220,234,-14
BR1_2724670299,5,True,1,0,0,15783,214,52,7.4,True,3,False,0,0,0,15430,221,48,7.2,False,29.883166666666668,353,2,1,266,269,-3
BR1_2730295240,9,False,0,1,0,17722,179,52,6.8,True,8,True,1,0,0,18050,181,48,7.0,False,28.240116666666665,-328,1,-1,231,229,2
BR1_2728159786,11,True,0,0,0,18773,175,36,6.4,True,8,False,1,0,0,15183,103,38,6.2,False,29.783666666666665,3590,3,-1,211,141,70
BR1_2727791770,8,False,0,0,0,17363,187,56,7.0,False,12,True,0,1,0,19837,183,56,7.2,True,29.390666666666668,-2474,-4,0,243,239,4
BR1_2688536317,7,False,1,0,0,16793,178,52,6.8,False,6,True,0,0,0,16862,189,40,7.0,True,27.716483333333333,-69,1,1,230,229,1
BR1_2683365430,6,True,1,1,0,16332,168,47,7.4,True,7,False,0,0,0,16257,203,53,7.2,False,27.778116666666666,75,-1,1,215,256,-41
BR1_2697705423,7,True,1,0,0,16949,192,48,7.4,True,1,False,0,1,0,14796,197,56,7.2,False,28.97345,2153,6,1,240,253,-13
BR1_2721077466,3,True,0,0,0,13680,155,48,6.4,False,5,False,1,0,0,14480,137,44,6.6,True,26.966266666666666,-800,-2,-1,203,181,22
BR1_2719421072,11,False,0,1,0,17702,153,44,6.8,True,16,True,0,0,0,20265,196,48,7.2,False,29.075633333333332,-2563,-5,0,197,244,-47
BR1_2731568074,2,True,1,0,0,12740,151,40,6.6,False,3,False,0,1,0,14235,153,64,7.0,True,26.3401,-1495,-1,1,191,217,-26
BR1_2706048952,3,False,1,1,0,14649,186,52,6.6,True,3,True,0,0,0,13239,145,36,6.2,False,26.869216666666667,1410,0,1,238,181,57
BR1_2703318343,5,True,1,1,0,17743,190,68,7.4,True,1,False,0,0,0,14501,188,60,7.2,False,29.355733333333333,3242,4,1,258,248,10
BR1_2703303138,3,False,0,0,0,14157,173,52,6.8,False,5,True,1,1,0,14970,163,48,6.6,True,27.24145,-813,-2,-1,225,211,14
BR1_2691883112,10,False,0,0,0,17019,135,36,6.0,False,18,True,1,0,0,20159,203,36,6.8,True,27.008533333333332,-3140,-8,-1,171,239,-68
BR1_2730659157,13,True,0,0,0,19777,169,71,7.0,True,8,False,0,0,0,16469,145,44,6.2,False,29.400383333333334,3308,5,0,240,189,51
BR1_2727488811,2,False,0,1,0,15878,204,60,7.2,False,10,True,1,0,0,18151,196,48,7.8,True,28.517083333333332,-2273,-8,-1,264,244,20
BR1_2726270791,6,False,0,0,0,14298,146,39,6.4,False,10,True,1,1,0,18525,164,56,6.4,True,26.325416666666666,-4227,-4,-1,185,220,-35
BR1_2713716521,5,False,1,0,0,16207,223,52,7.2,False,6,True,0,0,0,17541,241,58,7.4,True,28.46245,-1334,-1,1,275,299,-24
BR1_2713620530,14,False,1,0,0,18672,158,52,6.6,False,9,True,0,0,0,17453,165,52,6.4,True,26.671966666666666,1219,5,1,210,217,-7
BR1_2729985686,12,True,0,0,0,19397,153,48,6.8,False,8,False,1,1,0,17527,165,48,6.8,True,28.024583333333332,1870,4,-1,201,213,-12
BR1_2717665631,8,True,1,0,0,18200,215,60,7.2,False,4,False,0,1,0,15240,199,48,7.0,True,29.0823,2960,4,1,275,247,28
BR1_2729900021,14,False,1,0,0,17983,169,56,7.2,True,3,True,0,1,0,14928,171,40,6.8,False,27.962533333333333,3055,11,1,225,211,14
BR1_2719718241,2,False,0,0,0,13581,151,48,7.0,False,2,True,0,0,0,15627,191,56,7.4,True,28.54335,-2046,0,0,199,247,-48
BR1_2719227170,11,True,1,0,0,17158,153,52,6.8,True,4,False,0,0,0,13631,159,36,6.2,False,27.3385,3527,7,1,205,195,10
BR1_2726598165,7,False,1,0,0,16172,175,31,7.2,True,4,True,0,1,0,16370,198,44,7.2,False,29.967183333333335,-198,3,1,206,242,-36
BR1_2716625341,4,False,0,0,0,14312,184,48,6.4,False,7,True,1,0,0,16500,218,48,6.8,True,26.41835,-2188,-3,-1,232,266,-34
BR1_2675061659,11,True,0,0,0,16014,129,46,6.4,True,5,False,0,0,0,13989,141,38,6.2,False,25.054883333333333,2025,6,0,175,179,-4
BR1_2708888914,2,False,1,1,0,13554,158,67,6.4,True,9,True,0,0,0,15524,160,28,6.6,False,27.357666666666667,-1970,-7,1,225,188,37
BR1_2730925640,2,False,0,0,0,15125,213,40,7.4,False,11,True,1,0,0,18787,192,56,7.0,True,29.521683333333332,-3662,-9,-1,253,248,5
BR1_2731394853,9,True,0,0,1,18737,162,36,7.0,False,17,False,1,1,1,23754,200,63,7.4,True,27.870016666666668,-5017,-8,-1,198,263,-65
BR1_2691260967,20,True,1,1,0,21403,193,64,7.6,True,8,False,0,0,0,17858,154,52,7.0,False,29.601166666666668,3545,12,1,257,206,51
BR1_2689208516,4,True,0,0,0,12341,118,24,6.0,False,9,False,0,0,0,17228,195,52,7.0,True,27.264133333333334,-4887,-5,0,142,247,-105
BR1_2692115514,3,False,0,0,0,13293,149,44,6.2,False,9,True,0,0,0,16236,172,36,6.6,True,26.702416666666668,-2943,-6,0,193,208,-15
BR1_2692080381,3,False,0,0,0,15530,194,48,7.2,False,5,True,0,0,0,15599,178,64,7.2,True,29.18455,-69,-2,0,242,242,0
BR1_2706800825,10,True,1,1,0,18564,179,64,7.6,True,5,False,0,0,0,15673,170,52,6.4,False,27.707766666666668,2891,5,1,243,222,21
BR1_2708528671,5,True,0,0,0,13912,165,28,6.6,False,9,False,0,0,0,17074,213,44,6.8,True,25.897166666666667,-3162,-4,0,193,257,-64
BR1_2675294778,10,False,0,1,0,18086,205,52,7.2,False,15,True,1,0,0,20865,225,60,7.8,True,28.98765,-2779,-5,-1,257,285,-28
BR1_2711445168,7,False,0,0,0,16585,164,32,6.4,False,10,True,1,1,0,18038,169,44,6.8,True,29.069733333333332,-1453,-3,-1,196,213,-17
BR1_2710203164,10,False,1,1,0,18430,187,64,7.2,True,5,True,0,0,0,16047,203,44,7.0,False,28.555516666666666,2383,5,1,251,247,4
BR1_2731441194,2,False,0,0,0,13838,126,48,7.0,False,4,True,1,1,0,15578,201,56,7.2,True,29.6915,-1740,-2,-1,174,257,-83
BR1_2731195529,4,False,0,0,0,14619,189,48,6.8,True,5,True,0,0,0,13837,142,40,6.4,False,25.575266666666668,782,-1,0,237,182,55
BR1_2730895176,6,True,0,0,0,15311,159,56,6.8,True,5,False,1,0,0,14155,178,40,7.0,False,27.187783333333332,1156,1,-1,215,218,-3
BR1_2692825000,3,False,0,0,0,13069,154,40,6.6,False,9,True,1,0,0,16171,157,48,7.0,True,26.95165,-3102,-6,-1,194,205,-11
BR1_2692816355,10,True,1,1,0,18069,169,56,7.4,True,2,False,0,0,0,13257,145,40,6.4,False,27.59275,4812,8,1,225,185,40
BR1_2691870961,8,True,1,0,0,15829,172,51,6.8,True,2,False,0,1,0,13155,184,42,6.6,False,26.235516666666665,2674,6,1,223,226,-3
BR1_2692200369,7,True,0,1,0,18615,236,48,7.4,True,1,False,0,0,0,13556,181,48,7.0,False,28.81205,5059,6,0,284,229,55
BR1_2687077644,8,True,0,0,0,16543,153,64,7.4,True,11,False,1,1,0,19639,194,48,7.4,False,28.583566666666666,-3096,-3,-1,217,242,-25
BR1_2718511015,3,False,0,0,0,14112,162,52,6.6,True,5,True,0,0,0,15055,165,52,6.6,False,27.184316666666668,-943,-2,0,214,217,-3
BR1_2726209392,3,True,1,0,0,13831,148,52,6.6,False,4,False,0,1,0,15466,178,56,7.0,True,26.062683333333332,-1635,-1,1,200,234,-34
BR1_2726014675,2,False,0,0,0,13345,172,46,6.6,False,4,True,1,0,0,14505,181,60,6.4,True,26.083433333333332,-1160,-2,-1,218,241,-23
BR1_2730706529,3,False,0,0,0,13429,152,40,6.4,False,7,True,1,0,0,15500,159,48,6.6,True,26.825683333333334,-2071,-4,-1,192,207,-15
BR1_2728013580,4,False,1,1,0,14483,135,56,6.6,True,5,True,0,0,0,14987,165,40,6.6,False,26.901716666666665,-504,-1,1,191,205,-14
BR1_2728460234,11,True,1,1,0,19387,192,62,7.8,True,2,False,0,0,0,14421,205,38,6.8,False,27.518266666666666,4966,9,1,254,243,11
BR1_2715215582,10,True,1,1,0,19419,186,52,7.2,True,4,False,0,0,0,14207,144,48,7.2,False,29.411783333333332,5212,6,1,238,192,46
BR1_2725847122,6,True,0,0,0,14907,159,52,6.4,False,5,False,0,1,0,15705,207,48,6.8,True,25.19685,-798,1,0,211,255,-44
BR1_2709624312,5,True,0,1,0,14741,166,48,6.6,True,5,False,1,0,0,13671,150,47,6.6,False,26.2353,1070,0,-1,214,197,17
BR1_2703507767,6,True,0,1,0,15411,138,44,6.4,False,7,False,1,0,0,15780,186,44,6.6,True,26.354983333333333,-369,-1,-1,182,230,-48
BR1_2719516449,5,False,0,1,0,16821,179,68,7.2,False,6,True,1,0,0,18222,217,68,7.6,True,29.928883333333335,-1401,-1,-1,247,285,-38
BR1_2731614889,7,False,0,0,0,16300,154,44,6.8,True,6,True,1,0,0,16257,197,68,7.0,False,28.851266666666668,43,1,-1,198,265,-67
BR1_2710298547,6,False,0,0,0,14169,143,44,6.4,False,6,True,0,1,0,15285,162,52,6.6,True,27.388583333333333,-1116,0,0,187,214,-27
BR1_2710261062,4,False,1,1,0,14651,154,52,6.6,False,9,True,0,0,0,17578,179,52,6.6,True,25.030533333333334,-2927,-5,1,206,231,-25
BR1_2731604401,6,False,0,0,0,14394,124,48,6.4,False,10,True,1,0,0,16658,160,60,6.8,True,27.48785,-2264,-4,-1,172,220,-48
BR1_2731508718,3,False,0,0,0,14711,167,76,7.4,True,6,True,1,0,0,16533,196,44,7.2,False,28.866716666666665,-1822,-3,-1,243,240,3
BR1_2707536874,4,False,0,0,0,13971,119,40,6.4,False,10,True,1,1,0,17221,182,52,6.6,True,25.302333333333333,-3250,-6,-1,159,234,-75
BR1_2683868839,12,True,0,0,0,18458,170,52,6.8,True,11,False,0,0,0,17802,174,48,6.8,False,25.26481666666667,656,1,0,222,222,0
BR1_2722931912,6,False,0,0,0,15523,166,54,6.8,False,5,True,1,0,0,15788,195,44,6.8,True,29.013866666666665,-265,1,-1,220,239,-19
BR1_2720660042,1,True,0,0,0,11760,139,36,5.4,False,7,False,1,0,1,16008,169,48,6.8,True,26.011783333333334,-4248,-6,-1,175,217,-42
BR1_2712528322,6,False,0,1,0,14770,157,44,6.8,False,4,True,1,0,0,14742,144,64,6.6,True,25.02235,28,2,-1,201,208,-7
BR1_2731611882,7,False,1,0,0,15350,153,44,6.2,False,7,True,0,0,0,14158,115,49,6.2,True,26.354683333333334,1192,0,1,197,164,33
BR1_2731280418,5,True,1,1,1,17535,164,60,7.2,True,4,False,0,0,0,14254,153,52,6.6,False,29.600783333333332,3281,1,1,224,205,19
BR1_2730367512,12,False,1,0,0,17882,117,52,6.4,False,12,True,0,0,0,19173,158,58,6.8,True,27.598883333333333,-1291,0,1,169,216,-47
BR1_2707289598,4,True,0,0,0,14709,188,63,6.8,False,2,False,1,1,0,13245,152,48,7.0,True,25.736216666666667,1464,2,-1,251,200,51
BR1_2702885984,7,False,0,0,0,15228,155,36,6.4,False,3,True,1,1,0,14187,161,48,6.6,True,25.649083333333333,1041,4,-1,191,209,-18
BR1_2691114338,10,False,1,0,0,17656,174,52,7.2,True,4,True,0,0,0,13982,130,56,6.6,False,28.75883333333333,3674,6,1,226,186,40
BR1_2730833307,2,False,1,0,0,14970,183,52,7.2,False,6,True,0,0,0,15617,179,48,7.2,True,27.689866666666667,-647,-4,1,235,227,8
BR1_2730786074,4,False,0,0,0,16097,182,68,7.4,True,2,True,0,0,0,14524,166,56,7.0,False,29.93585,1573,2,0,250,222,28
BR1_2728901750,5,True,1,0,0,15589,171,40,6.6,True,1,False,0,0,0,12694,160,48,6.4,False,26.085,2895,4,1,211,208,3
BR1_2726253802,6,True,1,0,0,17191,229,64,7.2,False,3,False,0,0,0,14621,178,52,7.0,True,28.906133333333333,2570,3,1,293,230,63
BR1_2695521839,8,False,1,0,0,16167,162,48,6.6,True,5,True,0,1,0,16190,201,48,6.6,False,25.592666666666666,-23,3,1,210,249,-39
BR1_2731640125,7,False,1,0,0,15848,168,56,6.4,True,11,True,0,0,0,16988,158,64,6.6,False,25.733916666666666,-1140,-4,1,224,222,2
BR1_2686818779,4,False,0,0,1,15961,165,51,6.6,True,3,True,0,0,0,13196,143,43,5.4,False,26.787416666666665,2765,1,0,216,186,30
BR1_2674642071,7,False,0,1,0,16196,143,60,7.2,True,4,True,1,0,0,15217,158,48,7.0,False,29.4006,979,3,-1,203,206,-3
BR1_2669473676,5,False,1,0,0,16778,213,56,7.6,True,2,True,0,0,0,14560,208,40,7.2,False,29.175616666666667,2218,3,1,269,248,21
BR1_2729019846,3,False,0,0,0,13431,172,40,6.8,False,10,True,1,0,0,16919,155,44,6.6,True,27.186966666666667,-3488,-7,-1,212,199,13
BR1_2728589623,4,True,1,0,0,14737,174,48,7.0,True,3,False,0,0,0,12978,149,49,6.6,False,26.613566666666667,1759,1,1,222,198,24
BR1_2688459208,8,False,0,0,0,14689,120,50,6.4,True,9,True,0,0,0,15060,139,45,6.6,False,26.5125,-371,-1,0,170,184,-14
BR1_2688424947,5,True,1,1,0,17129,195,52,7.2,True,2,False,0,0,0,13274,144,48,7.0,False,27.599116666666667,3855,3,1,247,192,55
BR1_2688217063,5,True,1,0,0,14757,177,44,6.4,True,6,False,0,0,0,15020,155,44,6.2,False,26.103583333333333,-263,-1,1,221,199,22
BR1_2688199357,9,True,1,1,0,16960,159,52,7.0,True,8,False,0,0,0,17483,188,40,7.2,False,29.564583333333335,-523,1,1,211,228,-17
BR1_2726179377,9,True,0,0,0,15702,173,48,6.6,False,4,False,0,1,0,13630,142,56,6.4,True,26.38981666666667,2072,5,0,221,198,23
BR1_2726133317,5,True,1,1,0,15855,199,50,6.8,True,5,False,0,0,0,14791,190,36,7.2,False,29.3946,1064,0,1,249,226,23
BR1_2726100491,11,True,1,0,0,17410,150,44,7.0,False,11,False,0,1,0,19450,211,60,7.4,True,29.08716666666667,-2040,0,1,194,271,-77
BR1_2713850242,7,True,1,0,0,16596,188,43,7.0,True,2,False,0,0,0,12815,145,36,6.2,False,25.62815,3781,5,1,231,181,50
BR1_2731450745,7,True,0,1,0,15921,173,52,7.0,True,2,False,1,0,0,12557,132,48,6.2,False,25.76305,3364,5,-1,225,180,45
BR1_2730609307,12,False,0,0,0,20694,218,60,7.6,True,4,True,1,1,0,16395,199,48,7.0,False,28.465766666666667,4299,8,-1,278,247,31
BR1_2720374454,6,True,0,0,0,16068,164,36,6.8,True,3,False,1,0,0,15098,151,58,6.8,False,29.134216666666667,970,3,-1,200,209,-9
BR1_2731337688,6,False,1,0,0,17497,225,68,7.2,True,8,True,0,0,0,18290,205,60,7.6,False,29.2636,-793,-2,1,293,265,28
BR1_2731326515,8,False,0,0,0,16901,159,44,6.4,False,17,True,1,1,0,21158,178,60,6.8,True,27.4952,-4257,-9,-1,203,238,-35
BR1_2728086350,8,False,1,0,0,18219,223,52,7.2,False,12,True,0,0,0,20264,188,64,7.2,True,28.204133333333335,-2045,-4,1,275,252,23
BR1_2730642582,6,True,0,0,0,15472,177,44,6.8,True,4,False,1,1,0,15956,203,52,7.0,False,29.094416666666667,-484,2,-1,221,255,-34
BR1_2730569865,3,False,1,0,0,12229,116,44,5.2,False,5,True,0,1,1,17103,184,56,6.8,True,26.837833333333332,-4874,-2,1,160,240,-80
BR1_2730537970,5,True,0,0,0,15547,192,56,7.4,False,5,False,1,0,0,16454,223,60,7.4,True,29.391216666666665,-907,0,-1,248,283,-35
BR1_2714507618,6,False,0,1,0,17362,203,68,7.2,False,14,True,0,0,0,20031,207,52,7.2,True,29.71325,-2669,-8,0,271,259,12
BR1_2731207832,5,True,1,0,0,16807,180,56,7.2,True,4,False,0,0,0,14284,144,64,6.8,False,29.03921666666667,2523,1,1,236,208,28
BR1_2731172490,6,True,1,0,0,15246,180,44,7.0,True,3,False,0,0,0,15369,206,60,7.0,False,27.55365,-123,3,1,224,266,-42
BR1_2693792523,4,True,1,0,0,13517,142,44,6.6,False,4,False,0,0,0,13356,169,40,6.4,True,25.258016666666666,161,0,1,186,209,-23
BR1_2731218888,10,True,0,0,0,17377,165,40,7.0,True,4,False,0,0,0,14040,160,24,6.2,False,27.8897,3337,6,0,205,184,21
BR1_2731632349,6,True,1,0,0,16899,228,47,7.0,True,3,False,0,1,0,13582,150,44,6.2,False,25.867766666666668,3317,3,1,275,194,81
BR1_2731214854,19,True,0,0,0,20765,138,44,7.0,False,14,False,1,0,0,20880,183,48,7.2,True,27.71785,-115,5,-1,182,231,-49
BR1_2731166364,2,False,0,0,0,13855,158,60,6.6,False,8,True,1,0,0,16316,181,68,7.4,True,25.519616666666668,-2461,-6,-1,218,249,-31
BR1_2730157286,8,False,0,1,0,18143,206,60,7.4,True,5,True,0,0,0,16093,193,52,7.4,False,28.544933333333333,2050,3,0,266,245,21
BR1_2721631560,4,False,1,0,0,14086,147,60,6.8,True,4,True,0,0,0,13270,136,32,6.2,False,27.387666666666668,816,0,1,207,168,39
BR1_2731106464,10,False,1,0,0,18146,199,43,7.6,True,3,True,0,0,0,14356,168,52,7.2,False,28.8275,3790,7,1,242,220,22
BR1_2691901816,2,False,0,1,0,15493,186,44,7.0,False,3,True,0,0,0,14098,154,47,6.8,True,28.0859,1395,-1,0,230,201,29
BR1_2673063375,6,True,0,0,0,15778,167,48,6.8,True,1,False,1,1,0,12664,139,44,6.8,False,26.76495,3114,5,-1,215,183,32
BR1_2730780534,7,True,0,0,0,14881,131,40,6.4,False,6,False,1,0,0,15143,154,52,6.8,True,25.730283333333333,-262,1,-1,171,206,-35
BR1_2730740855,7,True,0,0,0,15329,143,60,6.8,False,3,False,1,0,0,14434,209,52,6.6,True,26.627183333333335,895,4,-1,203,261,-58
BR1_2730548448,6,False,0,0,0,15784,142,44,6.8,False,14,True,0,1,0,20436,195,48,7.0,True,29.26493333333333,-4652,-8,0,186,243,-57
BR1_2699224877,8,False,0,0,0,17967,181,44,7.2,True,7,True,1,0,0,16306,174,60,7.0,False,29.7815,1661,1,-1,225,234,-9
BR1_2726782275,1,False,0,0,0,12348,167,36,6.4,False,8,True,1,1,0,16755,159,51,6.8,True,26.664133333333332,-4407,-7,-1,203,210,-7
BR1_2726600401,8,False,0,0,0,16508,155,45,6.6,False,10,True,1,0,0,16532,147,38,6.2,True,27.183883333333334,-24,-2,-1,200,185,15
BR1_2710136940,10,False,0,0,0,17735,165,56,7.0,False,4,True,1,1,0,16514,184,60,7.0,True,27.796566666666667,1221,6,-1,221,244,-23
BR1_2720320742,6,False,1,0,0,16049,187,44,7.0,False,8,True,0,1,0,19432,246,64,7.4,True,29.35205,-3383,-2,1,231,310,-79
BR1_2720289473,5,False,1,0,0,16999,187,72,7.4,True,6,True,0,1,0,17680,219,56,7.4,False,29.271466666666665,-681,-1,1,259,275,-16
BR1_2729510137,11,True,1,0,0,18206,157,56,7.0,False,4,False,0,1,0,16485,177,60,7.2,True,28.9661,1721,7,1,213,237,-24
BR1_2703341924,7,True,0,1,0,15712,144,52,6.8,False,6,False,0,0,0,15808,188,48,6.6,True,26.164816666666667,-96,1,0,196,236,-40
BR1_2663079872,1,False,0,0,0,12065,148,44,6.0,False,13,True,1,0,0,18126,160,59,6.8,True,25.600766666666665,-6061,-12,-1,192,219,-27
BR1_2731517889,2,False,0,0,0,13388,166,36,6.4,False,15,True,1,0,0,19494,178,48,6.8,True,26.69195,-6106,-13,-1,202,226,-24
BR1_2729825539,5,False,0,0,0,14366,139,44,6.6,False,2,True,1,0,0,13955,191,68,7.0,True,25.167583333333333,411,3,-1,183,259,-76
BR1_2713678874,8,False,0,1,0,17289,160,68,7.2,False,11,True,1,0,0,20901,253,52,7.4,True,27.982316666666666,-3612,-3,-1,228,305,-77
BR1_2713633573,6,False,0,1,0,16404,184,64,6.8,True,5,True,0,0,0,14566,172,36,6.4,False,26.465433333333333,1838,1,0,248,208,40
BR1_2709064090,10,True,0,0,0,16847,162,43,6.6,True,4,False,1,0,0,12888,118,44,6.4,False,25.535866666666667,3959,6,-1,205,162,43
BR1_2723308963,5,True,1,0,0,15275,179,52,6.6,True,7,False,0,1,0,15009,143,68,6.6,False,25.422066666666666,266,-2,1,231,211,20
BR1_2723221879,4,False,0,0,0,16237,202,55,6.8,False,6,True,0,0,0,17194,211,40,7.0,True,28.666383333333332,-957,-2,0,257,251,6
BR1_2703243754,4,True,0,0,0,12356,102,28,6.0,False,5,False,1,1,0,15838,179,52,6.8,True,26.0058,-3482,-1,-1,130,231,-101
BR1_2703237680,5,True,0,0,0,15412,187,48,6.6,True,4,False,0,0,0,13899,135,36,6.6,False,26.511683333333334,1513,1,0,235,171,64
BR1_2664619939,11,True,1,0,0,18571,221,60,7.0,True,1,False,0,0,0,12278,137,48,6.4,False,25.556716666666667,6293,10,1,281,185,96
BR1_2731196027,7,False,0,0,0,14945,158,43,6.6,True,4,True,1,0,0,14010,153,44,6.6,False,27.200016666666667,935,3,-1,201,197,4
BR1_2730788472,7,False,0,0,0,14889,156,40,6.4,False,9,True,0,0,0,16777,179,40,6.8,True,25.063716666666668,-1888,-2,0,196,219,-23
BR1_2730918447,0,False,0,1,0,13825,185,59,7.2,False,8,True,1,0,0,18282,232,48,7.4,True,28.170083333333334,-4457,-8,-1,244,280,-36
BR1_2730013434,4,True,0,0,0,15040,173,52,7.0,False,3,False,1,1,0,15672,208,48,7.2,True,29.917116666666665,-632,1,-1,225,256,-31
BR1_2729956269,3,True,0,0,0,16232,202,56,7.0,True,2,False,1,0,0,12432,130,56,6.2,False,26.535983333333334,3800,1,-1,258,186,72
BR1_2710280177,3,False,0,0,0,12707,140,36,6.2,False,4,True,1,0,0,14896,192,44,6.4,True,25.3671,-2189,-1,-1,176,236,-60
BR1_2681410804,11,False,1,1,0,16983,140,52,6.4,False,13,True,0,0,0,17995,145,40,6.2,True,25.6075,-1012,-2,1,192,185,7
BR1_2725510252,8,True,0,1,0,16730,183,64,6.8,True,5,False,0,0,0,14513,150,24,6.4,False,25.0253,2217,3,0,247,174,73
BR1_2725479715,10,True,1,1,0,18653,163,56,7.2,False,8,False,0,0,0,17266,183,56,7.4,True,29.926883333333333,1387,2,1,219,239,-20
BR1_2723737392,3,False,0,0,0,12472,135,35,6.2,False,9,True,1,1,0,16515,165,60,6.4,True,26.27938333333333,-4043,-6,-1,170,225,-55
BR1_2730076782,11,False,1,0,0,17217,180,45,7.0,True,6,True,0,1,0,14174,93,46,6.4,False,25.496533333333332,3043,5,1,225,139,86
BR1_2731644845,3,True,1,0,0,15757,196,64,7.0,True,6,False,0,0,0,15461,154,44,6.8,False,27.861933333333333,296,-3,1,260,198,62
BR1_2699513019,9,False,1,0,0,15444,142,40,6.4,True,12,True,0,1,0,18496,171,38,7.0,False,28.66315,-3052,-3,1,182,209,-27
BR1_2702518575,7,False,0,0,0,15864,114,39,7.0,False,3,True,0,1,0,16800,221,64,7.2,True,28.392316666666666,-936,4,0,153,285,-132
BR1_2729893273,4,True,0,0,0,14847,195,49,7.2,False,9,False,1,1,0,19435,224,56,7.4,True,28.991183333333332,-4588,-5,-1,244,280,-36
BR1_2714220401,3,True,0,0,0,13643,137,36,6.2,False,4,False,0,0,0,14572,152,40,6.4,True,26.917916666666667,-929,-1,0,173,192,-19
BR1_2713898958,11,True,1,1,0,18305,180,52,7.2,True,5,False,0,0,0,15521,154,32,7.0,False,28.56661666666667,2784,6,1,232,186,46
BR1_2716363245,8,False,0,0,0,15356,144,35,6.8,True,8,True,0,0,0,16311,160,60,6.8,False,26.105116666666667,-955,0,0,179,220,-41
BR1_2706779968,6,False,1,0,0,16693,195,56,7.2,False,12,True,0,1,0,19741,224,56,7.6,True,29.2871,-3048,-6,1,251,280,-29
BR1_2728404621,7,True,0,0,0,16620,176,48,6.8,True,4,False,1,0,0,15378,161,42,7.0,False,28.52165,1242,3,-1,224,203,21
BR1_2725392532,7,True,1,0,0,17201,208,60,7.4,True,5,False,0,0,0,15284,181,40,7.0,False,28.945766666666668,1917,2,1,268,221,47
BR1_2731370088,1,True,0,1,0,13582,198,40,6.6,True,1,False,0,0,0,12824,204,36,6.6,False,27.263183333333334,758,0,0,238,240,-2
BR1_2667915134,6,True,0,0,0,16647,192,52,7.6,False,5,False,1,1,0,16098,155,48,7.2,True,28.769266666666667,549,1,-1,244,203,41
BR1_2698399303,10,True,1,0,0,17097,164,45,7.0,True,4,False,0,0,0,15534,206,58,7.0,False,28.10345,1563,6,1,209,264,-55
BR1_2711884497,7,True,0,0,0,16298,191,44,6.8,True,5,False,0,0,0,15500,197,52,6.6,False,26.68685,798,2,0,235,249,-14
BR1_2723088850,4,False,1,0,0,14727,182,60,6.6,False,7,True,0,0,0,16592,212,44,6.8,True,26.1049,-1865,-3,1,242,256,-14
BR1_2702878473,5,False,0,0,0,14421,148,54,6.6,True,8,True,0,0,0,14932,141,34,6.4,False,27.141216666666665,-511,-3,0,202,175,27
BR1_2729079953,8,True,1,0,0,16093,144,48,6.6,False,6,False,0,1,0,17369,175,60,7.0,True,29.224133333333334,-1276,2,1,192,235,-43
BR1_2683320208,4,False,0,0,0,14270,158,40,6.2,True,14,True,1,0,0,18868,203,48,7.2,False,25.770516666666666,-4598,-10,-1,198,251,-53
BR1_2683293479,3,True,0,1,0,13377,153,56,7.0,False,2,False,1,0,0,13960,203,44,7.0,True,26.898966666666666,-583,1,-1,209,247,-38
BR1_2696597452,5,False,1,0,0,14962,152,48,6.8,False,9,True,0,0,0,17238,179,56,7.0,True,26.669933333333333,-2276,-4,1,200,235,-35
BR1_2670484267,12,True,1,1,0,18543,169,48,7.4,True,5,False,0,0,0,15788,158,44,6.8,False,29.033483333333333,2755,7,1,217,202,15
BR1_2707026523,7,True,0,1,0,17554,197,52,7.4,True,4,False,1,0,0,15218,183,40,6.8,False,29.86635,2336,3,-1,249,223,26
BR1_2731291649,9,False,1,1,0,16282,185,36,6.8,True,5,True,0,0,0,14825,186,60,6.8,False,26.240166666666667,1457,4,1,221,246,-25
BR1_2730730706,8,False,0,1,0,17989,190,67,7.4,False,19,True,1,0,0,21260,172,47,7.4,True,27.6104,-3271,-11,-1,257,219,38
BR1_2686974148,8,False,1,0,0,17043,189,58,7.6,True,6,True,0,0,0,14896,155,36,7.0,False,29.673866666666665,2147,2,1,247,191,56
BR1_2686271750,8,False,0,0,0,15833,151,48,6.8,False,11,True,1,1,0,17151,144,52,7.4,True,27.164316666666668,-1318,-3,-1,199,196,3
BR1_2667247187,1,False,0,0,0,14097,163,76,7.2,False,5,True,1,0,0,17110,223,68,7.6,True,29.982666666666667,-3013,-4,-1,239,291,-52
BR1_2687932163,9,False,0,0,0,17861,182,40,6.8,True,5,True,1,0,0,15807,182,60,7.0,False,27.920066666666667,2054,4,-1,222,242,-20
BR1_2731141570,6,False,1,0,0,15082,155,40,6.8,False,8,True,0,0,0,17533,197,48,7.0,True,27.808816666666665,-2451,-2,1,195,245,-50
BR1_2731624735,9,False,1,0,0,17458,196,44,6.8,True,2,True,0,0,0,12785,135,48,6.4,False,26.665566666666667,4673,7,1,240,183,57
BR1_2720945697,2,False,1,0,0,12616,157,48,6.6,False,6,True,0,1,0,15010,141,52,6.6,True,26.611383333333333,-2394,-4,1,205,193,12
BR1_2720874734,12,False,0,0,0,18970,185,35,7.0,True,8,True,0,0,0,17000,152,32,6.6,False,28.064916666666665,1970,4,0,220,184,36
BR1_2708467399,4,False,0,0,0,15101,177,56,6.6,False,7,True,0,0,0,18334,212,48,7.2,True,28.422633333333334,-3233,-3,0,233,260,-27
BR1_2692422553,10,True,0,0,0,17908,187,32,6.8,False,12,False,0,1,0,19718,199,64,7.2,True,28.831316666666666,-1810,-2,0,219,263,-44
BR1_2692403980,4,False,0,0,0,15452,169,60,7.0,False,12,True,0,1,0,18621,185,60,7.4,True,29.502116666666666,-3169,-8,0,229,245,-16
BR1_2731085507,8,False,0,0,0,15835,132,60,6.6,True,7,True,1,1,0,15651,154,48,6.8,False,25.587266666666668,184,1,-1,192,202,-10
BR1_2730702863,6,False,1,1,0,16918,220,72,7.8,False,5,True,0,0,0,17014,224,47,7.6,True,29.557766666666666,-96,1,1,292,271,21
BR1_2730406989,13,True,1,0,0,19181,188,68,7.4,True,2,False,0,0,0,14000,153,48,6.4,False,28.61925,5181,11,1,256,201,55
BR1_2692008972,4,True,1,0,0,14269,165,40,6.6,True,2,False,0,0,0,12352,137,40,6.0,False,26.514133333333334,1917,2,1,205,177,28
BR1_2718345219,7,True,1,0,0,15676,153,64,7.0,True,6,False,0,0,0,16966,208,52,7.4,False,29.91235,-1290,1,1,217,260,-43
BR1_2727518639,6,True,1,0,0,15828,163,51,6.8,False,5,False,0,0,0,15022,210,64,7.0,True,26.268183333333333,806,1,1,214,274,-60
BR1_2727492607,1,False,0,0,0,11609,113,36,6.2,False,10,True,0,0,0,17335,193,35,6.8,True,27.01605,-5726,-9,0,149,228,-79
BR1_2727423213,5,True,1,0,0,15106,175,52,6.6,False,2,False,0,1,0,13737,171,55,6.4,True,26.655933333333333,1369,3,1,227,226,1
BR1_2729976565,9,True,0,0,0,16406,165,52,6.6,True,7,False,0,0,0,14727,147,48,6.2,False,26.493233333333333,1679,2,0,217,195,22
BR1_2728928156,4,False,1,0,0,14395,187,64,6.8,False,14,True,0,0,0,19998,231,4,7.2,True,26.270933333333332,-5603,-10,1,251,235,16
BR1_2714908656,7,False,1,1,0,16394,176,52,6.8,True,5,True,0,0,0,16203,163,64,7.0,False,28.77055,191,2,1,228,227,1
BR1_2706765840,7,True,0,0,0,14673,143,36,6.0,False,5,False,1,0,0,14394,157,40,6.0,True,25.612016666666666,279,2,-1,179,197,-18
BR1_2728127796,3,False,0,0,0,13919,166,20,6.4,False,8,True,0,0,0,15560,150,44,6.4,True,27.229916666666668,-1641,-5,0,186,194,-8
BR1_2728122557,8,False,0,0,0,15133,120,44,6.0,False,12,True,1,1,0,17380,165,56,6.6,True,26.882016666666665,-2247,-4,-1,164,221,-57
BR1_2727514332,9,False,0,1,0,16344,167,48,6.4,True,7,True,0,0,0,14437,140,32,6.4,False,25.204366666666665,1907,2,0,215,172,43
BR1_2713958510,7,True,1,1,0,17972,219,60,7.2,True,4,False,0,0,0,15150,163,60,7.4,False,29.35035,2822,3,1,279,223,56
BR1_2706811140,4,True,0,0,0,12548,143,31,6.2,False,7,False,1,0,0,15374,182,42,6.8,True,25.761666666666667,-2826,-3,-1,174,224,-50
BR1_2701711303,6,False,0,0,0,15309,146,44,6.6,True,7,True,0,1,0,17527,193,52,7.2,False,29.24075,-2218,-1,0,190,245,-55
BR1_2698365440,4,True,0,0,0,14446,108,48,5.8,False,7,False,0,0,0,16362,183,56,7.0,True,27.6783,-1916,-3,0,156,239,-83
BR1_2729619445,5,True,1,1,0,14708,145,40,6.8,True,0,False,0,0,0,12288,159,58,6.6,False,26.5457,2420,5,1,185,217,-32
BR1_2728103499,9,True,0,1,0,19768,221,40,7.4,True,5,False,1,0,0,14709,112,51,6.6,False,29.151866666666667,5059,4,-1,261,163,98
BR1_2729504534,2,False,0,1,0,12468,149,38,6.6,False,6,True,1,0,0,14866,152,52,6.8,True,25.4598,-2398,-4,-1,187,204,-17
BR1_2728479755,9,False,1,0,0,16474,148,44,6.0,True,8,True,0,0,0,15507,147,43,6.2,False,25.51268333333333,967,1,1,192,190,2
BR1_2730801302,9,True,0,0,0,16568,163,42,6.4,True,2,False,1,0,0,12757,167,32,6.4,False,26.480333333333334,3811,7,-1,205,199,6
BR1_2700143563,7,True,0,0,0,17964,188,60,7.6,True,3,False,0,0,0,12964,125,52,6.0,False,28.2385,5000,4,0,248,177,71
BR1_2721711510,7,True,1,1,0,17772,209,68,7.4,True,2,False,0,0,0,14644,192,60,7.0,False,28.342933333333335,3128,5,1,277,252,25
BR1_2725788273,4,True,1,1,0,15575,194,51,7.2,True,3,False,0,0,0,15617,216,60,7.2,False,28.36635,-42,1,1,245,276,-31
BR1_2730195123,2,False,1,0,0,15524,188,84,7.2,False,6,True,0,1,0,16190,182,36,7.4,True,28.86575,-666,-4,1,272,218,54
BR1_2730151859,9,True,1,0,0,18444,202,68,7.6,True,5,False,0,1,0,16122,188,64,7.4,False,29.089433333333332,2322,4,1,270,252,18
BR1_2731525000,4,True,0,0,0,15589,176,64,7.2,False,4,False,1,1,0,16419,195,68,7.6,True,29.2289,-830,0,-1,240,263,-23
BR1_2695279302,6,True,1,1,0,16112,172,68,7.0,True,0,False,0,0,0,12092,154,48,6.4,False,26.327766666666665,4020,6,1,240,202,38
BR1_2695257872,13,True,0,0,0,18716,181,56,6.6,True,3,False,1,0,0,13849,161,64,6.6,False,26.42953333333333,4867,10,-1,237,225,12
BR1_2725805690,11,True,1,0,0,18872,175,52,7.2,True,4,False,0,0,0,14112,154,39,6.8,False,28.972816666666667,4760,7,1,227,193,34
BR1_2724249184,7,True,0,0,1,15796,151,34,6.2,False,11,False,1,1,0,20282,191,71,7.2,True,27.546716666666665,-4486,-4,-1,185,262,-77
BR1_2680721708,5,True,1,1,0,16700,171,72,7.2,True,0,False,0,0,0,13338,199,39,6.6,False,28.142366666666668,3362,5,1,243,238,5
BR1_2724882249,4,False,0,0,0,15673,209,48,7.0,False,10,True,0,0,0,19521,237,59,7.4,True,28.062933333333334,-3848,-6,0,257,296,-39
BR1_2672516908,5,False,0,0,0,13659,163,24,6.6,False,8,True,1,0,0,15587,150,52,6.8,True,26.556916666666666,-1928,-3,-1,187,202,-15
BR1_2723057588,20,True,1,0,0,21375,178,52,7.6,True,4,False,0,0,0,15052,126,48,7.0,False,29.872883333333334,6323,16,1,230,174,56
BR1_2689438203,5,False,0,0,0,13778,146,44,6.6,False,7,True,1,0,0,16059,203,57,7.0,True,27.413716666666666,-2281,-2,-1,190,260,-70
BR1_2731571129,9,True,1,0,0,17278,165,44,7.0,True,8,False,0,1,0,16663,156,48,6.8,False,29.627083333333335,615,1,1,209,204,5
BR1_2714835725,7,False,0,0,0,15412,154,32,6.8,False,14,True,0,1,0,20612,184,52,7.4,True,29.73155,-5200,-7,0,186,236,-50
BR1_2730800581,10,False,0,0,0,16553,163,48,6.8,True,10,True,0,0,0,15387,131,44,6.6,False,26.895633333333333,1166,0,0,211,175,36
BR1_2730773904,10,True,1,0,0,16339,155,36,6.4,True,5,False,0,0,0,14156,139,48,6.4,False,26.3278,2183,5,1,191,187,4
BR1_2704499662,1,False,0,1,0,12950,152,64,6.8,False,8,True,0,0,0,18030,204,36,6.8,True,26.861016666666668,-5080,-7,0,216,240,-24
BR1_2704413195,8,False,1,0,0,18495,205,52,7.2,True,5,True,0,1,0,16382,195,51,7.2,False,29.758166666666668,2113,3,1,257,246,11
BR1_2704361299,7,False,1,0,0,16272,143,60,6.8,True,6,True,0,1,0,16779,173,48,7.2,False,29.107016666666667,-507,1,1,203,221,-18
BR1_2702538346,9,False,0,0,0,18703,144,56,6.6,False,14,True,1,0,0,19305,162,44,7.0,True,29.677016666666667,-602,-5,-1,200,206,-6
BR1_2702439787,11,False,1,0,0,15709,119,60,6.4,True,4,True,0,0,0,13214,120,40,6.2,False,27.200866666666666,2495,7,1,179,160,19
BR1_2731629450,2,False,0,0,0,14020,175,48,6.8,False,9,True,1,0,0,17748,198,56,7.6,True,27.72475,-3728,-7,-1,223,254,-31
BR1_2730799758,8,False,0,1,0,17691,139,44,6.8,True,12,True,0,0,0,19598,192,46,7.2,False,29.82965,-1907,-4,0,183,238,-55
BR1_2717841150,7,False,0,1,0,16571,221,44,6.6,True,3,True,0,0,0,13280,117,52,6.4,False,26.683483333333335,3291,4,0,265,169,96
BR1_2731593120,2,True,0,1,0,13150,151,44,6.8,False,3,False,1,0,0,14286,180,56,6.8,True,26.0816,-1136,-1,-1,195,236,-41
BR1_2713413028,10,False,0,0,0,18602,175,56,7.6,True,6,True,1,0,0,16397,213,48,7.2,False,29.01125,2205,4,-1,231,261,-30
BR1_2713372777,10,False,0,0,0,15840,140,52,6.8,True,9,True,0,0,0,16253,160,56,7.2,False,25.2618,-413,1,0,192,216,-24
BR1_2709895513,10,True,1,0,0,16998,181,60,6.8,True,3,False,0,0,0,14071,150,44,6.6,False,27.09595,2927,7,1,241,194,47
BR1_2681975435,8,False,1,0,0,16795,201,51,7.2,True,8,True,0,1,0,17373,215,36,6.8,False,29.251833333333334,-578,0,1,252,251,1
BR1_2681703999,4,True,1,0,1,17230,208,48,7.0,False,12,False,0,0,0,18206,189,48,7.6,True,29.065883333333332,-976,-8,1,256,237,19
BR1_2730737093,7,False,1,0,0,14869,134,44,6.6,False,5,True,0,1,0,15549,171,72,7.2,True,25.696066666666667,-680,2,1,178,243,-65
BR1_2729496691,8,True,0,1,0,15848,131,58,6.0,False,10,False,1,0,0,16873,161,50,6.4,True,27.067916666666665,-1025,-2,-1,189,211,-22
BR1_2724141438,2,True,0,0,0,14076,179,65,6.8,True,2,False,0,0,0,13161,184,43,6.6,False,25.48075,915,0,0,244,227,17
BR1_2724115710,4,True,1,0,0,14547,210,44,6.6,True,1,False,0,0,0,11641,134,28,6.2,False,26.038633333333333,2906,3,1,254,162,92
BR1_2730166461,5,False,0,0,0,13517,124,28,5.6,False,12,True,0,0,0,18220,192,52,7.0,True,26.691066666666668,-4703,-7,0,152,244,-92
BR1_2689751653,7,False,1,1,0,16007,139,52,7.2,False,10,True,0,0,0,18257,168,44,6.6,True,29.8445,-2250,-3,1,191,212,-21
BR1_2689536709,9,True,1,1,0,16068,159,56,7.0,True,5,False,0,0,0,13541,118,36,6.4,False,25.709066666666665,2527,4,1,215,154,61
BR1_2688897802,8,True,0,0,0,15728,153,52,6.8,True,2,False,0,0,0,12803,176,43,6.8,False,26.45075,2925,6,0,205,219,-14
BR1_2721219542,4,True,1,0,0,14428,158,52,6.8,False,7,False,0,1,0,17533,169,60,7.2,True,28.67345,-3105,-3,1,210,229,-19
BR1_2730579863,4,False,0,0,0,14797,174,41,6.8,False,8,True,1,1,0,19014,229,60,7.2,True,28.617283333333333,-4217,-4,-1,215,289,-74
BR1_2731623228,10,False,0,0,0,16603,169,44,6.2,True,4,True,1,0,0,13871,141,52,6.4,False,25.833233333333332,2732,6,-1,213,193,20
BR1_2731640934,7,True,0,0,0,16195,142,44,7.0,False,11,False,1,0,0,18432,171,60,7.6,True,27.896716666666666,-2237,-4,-1,186,231,-45
BR1_2731201795,8,True,1,1,0,15869,151,54,6.8,True,4,False,0,0,0,14147,138,42,6.8,False,26.09565,1722,4,1,205,180,25
BR1_2730313332,7,False,1,0,0,15818,183,52,6.8,True,2,True,0,0,0,12765,147,56,6.2,False,26.593,3053,5,1,235,203,32
BR1_2725846097,6,True,0,0,0,16198,153,40,6.2,False,4,False,0,1,1,18060,209,52,7.0,True,29.029433333333333,-1862,2,0,193,261,-68
BR1_2731285169,5,False,0,1,0,17318,197,70,7.4,True,5,True,1,0,0,15783,190,56,7.4,False,27.963216666666668,1535,0,-1,267,246,21
BR1_2715234375,8,True,1,0,1,18082,197,44,7.2,True,5,False,0,1,0,16393,186,52,7.2,False,28.030666666666665,1689,3,1,241,238,3
BR1_2705154117,6,True,0,0,0,12767,115,28,5.8,False,1,False,0,0,0,13301,159,56,6.6,True,26.136116666666666,-534,5,0,143,215,-72
BR1_2674380734,9,True,0,1,1,19086,212,44,7.0,True,6,False,0,0,0,14646,143,40,6.0,False,25.186566666666668,4440,3,0,256,183,73
BR1_2673597615,8,True,0,0,0,15730,183,8,6.4,False,5,False,1,1,0,16200,186,60,7.2,True,28.603716666666667,-470,3,-1,191,246,-55
BR1_2731485027,8,True,0,0,0,15683,159,44,6.6,False,13,False,1,0,0,17789,138,48,6.6,True,25.95985,-2106,-5,-1,203,186,17
BR1_2729631765,9,True,0,1,1,18231,180,40,6.2,True,9,False,1,0,0,18376,191,68,7.6,False,27.9253,-145,0,-1,220,259,-39
BR1_2731563984,12,True,1,1,0,18555,171,60,7.2,True,6,False,0,0,0,15651,159,33,6.4,False,27.9154,2904,6,1,231,192,39
BR1_2731257218,9,True,0,0,0,16714,187,36,6.6,False,4,False,0,1,0,14624,155,36,6.4,True,26.674533333333333,2090,5,0,223,191,32
BR1_2724910300,4,False,0,0,0,15987,184,48,7.0,False,8,True,1,0,0,17193,177,60,7.2,True,28.481683333333333,-1206,-4,-1,232,237,-5
BR1_2724891724,9,True,0,0,0,15229,138,21,6.4,False,3,False,0,1,0,15058,139,54,7.2,True,29.13815,171,6,0,159,193,-34
BR1_2724587418,3,False,0,0,0,13299,138,59,6.6,False,6,True,1,0,0,17403,211,52,7.0,True,26.74155,-4104,-3,-1,197,263,-66
BR1_2730490826,7,False,1,0,0,13857,148,45,6.0,False,7,True,0,0,0,15685,159,42,6.4,True,26.079183333333333,-1828,0,1,193,201,-8
BR1_2730466428,5,False,0,0,0,14255,145,44,6.4,False,12,True,0,0,0,17600,169,52,6.8,True,26.539583333333333,-3345,-7,0,189,221,-32
BR1_2728704878,5,True,0,0,0,14892,167,56,6.6,True,2,False,1,0,0,13432,177,52,6.6,False,26.23235,1460,3,-1,223,229,-6
BR1_2691289864,5,True,1,0,0,15811,194,40,6.6,False,7,False,0,0,0,16766,180,48,7.0,True,27.59105,-955,-2,1,234,228,6
BR1_2731577416,6,False,0,0,0,14214,143,50,6.6,True,3,True,0,0,0,13592,187,32,6.6,False,25.881666666666668,622,3,0,193,219,-26
BR1_2730986579,6,False,0,0,0,14944,183,48,6.8,True,4,True,1,0,0,14486,177,44,6.2,False,25.559333333333335,458,2,-1,231,221,10
BR1_2702869103,4,False,0,0,0,12627,147,0,6.2,False,5,True,1,0,0,14457,135,52,6.8,True,27.386583333333334,-1830,-1,-1,147,187,-40
BR1_2698265371,6,False,1,0,0,15920,190,48,6.8,True,2,True,0,0,0,13413,163,56,6.4,False,26.4876,2507,4,1,238,219,19
BR1_2730713680,11,True,0,0,0,16574,119,44,6.2,False,8,False,1,0,0,16737,166,48,6.2,True,25.587416666666666,-163,3,-1,163,214,-51
BR1_2724956332,8,True,0,0,0,15601,180,39,6.2,True,7,False,1,0,0,14280,147,30,6.0,False,25.465333333333334,1321,1,-1,219,177,42
BR1_2708179482,7,False,0,0,0,15254,148,36,7.0,False,6,True,1,0,0,16466,217,60,7.0,True,29.867,-1212,1,-1,184,277,-93
BR1_2707657074,5,False,0,0,0,14936,132,32,6.2,False,14,True,1,0,0,18814,196,40,6.8,True,27.478133333333332,-3878,-9,-1,164,236,-72
BR1_2707030349,3,False,1,0,0,13502,133,51,6.6,False,12,True,0,1,0,19515,204,64,7.8,True,27.65438333333333,-6013,-9,1,184,268,-84
BR1_2731601013,2,False,0,0,0,14241,195,40,7.0,False,8,True,1,0,0,16938,195,68,7.4,True,28.191066666666668,-2697,-6,-1,235,263,-28
BR1_2730271128,6,True,1,0,0,16758,178,56,7.2,True,6,False,0,1,0,16075,168,44,7.2,False,28.666033333333335,683,0,1,234,212,22
BR1_2730235513,7,False,0,1,0,16530,152,60,7.0,True,4,True,0,0,0,15374,181,48,6.6,False,27.874383333333334,1156,3,0,212,229,-17
BR1_2730208670,7,True,1,0,0,15300,184,56,6.6,True,3,False,0,0,0,12642,124,60,6.6,False,25.31265,2658,4,1,240,184,56
BR1_2666082269,5,True,0,1,0,16324,172,64,7.2,True,7,False,0,0,0,18292,190,48,7.6,False,27.623816666666666,-1968,-2,0,236,238,-2
BR1_2704052895,3,True,0,1,0,15088,149,72,7.2,False,3,False,1,0,0,14976,178,48,7.4,True,29.970866666666666,112,0,-1,221,226,-5
BR1_2704000156,2,True,0,0,0,12881,146,40,6.2,False,5,False,1,1,0,14463,166,52,6.6,True,26.978683333333333,-1582,-3,-1,186,218,-32
BR1_2691135156,4,True,0,0,0,13416,139,44,6.2,False,11,False,1,1,0,16953,176,48,6.8,True,27.185016666666666,-3537,-7,-1,183,224,-41
BR1_2691124934,5,False,1,0,0,14819,197,60,6.8,True,4,True,0,0,0,14138,171,44,6.8,False,26.529783333333334,681,1,1,257,215,42
BR1_2696756069,5,True,0,0,0,15298,151,47,6.6,False,5,False,1,1,0,14753,165,48,6.4,True,25.4223,545,0,-1,198,213,-15
BR1_2696298922,5,True,1,0,0,14798,182,60,6.6,True,3,False,0,0,0,12901,194,5,5.8,False,26.98645,1897,2,1,242,199,43
BR1_2698938976,11,True,0,0,0,18848,204,56,7.0,False,8,False,0,1,0,18959,180,60,7.4,True,28.848916666666668,-111,3,0,260,240,20
BR1_2698912750,13,True,1,1,0,20609,186,68,7.4,True,8,False,0,0,0,16558,154,44,7.0,False,29.138966666666665,4051,5,1,254,198,56
BR1_2698704641,8,True,1,1,0,18211,193,60,7.2,True,9,False,0,0,0,17547,155,68,7.2,False,28.103933333333334,664,-1,1,253,223,30
BR1_2680399571,11,False,0,0,0,17980,218,48,7.8,True,5,True,0,0,0,15520,183,60,7.4,False,28.163433333333334,2460,6,0,266,243,23
BR1_2731600569,6,True,0,0,0,15487,161,64,7.0,False,3,False,1,0,0,12846,169,40,6.8,True,27.097433333333335,2641,3,-1,225,209,16
BR1_2731617180,3,False,1,1,0,15055,171,48,6.8,True,8,True,0,0,0,17624,225,44,7.2,False,28.152316666666668,-2569,-5,1,219,269,-50
BR1_2731264194,7,True,0,1,0,16356,160,48,6.8,False,4,False,0,0,0,15781,182,56,6.8,True,28.192733333333333,575,3,0,208,238,-30
BR1_2731233921,4,True,0,0,0,14306,186,52,6.4,False,5,False,0,0,0,15560,191,44,6.8,True,26.74885,-1254,-1,0,238,235,3
BR1_2731170803,5,False,0,0,0,15487,226,44,7.0,False,6,True,0,0,0,17136,185,56,7.0,True,27.629716666666667,-1649,-1,0,270,241,29
BR1_2731207289,7,False,0,1,0,16340,178,44,6.8,False,12,True,1,0,0,19537,214,60,7.6,True,28.707016666666668,-3197,-5,-1,222,274,-52
BR1_2731183199,7,False,0,0,0,15054,129,40,6.2,False,8,True,0,0,0,16579,170,44,6.6,True,26.136866666666666,-1525,-1,0,169,214,-45
BR1_2712705954,2,False,0,0,0,13675,147,48,6.2,False,12,True,1,0,0,19077,222,52,6.8,True,26.458933333333334,-5402,-10,-1,195,274,-79
BR1_2730077563,8,True,0,0,0,16602,191,60,7.0,True,2,False,0,0,0,13371,165,48,6.4,False,27.124666666666666,3231,6,0,251,213,38
BR1_2729373362,6,False,0,1,0,17421,221,44,6.6,True,8,True,0,0,0,17604,157,52,6.8,False,28.40213333333333,-183,-2,0,265,209,56
BR1_2681914251,5,True,1,1,0,17362,217,52,7.2,True,4,False,0,0,0,16145,229,52,7.2,False,28.431266666666666,1217,1,1,269,281,-12
BR1_2731348571,2,False,0,0,0,14716,222,46,6.8,False,6,True,1,1,0,16628,226,53,7.0,True,26.54395,-1912,-4,-1,268,279,-11
BR1_2730976792,7,True,0,1,0,17535,216,48,7.4,True,7,False,0,0,0,17486,223,56,7.6,False,29.65385,49,0,0,264,279,-15
BR1_2730473041,2,False,1,0,0,14575,200,56,7.2,False,9,True,0,0,0,19622,191,76,7.8,True,28.306233333333335,-5047,-7,1,256,267,-11
BR1_2706699904,5,False,0,1,0,15208,198,44,6.8,False,6,True,1,0,0,15731,156,64,6.8,True,25.87515,-523,-1,-1,242,220,22
BR1_2728099921,6,False,0,1,0,18159,219,61,7.6,True,5,True,1,0,0,16220,187,54,7.0,False,29.96865,1939,1,-1,280,241,39
BR1_2706965725,5,True,0,0,0,16501,195,64,7.2,True,3,False,1,1,0,16068,210,72,7.4,False,28.145,433,2,-1,259,282,-23
BR1_2697825860,12,True,1,0,0,18858,200,52,6.8,True,7,False,0,0,0,17463,189,48,7.0,False,29.576516666666667,1395,5,1,252,237,15
BR1_2697184522,14,True,1,0,0,18107,174,40,6.8,True,6,False,0,1,0,14286,135,52,6.0,False,26.731333333333332,3821,8,1,214,187,27
BR1_2696804111,6,False,0,0,0,14818,130,40,6.6,False,8,True,1,0,0,16510,200,28,6.6,True,26.9124,-1692,-2,-1,170,228,-58
BR1_2696943081,9,False,1,1,0,18441,200,61,7.8,True,3,True,0,0,0,15292,199,70,7.2,False,27.847066666666667,3149,6,1,261,269,-8
BR1_2698182598,1,True,1,0,0,11855,117,56,5.6,False,2,False,0,1,1,15796,206,40,7.2,True,25.700216666666666,-3941,-1,1,173,246,-73
BR1_2711905609,7,True,1,0,0,18022,229,60,7.2,False,8,False,0,1,0,18152,231,52,7.2,True,29.742133333333335,-130,-1,1,289,283,6
BR1_2704879623,8,False,0,0,0,16903,189,58,7.2,True,6,True,0,1,0,16677,197,42,6.8,False,29.48095,226,2,0,247,239,8
BR1_2729643295,3,False,1,1,0,12433,122,48,6.4,False,4,True,0,0,0,15290,190,41,7.0,True,26.706583333333334,-2857,-1,1,170,231,-61
BR1_2729611861,7,True,0,1,0,15125,150,44,6.4,False,10,False,1,0,0,17574,145,48,6.6,True,27.316533333333332,-2449,-3,-1,194,193,1
BR1_2727388572,11,True,1,0,0,19696,205,64,7.6,True,1,False,0,0,0,13315,163,40,6.6,False,29.434433333333335,6381,10,1,269,203,66
BR1_2722694247,4,False,1,0,0,16723,181,64,7.4,False,5,True,0,1,0,16732,190,60,7.0,True,29.08905,-9,-1,1,245,250,-5
BR1_2722691091,8,False,1,0,0,17337,211,32,6.8,True,6,True,0,0,0,15232,178,38,6.4,False,26.803466666666665,2105,2,1,243,216,27
BR1_2722682275,8,True,1,0,0,16095,165,32,7.0,False,5,False,0,1,0,17084,213,44,7.2,True,29.54885,-989,3,1,197,257,-60
BR1_2712419906,12,True,0,0,0,18147,192,52,6.8,True,2,False,0,0,0,12356,139,32,6.0,False,26.080716666666667,5791,10,0,244,171,73
BR1_2676989654,2,True,0,0,0,14515,180,32,7.0,False,5,False,1,0,0,16110,170,44,7.0,True,28.375916666666665,-1595,-3,-1,212,214,-2
BR1_2712712693,9,True,1,0,0,16531,154,44,7.2,True,9,False,0,0,0,18745,210,56,7.4,False,29.648616666666666,-2214,0,1,198,266,-68
BR1_2701459834,7,True,1,0,0,16618,173,51,6.8,True,5,False,0,0,0,16262,187,52,6.8,False,27.738233333333334,356,2,1,224,239,-15
BR1_2730700917,9,False,1,0,0,17527,184,44,6.8,True,9,True,0,0,0,16145,145,56,6.8,False,25.941633333333332,1382,0,1,228,201,27
BR1_2681958962,5,True,1,0,0,14627,161,44,6.6,True,6,False,0,0,0,14503,171,44,6.8,False,26.1636,124,-1,1,205,215,-10
BR1_2727567247,9,False,1,0,0,16990,162,64,7.0,False,6,True,0,1,0,16810,198,56,7.2,True,28.2035,180,3,1,226,254,-28
BR1_2731235558,2,False,0,0,0,15646,201,50,7.2,True,3,True,1,0,0,15347,194,52,7.4,False,27.521183333333333,299,-1,-1,251,246,5
BR1_2724740386,3,False,0,0,0,14851,158,55,6.6,False,8,True,1,0,0,17536,215,28,6.8,True,28.2847,-2685,-5,-1,213,243,-30
BR1_2729749693,9,True,1,1,0,17582,173,46,7.0,True,7,False,0,0,0,15081,128,50,6.6,False,29.206933333333332,2501,2,1,219,178,41
BR1_2676322636,7,False,1,1,0,17467,187,79,7.6,True,9,True,0,0,0,17972,229,32,7.6,False,29.409816666666668,-505,-2,1,266,261,5
BR1_2718597762,2,False,0,1,0,15795,211,60,7.6,False,2,True,1,0,0,15332,193,48,7.2,True,27.785783333333335,463,0,-1,271,241,30
BR1_2675136516,5,False,1,0,0,15876,193,54,7.0,False,8,True,0,0,0,17765,213,66,7.4,True,29.73585,-1889,-3,1,247,279,-32
BR1_2729040137,9,True,1,1,1,20697,233,62,7.4,True,4,False,0,0,0,16234,213,64,7.4,False,28.393833333333333,4463,5,1,295,277,18
BR1_2711255223,12,True,1,0,0,18798,172,52,7.2,True,7,False,0,0,0,16605,161,48,7.0,False,29.033316666666668,2193,5,1,224,209,15
BR1_2710969748,13,False,0,0,0,17772,185,36,6.4,True,5,True,0,0,0,14193,165,32,6.2,False,26.681316666666667,3579,8,0,221,197,24
BR1_2730261171,5,False,0,0,0,14215,162,60,6.0,False,14,True,1,0,0,18396,166,52,7.0,True,27.340683333333335,-4181,-9,-1,222,218,4
BR1_2730095117,5,False,1,0,0,13195,121,48,6.4,False,7,True,0,0,0,15566,140,44,6.6,True,27.059616666666667,-2371,-2,1,169,184,-15
BR1_2708260092,7,True,1,0,0,16681,169,52,7.0,False,9,False,0,0,0,18507,192,44,7.0,True,27.600066666666667,-1826,-2,1,221,236,-15
BR1_2724975932,5,True,0,0,0,15780,182,64,7.0,False,8,False,1,0,0,15569,164,56,6.8,True,27.316383333333334,211,-3,-1,246,220,26
BR1_2705949591,7,True,1,0,0,15976,176,52,6.4,True,9,False,0,1,0,15929,141,36,6.4,False,25.947866666666666,47,-2,1,228,177,51
BR1_2684092425,5,True,1,0,0,17114,194,68,7.4,True,5,False,0,1,0,15281,181,52,7.4,False,27.710016666666668,1833,0,1,262,233,29
BR1_2724223379,2,False,0,0,0,12294,132,28,6.2,False,7,True,1,0,0,15697,161,52,6.2,True,27.25175,-3403,-5,-1,160,213,-53
BR1_2719490833,8,True,1,0,0,17316,185,60,6.4,True,5,False,0,0,0,18300,236,72,7.4,False,28.342366666666667,-984,3,1,245,308,-63
BR1_2731296996,11,True,1,0,0,17103,156,47,6.6,True,2,False,0,0,0,12638,157,39,6.2,False,25.668566666666667,4465,9,1,203,196,7
BR1_2731278565,7,False,0,0,0,15947,150,48,6.4,False,14,True,1,0,0,21012,208,47,7.0,True,27.705183333333334,-5065,-7,-1,198,255,-57
BR1_2730745928,6,False,0,0,0,16104,176,60,7.0,False,6,True,1,0,0,16964,198,56,7.2,True,29.5855,-860,0,-1,236,254,-18
BR1_2731155092,6,False,1,1,0,17737,185,56,7.4,True,3,True,0,0,0,14968,172,55,6.8,False,29.9461,2769,3,1,241,227,14
BR1_2707355007,17,True,0,0,0,19910,168,48,7.0,True,7,False,1,0,0,16547,172,48,6.6,False,28.573416666666667,3363,10,-1,216,220,-4
BR1_2730776273,7,False,0,0,0,16602,135,56,6.6,False,10,True,1,1,0,18078,160,52,6.8,True,28.567016666666667,-1476,-3,-1,191,212,-21
BR1_2730608022,6,False,1,0,0,16895,195,40,6.6,False,10,True,0,0,0,17853,202,48,6.8,True,29.612733333333335,-958,-4,1,235,250,-15
BR1_2714324724,3,False,1,0,0,14263,179,32,7.0,False,4,True,0,1,0,15821,162,72,7.0,True,28.465116666666667,-1558,-1,1,211,234,-23
BR1_2729645046,5,False,0,0,0,15647,177,48,6.6,False,8,True,0,0,0,16639,152,56,7.0,True,28.932533333333332,-992,-3,0,225,208,17
BR1_2729606417,6,True,0,0,0,16624,182,52,7.2,False,7,False,1,1,0,17324,200,56,7.4,True,28.705816666666667,-700,-1,-1,234,256,-22
BR1_2731639723,18,True,1,0,0,22178,176,45,7.2,True,6,False,0,0,0,16017,130,47,6.2,False,28.897433333333332,6161,12,1,221,177,44
BR1_2731620459,9,True,0,0,0,18179,149,70,7.2,True,10,False,1,1,0,18891,180,58,6.8,False,27.576366666666665,-712,-1,-1,219,238,-19
BR1_2731450179,13,True,0,0,0,17890,172,44,7.0,True,5,False,1,0,0,14339,138,48,6.6,False,26.990366666666667,3551,8,-1,216,186,30
BR1_2730964560,5,False,0,0,0,15544,202,48,7.0,False,8,True,0,0,0,18171,205,48,7.6,True,27.612566666666666,-2627,-3,0,250,253,-3
BR1_2707536625,4,False,0,1,0,15550,165,48,6.8,True,11,True,1,0,0,18099,180,44,7.0,False,28.642216666666666,-2549,-7,-1,213,224,-11
BR1_2690991562,11,True,1,0,0,17844,178,40,6.6,True,10,False,0,0,0,16625,143,55,6.8,False,27.29745,1219,1,1,218,198,20
BR1_2690114887,5,True,0,0,0,15731,165,52,6.8,False,6,False,0,0,0,15467,147,52,7.2,True,28.532316666666667,264,-1,0,217,199,18
BR1_2668142388,3,True,0,0,0,14342,187,68,7.2,True,3,False,1,0,0,13850,171,52,6.8,False,26.704816666666666,492,0,-1,255,223,32
BR1_2667831430,10,False,1,0,0,17776,183,52,7.8,False,8,True,0,1,0,18147,203,40,7.2,True,29.959616666666665,-371,2,1,235,243,-8
BR1_2726465199,2,False,0,0,0,13271,141,40,6.6,False,9,True,1,1,0,17687,170,52,7.0,True,27.5858,-4416,-7,-1,181,222,-41
BR1_2728765529,6,False,1,0,0,14607,148,52,6.6,False,8,True,0,0,0,16344,139,60,6.6,True,25.922733333333333,-1737,-2,1,200,199,1
BR1_2728872251,2,False,1,0,0,14193,196,36,6.6,False,12,True,0,1,0,21026,210,64,7.2,True,28.740233333333332,-6833,-10,1,232,274,-42
BR1_2731353087,6,True,1,1,0,16130,148,64,7.4,True,2,False,0,0,0,14088,182,48,7.0,False,28.21065,2042,4,1,212,230,-18
BR1_2730263679,8,True,1,0,0,16616,190,44,6.6,False,9,False,0,0,0,15792,149,36,6.6,True,25.820683333333335,824,-1,1,234,185,49
BR1_2683389874,12,False,1,0,0,17428,158,52,7.6,True,7,True,0,0,0,17465,148,56,7.4,False,28.960733333333334,-37,5,1,210,204,6
BR1_2731294353,4,True,1,1,0,15401,177,52,6.8,True,1,False,0,0,0,12675,160,48,6.6,False,26.774566666666665,2726,3,1,229,208,21
BR1_2731023040,5,False,0,1,1,16771,184,44,7.2,False,11,True,1,0,0,18939,170,56,7.2,True,29.688766666666666,-2168,-6,-1,228,226,2
BR1_2731163098,0,False,0,0,0,11778,137,33,6.0,False,9,True,0,0,0,17009,183,63,7.0,True,25.926833333333335,-5231,-9,0,170,246,-76
BR1_2731589672,6,False,1,1,0,18232,187,64,7.4,False,12,True,0,0,0,18441,153,44,7.2,True,27.656483333333334,-209,-6,1,251,197,54
BR1_2731574452,5,False,1,1,0,16350,195,59,7.0,True,5,True,0,0,0,15734,153,52,7.4,False,29.5623,616,0,1,254,205,49
BR1_2731534269,7,True,1,1,0,15832,157,48,6.6,True,5,False,0,0,0,14817,185,47,6.4,False,26.4759,1015,2,1,205,232,-27
BR1_2731515489,13,True,0,0,0,17899,187,44,6.8,False,6,False,0,0,0,15967,168,43,6.4,True,25.321866666666665,1932,7,0,231,211,20
BR1_2710633281,3,True,0,1,0,14721,166,51,7.0,False,6,False,1,0,0,16366,181,52,7.2,True,28.067583333333335,-1645,-3,-1,217,233,-16
BR1_2720214566,6,False,1,1,0,16753,178,60,7.2,False,6,True,0,0,0,17743,209,56,7.0,True,29.9913,-990,0,1,238,265,-27
BR1_2719158564,6,False,0,0,0,16213,216,42,7.0,False,11,True,0,1,0,18860,186,57,7.4,True,29.019216666666665,-2647,-5,0,258,243,15
BR1_2691323827,7,True,0,0,0,15169,188,40,6.8,True,8,False,0,0,0,16285,164,56,6.6,False,26.434316666666668,-1116,-1,0,228,220,8
BR1_2691304753,3,True,1,0,0,14692,191,52,7.4,True,2,False,0,1,0,15764,200,64,7.2,False,29.418566666666667,-1072,1,1,243,264,-21
BR1_2691233255,7,False,0,0,0,14835,171,44,6.6,False,5,True,1,0,0,15412,171,56,6.8,True,26.12925,-577,2,-1,215,227,-12
BR1_2682755337,6,False,0,0,0,14100,138,48,6.6,False,8,True,1,0,0,16102,181,56,6.8,True,26.136033333333334,-2002,-2,-1,186,237,-51
BR1_2727273587,10,True,0,1,1,19001,196,45,6.8,True,5,False,1,0,0,13325,117,27,5.2,False,25.140133333333335,5676,5,-1,241,144,97
BR1_2727262253,8,True,0,0,0,16926,199,29,6.8,True,12,False,0,1,0,18802,159,64,7.2,False,29.95035,-1876,-4,0,228,223,5
BR1_2727237579,11,True,1,0,0,18852,228,57,7.4,False,8,False,0,0,0,18037,183,40,7.0,True,28.616333333333333,815,3,1,285,223,62
BR1_2705300008,12,False,1,0,0,19141,169,39,6.8,False,16,True,0,0,0,20805,190,36,6.8,True,27.684916666666666,-1664,-4,1,208,226,-18
BR1_2726950742,2,False,0,0,0,12688,158,50,6.6,False,6,True,0,0,0,16373,184,52,7.0,True,25.712633333333333,-3685,-4,0,208,236,-28
BR1_2702774304,8,True,0,0,0,16749,158,48,6.8,False,4,False,1,1,0,16060,175,60,7.2,True,29.970266666666667,689,4,-1,206,235,-29
BR1_2710991320,5,False,0,0,0,14741,154,40,6.6,False,11,True,1,1,0,18925,234,60,7.2,True,28.487033333333333,-4184,-6,-1,194,294,-100
BR1_2725756381,9,True,1,0,0,16656,169,48,6.8,True,4,False,0,0,0,14637,177,44,6.8,False,25.593233333333334,2019,5,1,217,221,-4
BR1_2730231343,7,True,0,0,0,15785,176,56,6.8,True,6,False,0,0,0,14940,158,40,6.8,False,25.53755,845,1,0,232,198,34
BR1_2730793593,6,False,1,0,0,16543,164,64,7.0,False,9,True,0,0,0,17282,177,44,7.0,True,29.851966666666666,-739,-3,1,228,221,7
BR1_2727578638,4,False,0,1,0,14640,134,56,6.4,False,7,True,1,0,0,15873,158,44,6.8,True,26.3941,-1233,-3,-1,190,202,-12
BR1_2699943546,6,True,0,0,0,14607,165,41,6.4,True,3,False,1,0,0,13154,168,52,6.4,False,27.039083333333334,1453,3,-1,206,220,-14
BR1_2721960382,1,False,0,0,0,12117,128,48,6.6,False,5,True,0,0,0,15488,199,48,7.0,True,26.595816666666668,-3371,-4,0,176,247,-71
BR1_2731296762,10,True,1,1,0,17343,168,48,6.8,True,7,False,0,0,0,16442,190,44,6.8,False,27.261083333333332,901,3,1,216,234,-18
BR1_2666981188,2,False,0,0,0,13990,194,56,7.0,True,4,True,0,0,0,14267,167,60,7.2,False,26.564783333333335,-277,-2,0,250,227,23
BR1_2723064710,10,True,1,0,0,17741,176,44,6.8,False,10,False,0,0,0,17777,155,48,7.0,True,28.453883333333334,-36,0,1,220,203,17
BR1_2726910500,3,False,0,0,0,14737,185,56,6.8,True,6,True,1,0,0,15804,202,44,6.8,False,25.754316666666668,-1067,-3,-1,241,246,-5
BR1_2723664145,7,False,0,0,0,16581,166,36,6.8,False,6,True,0,0,0,18153,252,56,7.2,True,29.749183333333335,-1572,1,0,202,308,-106
BR1_2721580032,11,True,1,0,0,20155,220,56,7.0,True,6,False,0,1,0,17234,205,48,6.8,False,29.302316666666666,2921,5,1,276,253,23
BR1_2666450879,8,True,1,0,0,16903,181,56,6.8,True,5,False,0,0,0,14159,160,32,6.6,False,25.688916666666668,2744,3,1,237,192,45
BR1_2726402939,7,True,0,0,0,17261,203,48,7.4,False,6,False,1,1,0,16953,220,56,7.4,True,29.581566666666667,308,1,-1,251,276,-25
BR1_2726336770,4,True,1,0,0,14849,203,44,6.2,True,7,False,0,0,0,15438,141,48,6.4,False,25.3799,-589,-3,1,247,189,58
BR1_2708107502,13,True,1,1,0,17739,135,36,6.8,False,9,False,0,0,0,17768,181,44,6.6,True,28.7832,-29,4,1,171,225,-54
BR1_2705776534,7,False,0,1,0,16453,143,33,7.4,False,9,True,0,0,0,17764,227,52,7.4,True,28.9958,-1311,-2,0,176,279,-103
BR1_2663082354,1,False,0,0,0,14285,200,52,7.2,False,1,True,1,0,0,14906,199,60,7.2,True,28.6267,-621,0,-1,252,259,-7
BR1_2730359580,10,True,0,0,0,17724,165,53,7.0,False,9,False,0,1,0,17843,171,37,7.2,True,28.88533333333333,-119,1,0,218,208,10
BR1_2730342951,9,True,0,0,0,15647,180,36,6.4,True,6,False,0,0,0,14693,143,48,6.6,False,25.575816666666668,954,3,0,216,191,25
BR1_2712013778,9,False,0,0,0,16771,196,40,7.0,True,5,True,0,0,0,15042,145,60,6.2,False,27.43075,1729,4,0,236,205,31
BR1_2710326612,8,False,1,0,0,15053,142,33,6.6,False,6,True,0,1,0,16955,187,63,7.2,True,29.517683333333334,-1902,2,1,175,250,-75
BR1_2686445092,7,True,1,0,0,15267,169,48,7.0,True,1,False,0,0,0,11995,149,24,6.0,False,26.29445,3272,6,1,217,173,44
BR1_2725929388,3,False,0,0,0,13418,163,48,6.2,False,5,True,1,0,0,16250,224,54,7.0,True,27.331333333333333,-2832,-2,-1,211,278,-67
BR1_2731345341,4,True,0,0,0,15850,199,51,7.4,False,5,False,0,0,0,17427,245,53,7.2,True,27.639133333333334,-1577,-1,0,250,298,-48
BR1_2722483687,5,False,0,0,0,15065,144,44,6.4,True,9,True,0,0,0,15207,148,32,6.4,False,26.18725,-142,-4,0,188,180,8
BR1_2722840235,12,True,1,0,0,20596,247,68,7.8,True,2,False,0,0,0,15165,200,59,7.4,False,28.31875,5431,10,1,315,259,56
BR1_2722821468,5,True,0,0,0,15622,172,44,6.8,True,3,False,1,1,0,15218,206,60,6.8,False,25.116433333333333,404,2,-1,216,266,-50
BR1_2713664648,9,True,0,0,0,17194,186,48,6.6,True,4,False,0,0,0,13734,142,52,6.2,False,27.0559,3460,5,0,234,194,40
BR1_2689440474,1,True,0,0,0,12197,111,48,5.2,False,2,False,1,0,0,14504,199,52,7.0,True,25.04455,-2307,-1,-1,159,251,-92
BR1_2700875657,7,True,1,0,0,17649,235,42,7.2,True,2,False,0,0,0,14175,177,56,6.6,False,29.42035,3474,5,1,277,233,44
BR1_2731556465,8,False,0,0,0,16909,162,59,7.2,True,1,True,0,0,0,12597,155,52,6.4,False,26.089933333333335,4312,7,0,221,207,14
BR1_2723980145,9,True,0,0,0,19331,214,44,7.2,True,2,False,0,1,0,14731,181,57,7.2,False,27.935766666666666,4600,7,0,258,238,20
BR1_2726368217,6,True,0,0,0,15700,191,42,6.8,True,2,False,0,0,0,12138,129,37,6.6,False,25.0904,3562,4,0,233,166,67
BR1_2703682467,8,True,0,0,0,18587,201,52,6.8,False,9,False,0,0,0,19018,187,56,6.8,True,29.70305,-431,-1,0,253,243,10
BR1_2727587810,5,True,0,0,0,16735,201,40,7.0,False,7,False,1,0,0,18023,226,72,7.8,True,29.135766666666665,-1288,-2,-1,241,298,-57
BR1_2727564923,4,True,1,0,0,15832,190,52,7.2,True,3,False,0,1,0,15860,198,42,7.0,False,27.694166666666668,-28,1,1,242,240,2
BR1_2689999009,7,False,0,1,0,15843,171,64,7.4,True,5,True,1,0,0,14424,132,44,6.4,False,29.0396,1419,2,-1,235,176,59
BR1_2717017193,8,True,0,0,0,16861,171,28,6.8,False,9,False,1,0,0,17721,223,44,7.2,True,29.9217,-860,-1,-1,199,267,-68
BR1_2713446378,11,False,0,1,0,19302,196,56,7.0,True,5,True,1,0,0,15854,180,56,7.4,False,29.432183333333334,3448,6,-1,252,236,16
BR1_2693718513,7,True,1,0,0,14988,152,52,6.8,True,1,False,0,0,0,11573,131,36,6.4,False,25.233466666666665,3415,6,1,204,167,37
BR1_2707324976,8,True,0,0,0,17157,147,53,6.6,True,7,False,1,0,0,16159,146,30,6.2,False,27.532666666666668,998,1,-1,200,176,24
BR1_2731447569,2,False,0,0,0,12023,126,44,6.0,False,10,True,1,1,0,17871,197,52,6.6,True,25.09735,-5848,-8,-1,170,249,-79
BR1_2731437823,2,True,0,1,0,13483,165,52,6.6,False,2,False,0,0,0,14544,198,44,6.8,True,25.7704,-1061,0,0,217,242,-25
BR1_2731364517,2,False,0,1,0,14864,182,60,6.8,False,10,True,0,0,0,17856,171,52,6.8,True,28.6275,-2992,-8,0,242,223,19
BR1_2708751696,7,True,0,0,0,15603,163,40,6.8,True,4,False,1,0,0,13660,135,56,6.4,False,27.0896,1943,3,-1,203,191,12
BR1_2727986168,5,True,0,0,0,14489,150,48,6.8,False,12,False,1,1,0,19573,203,48,7.6,True,29.685283333333334,-5084,-7,-1,198,251,-53
BR1_2727540954,6,False,1,0,0,16107,201,50,6.8,True,7,True,0,0,0,15207,163,42,6.4,False,26.110633333333332,900,-1,1,251,205,46
BR1_2727474644,7,True,1,1,0,17752,180,68,7.0,False,9,False,0,0,0,17857,171,68,7.4,True,29.5886,-105,-2,1,248,239,9
BR1_2731552827,4,False,0,0,0,14759,167,55,6.8,True,6,True,1,0,0,14813,186,56,6.8,False,25.75975,-54,-2,-1,222,242,-20
BR1_2728040106,6,True,0,0,0,16284,197,56,7.0,False,5,False,0,0,0,15955,186,52,7.4,True,28.27955,329,1,0,253,238,15
BR1_2727195289,10,True,1,0,0,18648,218,64,7.4,True,2,False,0,1,0,14213,174,44,7.2,False,28.80255,4435,8,1,282,218,64
BR1_2688887759,4,True,1,0,0,15439,170,60,7.0,True,4,False,0,1,1,17409,181,46,7.2,False,29.203583333333334,-1970,0,1,230,227,3
BR1_2688884246,8,True,1,0,0,15428,170,56,6.8,True,1,False,0,1,0,12208,143,28,6.2,False,27.208283333333334,3220,7,1,226,171,55
BR1_2687040198,12,True,0,0,0,18180,166,68,7.0,True,7,False,1,0,0,15965,157,52,7.0,False,27.980566666666668,2215,5,-1,234,209,25
BR1_2730954559,5,True,1,0,1,18127,212,54,7.2,True,2,False,0,1,0,14059,160,64,7.0,False,28.4783,4068,3,1,266,224,42
BR1_2729602615,7,False,0,0,0,15093,115,48,6.6,False,10,True,1,0,0,17285,178,40,6.6,True,25.9068,-2192,-3,-1,163,218,-55
BR1_2671498525,11,True,1,0,0,18403,166,56,6.8,False,14,False,0,0,0,20307,205,44,7.2,True,29.342366666666667,-1904,-3,1,222,249,-27
BR1_2731600662,5,False,1,0,0,14705,155,44,6.8,False,11,True,0,0,0,18272,189,44,6.8,True,25.804333333333332,-3567,-6,1,199,233,-34
BR1_2731581536,7,True,1,0,0,14551,142,48,6.4,True,7,False,0,0,0,14850,128,44,6.4,False,26.71015,-299,0,1,190,172,18
BR1_2730731502,6,True,0,0,0,14234,152,40,6.2,False,9,False,0,0,0,16348,162,60,6.8,True,26.484516666666668,-2114,-3,0,192,222,-30
BR1_2697442562,2,False,0,0,0,14341,183,52,7.0,False,5,True,1,1,0,17232,211,60,7.6,True,28.945366666666665,-2891,-3,-1,235,271,-36
BR1_2701614847,7,False,0,1,0,15877,166,48,6.8,True,7,True,1,0,0,16101,157,60,7.0,False,27.712766666666667,-224,0,-1,214,217,-3
BR1_2701372962,9,True,0,0,0,17637,172,52,7.2,True,5,False,0,0,0,16113,194,44,7.0,False,28.002666666666666,1524,4,0,224,238,-14
BR1_2685033225,8,False,1,0,0,16834,196,40,7.4,True,7,True,0,0,0,15539,166,44,7.4,False,29.423333333333332,1295,1,1,236,210,26
BR1_2685005358,9,True,0,0,0,17280,203,48,7.4,True,3,False,0,0,0,15212,166,48,6.6,False,28.235166666666668,2068,6,0,251,214,37
BR1_2711859168,5,False,0,0,0,14152,155,40,6.8,False,6,True,1,0,0,15015,180,64,6.8,True,26.181933333333333,-863,-1,-1,195,244,-49
BR1_2730969685,4,True,0,0,0,14854,158,44,6.4,False,11,False,1,0,0,17893,204,53,7.0,True,28.5716,-3039,-7,-1,202,257,-55
BR1_2701747242,7,False,0,0,0,16058,156,31,6.8,False,11,True,1,0,0,19109,192,44,7.0,True,29.8901,-3051,-4,-1,187,236,-49
BR1_2729847298,3,True,0,1,0,14138,176,36,6.8,True,7,False,1,0,0,15912,198,56,6.8,False,26.930683333333334,-1774,-4,-1,212,254,-42
BR1_2729833533,5,False,1,0,1,13816,126,28,5.8,False,9,True,0,1,1,17920,156,44,7.0,True,27.072616666666665,-4104,-4,1,154,200,-46
BR1_2719933062,8,False,1,0,0,17111,190,40,6.8,True,6,True,0,1,0,16185,182,48,6.8,False,29.550966666666667,926,2,1,230,230,0
BR1_2708077402,2,False,0,1,0,14256,181,44,6.6,False,12,True,1,0,0,20189,180,68,7.6,True,29.511833333333332,-5933,-10,-1,225,248,-23
BR1_2731195376,7,False,1,0,0,17006,203,48,7.2,True,7,True,0,0,0,17267,195,44,7.0,False,27.882766666666665,-261,0,1,251,239,12
BR1_2707932371,3,False,0,0,0,13175,134,40,6.4,False,8,True,1,0,0,16319,168,52,6.8,True,26.814433333333334,-3144,-5,-1,174,220,-46
BR1_2724665219,3,True,0,0,0,13843,144,36,6.4,False,12,False,1,1,0,20521,227,56,7.6,True,28.002033333333333,-6678,-9,-1,180,283,-103
BR1_2718778377,6,True,1,0,0,16385,184,52,7.0,True,3,False,0,0,0,15370,193,54,7.0,False,27.902583333333332,1015,3,1,236,247,-11
BR1_2697542469,3,False,0,0,0,14975,186,55,7.4,False,14,True,1,1,0,19767,164,44,7.2,True,29.4009,-4792,-11,-1,241,208,33
BR1_2697516811,2,False,1,0,0,13573,135,52,6.2,False,12,True,0,0,0,18025,167,60,7.2,True,25.057916666666667,-4452,-10,1,187,227,-40
BR1_2697452840,7,False,0,0,0,16041,151,52,6.8,False,10,True,1,1,0,19349,178,64,7.2,True,27.638633333333335,-3308,-3,-1,203,242,-39
BR1_2687875289,8,False,1,0,0,14483,141,40,6.6,True,8,True,0,0,0,15577,136,36,6.2,False,26.096883333333334,-1094,0,1,181,172,9
BR1_2687851228,7,True,0,1,0,15329,129,56,6.4,False,4,False,1,0,0,16192,208,59,7.0,True,28.72821666666667,-863,3,-1,185,267,-82
BR1_2710214614,6,True,0,0,0,15738,172,40,6.4,False,13,False,1,0,0,17888,189,56,7.2,True,26.48015,-2150,-7,-1,212,245,-33
BR1_2730789494,6,False,1,1,0,17851,220,71,7.6,True,4,True,0,0,0,15988,219,44,7.0,False,29.5202,1863,2,1,291,263,28
BR1_2727592665,6,True,0,0,0,17053,215,40,6.8,False,7,False,1,0,0,17536,240,44,7.4,True,29.1225,-483,-1,-1,255,284,-29
BR1_2727580191,4,False,0,0,0,13625,156,48,6.6,False,7,True,0,0,0,17144,245,36,6.8,True,25.0768,-3519,-3,0,204,281,-77
BR1_2709778275,1,False,0,0,0,13122,168,46,7.0,False,7,True,0,0,0,17442,182,42,7.0,True,29.060016666666666,-4320,-6,0,214,224,-10
BR1_2714022666,6,False,1,0,0,15769,190,52,7.0,True,1,True,0,0,0,12954,163,52,6.4,False,26.893433333333334,2815,5,1,242,215,27
BR1_2724267873,7,False,0,0,0,15650,173,31,6.6,True,4,True,0,0,0,13646,147,60,6.2,False,26.446533333333335,2004,3,0,204,207,-3
BR1_2723492284,11,False,0,1,0,17471,162,44,6.6,True,6,True,1,0,0,15075,130,44,6.2,False,26.098666666666666,2396,5,-1,206,174,32
BR1_2701137701,9,True,1,1,0,17626,152,56,6.4,True,4,False,0,0,0,13772,148,44,6.6,False,26.925933333333333,3854,5,1,208,192,16
BR1_2731381964,12,False,1,0,0,17578,194,48,7.6,True,5,True,0,1,0,16095,162,44,6.8,False,28.64715,1483,7,1,242,206,36
BR1_2731616245,10,True,1,1,0,18497,166,56,7.0,True,7,False,0,0,0,17037,161,48,7.0,False,28.2783,1460,3,1,222,209,13
BR1_2730367351,7,True,0,0,0,15820,182,48,6.8,True,2,False,0,0,0,13733,198,58,7.2,False,27.399566666666665,2087,5,0,230,256,-26
BR1_2728530714,6,False,0,0,0,16210,147,40,6.6,True,5,True,1,1,0,16205,179,66,6.8,False,29.900083333333335,5,1,-1,187,245,-58
BR1_2730842193,7,True,1,0,0,16543,192,52,6.6,False,4,False,0,0,0,15455,187,60,7.0,True,26.73975,1088,3,1,244,247,-3
BR1_2697359739,7,True,1,0,0,16957,186,48,7.0,True,11,False,0,0,0,18294,171,60,7.4,False,28.7099,-1337,-4,1,234,231,3
BR1_2700385796,4,True,0,0,0,13190,168,4,5.8,False,4,False,1,0,0,14591,164,44,6.6,True,25.186066666666665,-1401,0,-1,172,208,-36
BR1_2699066586,2,False,0,0,0,13588,167,56,6.6,False,8,True,1,0,0,16849,194,56,7.0,True,26.821433333333335,-3261,-6,-1,223,250,-27
BR1_2731537872,5,True,0,0,0,14173,159,48,6.4,False,8,False,1,0,0,16974,199,58,7.0,True,27.468983333333334,-2801,-3,-1,207,257,-50
BR1_2730347216,6,True,0,1,0,16518,175,56,7.2,False,10,False,1,0,0,18547,218,56,7.8,True,29.309366666666666,-2029,-4,-1,231,274,-43
BR1_2689928344,7,False,1,0,0,17013,192,48,7.2,True,4,True,0,0,0,15410,163,54,7.2,False,29.79865,1603,3,1,240,217,23
BR1_2674851612,9,True,0,1,0,17517,188,41,7.2,False,13,False,1,0,0,18396,160,50,7.4,True,28.680533333333333,-879,-4,-1,229,210,19
BR1_2671865698,9,True,0,0,0,18117,192,60,7.2,True,8,False,1,0,0,17786,172,56,7.2,False,28.38615,331,1,-1,252,228,24
BR1_2723843500,14,True,1,1,0,19382,166,48,7.0,True,3,False,0,0,0,14196,152,44,7.0,False,27.569966666666666,5186,11,1,214,196,18
BR1_2723778205,4,True,1,0,0,14614,174,60,6.6,True,4,False,0,1,0,14232,155,36,6.8,False,25.499416666666665,382,0,1,234,191,43
BR1_2731272357,3,False,0,0,0,13472,120,42,6.0,False,15,True,1,1,0,20052,201,62,7.2,True,27.421,-6580,-12,-1,162,263,-101
BR1_2731086412,10,True,1,0,0,16929,199,48,6.8,True,7,False,0,0,0,14226,129,40,6.6,False,27.103483333333333,2703,3,1,247,169,78
BR1_2730964264,2,False,0,0,0,15620,189,68,7.2,True,4,True,0,0,0,17699,233,52,7.2,False,29.61755,-2079,-2,0,257,285,-28
BR1_2719623949,9,False,0,1,1,19522,202,60,7.6,True,7,True,1,0,0,16405,158,52,6.8,False,29.6807,3117,2,-1,262,210,52
BR1_2730297150,9,True,0,0,0,16157,147,60,6.6,False,6,False,1,0,0,15011,188,36,6.4,True,27.16358333333333,1146,3,-1,207,224,-17
BR1_2691702951,12,True,0,0,0,18587,197,64,7.4,True,8,False,1,0,0,16657,196,52,7.4,False,29.953133333333334,1930,4,-1,261,248,13
BR1_2691136442,9,True,0,1,0,19340,203,40,7.4,False,10,False,1,0,0,18297,186,48,7.0,True,29.51225,1043,-1,-1,243,234,9
BR1_2729756609,3,False,0,0,0,16066,204,56,7.2,False,6,True,1,1,0,16316,197,48,7.6,True,28.5459,-250,-3,-1,260,245,15
BR1_2731276091,14,True,1,1,1,21500,201,68,7.6,True,3,False,0,0,0,14347,154,36,6.6,False,27.631083333333333,7153,11,1,269,190,79
BR1_2721141536,5,True,0,0,0,14101,158,41,6.4,False,6,False,0,1,0,15691,169,44,6.6,True,27.28323333333333,-1590,-1,0,199,213,-14
BR1_2719294437,3,True,1,0,0,14178,145,48,6.4,False,5,False,0,0,0,14207,160,44,6.6,True,26.768633333333334,-29,-2,1,193,204,-11
BR1_2717943393,3,True,0,0,0,12508,133,41,6.4,False,9,False,1,0,0,17147,209,54,7.0,True,25.573816666666666,-4639,-6,-1,174,263,-89
BR1_2664819936,4,True,1,1,0,14273,156,48,6.4,False,6,False,0,0,0,15005,152,48,7.0,True,27.412283333333335,-732,-2,1,204,200,4
BR1_2710492451,10,True,1,0,0,17547,189,60,7.4,True,4,False,0,0,0,15264,156,56,7.2,False,28.524116666666668,2283,6,1,249,212,37
BR1_2683717591,7,True,0,0,0,16552,207,48,7.0,True,6,False,0,0,0,16340,180,46,7.0,False,28.4469,212,1,0,255,226,29
BR1_2683652504,5,False,1,0,0,13867,137,28,6.4,False,3,True,0,0,0,13827,137,52,6.6,True,25.495816666666666,40,2,1,165,189,-24
BR1_2700303526,7,False,0,0,0,17773,254,48,7.2,True,6,True,1,0,0,15795,165,44,7.2,False,28.021883333333335,1978,1,-1,302,209,93
BR1_2689485361,7,False,0,0,0,14545,126,28,6.4,False,16,True,1,0,0,17836,195,44,7.0,True,26.346733333333333,-3291,-9,-1,154,239,-85
BR1_2716693927,11,True,1,1,0,18504,189,64,7.2,True,4,False,0,0,0,15009,168,60,6.8,False,28.51825,3495,7,1,253,228,25
BR1_2704271543,9,False,1,1,0,18364,202,68,7.6,True,2,True,0,0,0,14958,217,52,7.0,False,27.6577,3406,7,1,270,269,1
BR1_2718621606,4,True,0,0,0,14172,148,52,6.8,True,2,False,1,0,0,12794,166,42,6.4,False,26.7641,1378,2,-1,200,208,-8
BR1_2729009339,7,False,1,1,0,16019,160,46,6.4,True,4,True,0,0,0,14156,155,57,6.4,False,26.22345,1863,3,1,206,212,-6
BR1_2728532110,1,False,0,1,0,14328,183,44,7.2,False,5,True,1,0,0,16314,181,56,7.0,True,28.743666666666666,-1986,-4,-1,227,237,-10
BR1_2672243739,5,True,1,0,0,15052,160,48,6.8,False,4,False,0,1,0,13820,143,60,6.6,True,27.13915,1232,1,1,208,203,5
BR1_2731397415,7,True,1,0,1,17837,243,62,7.6,True,9,False,0,1,0,18335,181,48,7.0,False,28.39225,-498,-2,1,305,229,76
BR1_2725044746,9,True,1,0,0,15764,166,60,6.8,True,4,False,0,0,0,14159,159,48,6.4,False,26.970883333333333,1605,5,1,226,207,19
BR1_2687826665,9,False,0,0,0,17363,177,45,6.8,True,8,True,0,0,0,15644,147,48,6.8,False,26.601983333333333,1719,1,0,222,195,27
BR1_2707415068,7,False,0,0,0,16103,144,48,6.8,False,12,True,1,0,0,19584,192,60,7.2,True,28.0127,-3481,-5,-1,192,252,-60
BR1_2717393157,9,True,1,0,0,18412,184,64,7.4,True,4,False,0,1,0,16224,204,56,7.2,False,28.174366666666668,2188,5,1,248,260,-12
BR1_2717206022,6,True,1,0,0,17159,175,52,7.2,True,5,False,0,1,0,16222,208,48,7.4,False,29.545066666666667,937,1,1,227,256,-29
BR1_2731271998,9,True,0,0,0,17567,145,48,6.8,False,10,False,1,0,0,18139,184,60,7.4,True,29.2174,-572,-1,-1,193,244,-51
BR1_2722819342,7,True,1,0,0,18257,195,48,7.4,True,5,False,0,0,0,14000,148,30,6.8,False,28.053533333333334,4257,2,1,243,178,65
BR1_2667483465,6,False,0,0,0,17609,195,76,7.6,False,10,True,1,0,0,18459,221,52,7.6,True,29.04071666666667,-850,-4,-1,271,273,-2
BR1_2728263520,4,True,0,0,0,15457,174,44,7.0,False,6,False,1,0,0,16289,162,60,7.2,True,27.768466666666665,-832,-2,-1,218,222,-4
BR1_2672579793,10,True,1,0,0,17079,162,56,7.2,True,3,False,0,1,0,13880,144,52,6.6,False,26.221216666666667,3199,7,1,218,196,22
BR1_2672515906,2,False,0,0,0,13793,181,44,6.8,True,2,True,1,0,0,11706,111,46,5.6,False,26.0613,2087,0,-1,225,157,68
BR1_2672466275,5,False,0,1,0,14040,136,40,6.8,False,7,True,1,0,0,16404,184,60,7.2,True,25.183466666666668,-2364,-2,-1,176,244,-68
BR1_2727902622,5,False,0,1,0,14049,132,52,6.8,False,7,True,1,0,0,15570,182,40,6.8,True,25.5275,-1521,-2,-1,184,222,-38
BR1_2727847623,7,True,1,0,0,16697,182,44,6.8,True,7,False,0,1,0,16591,177,44,6.8,False,28.911966666666668,106,0,1,226,221,5
BR1_2713890819,4,False,1,0,0,13127,131,39,6.6,False,10,True,0,0,0,17262,197,48,7.0,True,25.225133333333332,-4135,-6,1,170,245,-75
BR1_2730742520,6,False,1,0,0,15780,185,56,7.0,False,4,True,0,0,0,16736,197,52,7.4,True,29.129016666666665,-956,2,1,241,249,-8
BR1_2730716260,5,False,0,0,0,15881,176,48,6.6,True,6,True,0,1,0,14910,135,40,6.2,False,26.117833333333333,971,-1,0,224,175,49
BR1_2729621047,13,True,0,0,0,19722,207,63,7.4,False,5,False,1,0,0,16111,155,60,7.0,True,28.14005,3611,8,-1,270,215,55
BR1_2729591559,5,True,1,0,0,16688,207,57,7.6,False,3,False,0,1,0,14756,181,44,7.4,True,28.67065,1932,2,1,264,225,39
BR1_2726010248,4,False,1,0,0,15210,175,50,6.8,False,8,True,0,0,0,15822,173,42,6.6,True,26.931333333333335,-612,-4,1,225,215,10
BR1_2721634368,9,True,1,0,0,17338,162,48,6.8,True,4,False,0,0,0,15671,198,47,7.2,False,27.723116666666666,1667,5,1,210,245,-35
BR1_2719427728,3,False,0,0,0,13985,160,36,6.6,False,10,True,1,0,0,18228,184,52,7.0,True,25.08935,-4243,-7,-1,196,236,-40
BR1_2691763241,5,False,0,0,0,14939,146,52,6.4,True,3,True,1,0,0,12778,118,44,6.0,False,26.052783333333334,2161,2,-1,198,162,36
BR1_2684498194,10,True,0,0,0,18448,145,32,6.8,False,12,False,1,0,0,19734,153,60,7.6,True,29.9921,-1286,-2,-1,177,213,-36
BR1_2720104769,4,True,1,0,0,15658,185,46,7.0,True,9,False,0,0,0,18038,210,61,7.6,False,28.399083333333333,-2380,-5,1,231,271,-40
BR1_2719648766,5,True,0,1,0,15509,183,48,7.0,True,4,False,0,0,0,14729,148,52,6.8,False,29.615383333333334,780,1,0,231,200,31
BR1_2700554142,7,False,0,1,0,17922,141,52,6.8,False,17,True,1,0,0,20202,144,48,6.8,True,28.074983333333332,-2280,-10,-1,193,192,1
BR1_2730475370,6,False,1,0,0,16797,184,56,7.0,True,3,True,0,0,0,14168,176,40,6.8,False,28.664133333333332,2629,3,1,240,216,24
BR1_2730438590,7,True,1,1,0,17226,181,68,7.2,True,6,False,0,0,0,14526,140,30,6.4,False,29.067666666666668,2700,1,1,249,170,79
BR1_2730420408,11,True,1,1,0,18129,175,44,7.0,True,4,False,0,0,0,15368,180,56,6.8,False,28.069466666666667,2761,7,1,219,236,-17
BR1_2730911249,5,True,0,1,0,16076,152,73,6.6,False,10,False,1,0,0,16049,136,40,6.6,True,28.787916666666668,27,-5,-1,225,176,49
BR1_2730899280,8,False,1,0,0,16967,135,63,6.8,False,8,True,0,1,0,19213,233,52,7.4,True,29.208133333333333,-2246,0,1,198,285,-87
BR1_2718351526,7,True,1,0,0,13794,126,36,5.8,False,6,False,0,0,0,15292,140,32,6.4,True,27.213033333333332,-1498,1,1,162,172,-10
BR1_2717703580,6,False,1,0,0,16669,144,50,6.2,False,9,True,0,1,0,17851,155,48,6.8,True,27.835016666666668,-1182,-3,1,194,203,-9
BR1_2685153654,4,True,0,0,0,16476,220,52,7.6,False,6,False,0,0,0,17091,246,56,7.4,True,28.04845,-615,-2,0,272,302,-30
BR1_2684318687,5,True,1,0,0,14124,147,36,6.4,True,6,False,0,0,0,14383,136,28,6.2,False,25.341433333333335,-259,-1,1,183,164,19
BR1_2730178549,3,True,1,0,0,15806,178,58,7.0,False,5,False,0,0,0,15832,198,52,6.8,True,29.4185,-26,-2,1,236,250,-14
BR1_2716990908,4,False,0,1,0,15693,191,52,7.0,False,7,True,1,0,0,17205,182,64,7.2,True,29.35125,-1512,-3,-1,243,246,-3
BR1_2729620478,6,False,1,0,0,17179,191,60,7.4,False,7,True,0,0,0,17548,193,58,7.0,True,29.43125,-369,-1,1,251,251,0
BR1_2685521283,5,True,1,0,0,13222,134,40,6.0,False,8,False,0,0,0,16392,167,36,6.2,True,26.207716666666666,-3170,-3,1,174,203,-29
BR1_2720818702,4,True,0,0,0,15960,217,56,7.6,True,3,False,0,1,0,15251,188,56,7.2,False,28.150866666666666,709,1,0,273,244,29
BR1_2687113108,7,False,0,0,0,14677,155,37,6.4,False,11,True,0,0,0,17783,172,47,6.6,True,25.0226,-3106,-4,0,192,219,-27
BR1_2731120663,7,False,0,0,0,16565,201,52,7.0,True,8,True,1,1,0,17223,188,43,6.8,False,29.7415,-658,-1,-1,253,231,22
BR1_2727424550,1,False,0,0,0,12084,151,32,6.0,False,3,True,0,0,0,13837,179,44,7.0,True,26.204766666666668,-1753,-2,0,183,223,-40
BR1_2726919425,5,False,0,0,0,13642,127,58,6.4,False,6,True,1,0,0,16266,187,48,6.4,True,25.3081,-2624,-1,-1,185,235,-50
BR1_2708358386,9,False,1,0,0,15776,141,59,6.6,True,12,True,0,0,0,16418,159,0,6.0,False,25.2296,-642,-3,1,200,159,41
BR1_2704765003,2,False,0,0,0,14879,206,44,7.0,False,9,True,1,1,0,18732,183,72,7.4,True,28.573366666666665,-3853,-7,-1,250,255,-5
BR1_2704407906,11,False,0,0,0,19428,193,56,7.0,False,10,True,1,1,0,19570,189,64,6.8,True,29.45225,-142,1,-1,249,253,-4
BR1_2731488024,6,False,0,0,0,14485,162,24,6.4,False,9,True,1,0,0,16644,187,40,6.6,True,26.929,-2159,-3,-1,186,227,-41
BR1_2721111446,6,False,0,1,0,17238,187,56,7.2,True,9,True,0,0,0,16966,161,32,6.8,False,28.036633333333334,272,-3,0,243,193,50
BR1_2701890882,4,True,0,0,0,14397,179,48,6.8,True,2,False,0,0,0,13407,126,54,6.8,False,29.175383333333333,990,2,0,227,180,47
BR1_2731315163,9,False,1,0,0,17443,214,44,7.0,True,8,True,0,1,0,18101,215,60,7.6,False,29.46335,-658,1,1,258,275,-17
BR1_2731213906,8,False,0,0,0,15573,139,44,6.6,False,3,True,1,0,0,13842,172,60,6.8,True,25.4772,1731,5,-1,183,232,-49
BR1_2730720629,2,True,1,1,0,14574,201,52,6.8,False,2,False,0,0,0,13576,180,52,6.8,True,26.0706,998,0,1,253,232,21
BR1_2718268703,14,False,0,1,0,19177,202,44,7.6,True,6,True,1,0,0,15757,148,44,7.0,False,29.330333333333332,3420,8,-1,246,192,54
BR1_2731280642,10,False,0,1,0,18037,182,51,7.4,True,8,True,1,0,0,17707,194,76,7.4,False,27.7687,330,2,-1,233,270,-37
BR1_2686511837,8,False,0,0,0,16255,139,36,6.4,False,17,True,1,1,0,19774,132,44,7.0,True,26.7283,-3519,-9,-1,175,176,-1
BR1_2703581074,4,False,0,0,0,14983,177,36,6.8,False,9,True,0,0,0,17834,212,40,7.4,True,28.589766666666666,-2851,-5,0,213,252,-39
BR1_2685490738,6,False,0,0,0,15540,142,44,6.8,False,6,True,0,1,1,17205,162,36,7.2,True,29.492516666666667,-1665,0,0,186,198,-12
BR1_2684567890,8,True,1,1,1,19135,175,52,7.2,True,6,False,0,0,0,15223,166,44,7.0,False,29.137016666666668,3912,2,1,227,210,17
BR1_2715745083,9,True,1,0,0,17904,212,48,7.0,False,2,False,0,0,0,14668,198,56,7.0,True,28.073016666666668,3236,7,1,260,254,6
BR1_2675687043,5,False,1,0,0,16178,219,44,7.4,False,8,True,0,1,0,17648,194,40,7.4,True,29.577916666666667,-1470,-3,1,263,234,29
BR1_2728193687,10,False,0,0,0,19095,192,40,6.8,False,16,True,1,1,0,21115,141,60,7.0,True,27.763266666666667,-2020,-6,-1,232,201,31
BR1_2731280626,1,False,0,0,0,11884,156,40,6.2,False,5,True,1,0,0,14392,154,40,6.8,True,26.948216666666667,-2508,-4,-1,196,194,2
BR1_2730297229,9,True,0,0,0,15418,134,51,6.6,False,5,False,0,0,0,14552,147,40,6.4,True,26.24105,866,4,0,185,187,-2
BR1_2728796175,7,True,1,1,0,17292,233,44,7.2,True,1,False,0,0,0,13138,165,48,6.4,False,28.257433333333335,4154,6,1,277,213,64
BR1_2728172011,6,False,0,0,0,14532,157,40,6.8,False,8,True,1,0,0,16154,155,56,6.6,True,25.441566666666667,-1622,-2,-1,197,211,-14
BR1_2729468085,14,True,0,0,0,20016,220,72,7.6,True,2,False,1,1,0,14378,149,44,6.6,False,29.10845,5638,12,-1,292,193,99
BR1_2728526497,6,True,1,0,0,14657,148,40,6.4,True,0,False,0,0,0,12418,161,56,6.4,False,25.75985,2239,6,1,188,217,-29
BR1_2710915480,10,True,1,0,0,17943,185,52,7.0,True,9,False,0,0,0,17542,198,40,6.6,False,26.7853,401,1,1,237,238,-1
BR1_2725870355,4,True,1,0,0,12465,97,44,5.0,False,7,False,0,0,0,16110,167,56,6.8,True,26.38965,-3645,-3,1,141,223,-82
BR1_2697775440,2,True,0,0,0,12760,161,32,6.2,True,8,False,1,0,0,16351,140,40,6.2,False,26.17665,-3591,-6,-1,193,180,13
BR1_2697757655,8,True,0,1,0,18056,182,60,7.2,True,0,False,0,0,0,13007,155,56,6.8,False,27.949016666666665,5049,8,0,242,211,31
BR1_2730117965,4,False,1,1,1,16022,194,52,6.6,True,4,True,0,0,0,12588,109,40,5.0,False,27.1732,3434,0,1,246,149,97
BR1_2731385836,11,False,0,1,0,19922,182,60,7.6,False,12,True,1,0,0,19259,175,54,7.4,True,29.663083333333333,663,-1,-1,242,229,13
BR1_2731370027,15,True,1,1,0,21454,216,64,7.6,True,6,False,0,0,0,15921,180,51,6.8,False,27.6245,5533,9,1,280,231,49
BR1_2731364035,5,True,1,1,0,15519,188,52,6.4,True,4,False,0,0,0,13174,137,40,6.6,False,26.126383333333333,2345,1,1,240,177,63
BR1_2730972475,7,False,0,1,0,17379,175,56,7.0,True,7,True,1,0,0,15924,152,48,7.0,False,29.176333333333332,1455,0,-1,231,200,31
BR1_2675048880,2,True,0,0,0,14554,171,64,7.0,True,0,False,1,0,0,12796,161,64,6.4,False,25.959433333333333,1758,2,-1,235,225,10
BR1_2671912362,3,False,0,0,0,12857,147,28,6.6,True,3,True,0,1,0,13737,157,40,6.4,False,27.095933333333335,-880,0,0,175,197,-22
BR1_2728417550,11,True,0,1,0,20160,154,52,7.2,True,11,False,1,0,0,18089,142,36,6.8,False,28.5107,2071,0,-1,206,178,28
BR1_2730744569,7,True,0,0,0,17161,180,72,7.2,True,10,False,1,0,0,17140,149,56,7.0,False,27.663383333333332,21,-3,-1,252,205,47
BR1_2729434742,7,True,1,1,0,16373,139,70,6.8,True,9,False,0,0,0,17261,153,60,7.0,False,29.33265,-888,-2,1,209,213,-4
BR1_2731312849,5,False,0,0,0,14446,150,60,6.4,False,8,True,1,1,0,17520,206,59,6.8,True,26.239633333333334,-3074,-3,-1,210,265,-55
BR1_2731270811,11,True,1,0,0,17321,184,52,6.6,True,6,False,0,0,0,15941,199,42,6.6,False,26.95765,1380,5,1,236,241,-5
BR1_2731585105,11,True,1,0,0,18075,181,56,7.2,True,4,False,0,0,0,14131,148,38,7.0,False,29.43205,3944,7,1,237,186,51
BR1_2730970878,6,True,1,0,0,13682,126,40,6.8,False,8,False,0,0,0,16647,175,52,6.6,True,25.698116666666667,-2965,-2,1,166,227,-61
BR1_2687653272,10,False,1,0,0,16643,187,68,7.2,True,3,True,0,0,0,12451,133,40,6.6,False,26.130683333333334,4192,7,1,255,173,82
BR1_2710934503,5,False,0,0,0,16597,151,68,7.0,False,10,True,0,1,0,18186,201,52,7.0,True,29.883733333333332,-1589,-5,0,219,253,-34
BR1_2729439542,6,True,1,0,0,16940,190,56,7.6,True,5,False,0,1,0,16714,184,63,7.4,False,28.720766666666666,226,1,1,246,247,-1
BR1_2731349552,5,True,0,1,0,15530,184,56,6.6,True,2,False,0,0,0,13069,157,48,6.4,False,25.299266666666668,2461,3,0,240,205,35
BR1_2730329128,6,True,0,0,0,15279,194,42,6.8,False,3,False,1,0,0,14153,163,40,6.6,True,26.436016666666667,1126,3,-1,236,203,33
BR1_2731018880,10,True,0,1,0,17570,170,40,7.0,False,8,False,1,0,0,17355,164,48,6.8,True,28.216083333333334,215,2,-1,210,212,-2
BR1_2730663037,9,True,1,0,0,15985,142,40,6.2,False,5,False,0,0,0,14870,183,44,6.4,True,27.163016666666667,1115,4,1,182,227,-45
BR1_2700373368,6,False,0,0,0,15452,162,52,7.2,False,7,True,1,1,0,17456,185,60,7.4,True,29.680533333333333,-2004,-1,-1,214,245,-31
BR1_2680300323,3,False,1,1,0,15284,204,68,7.2,True,5,True,0,0,0,15387,181,36,7.0,False,28.321283333333334,-103,-2,1,272,217,55
BR1_2677920113,4,False,0,0,0,13066,159,56,6.8,False,6,True,1,1,0,15661,198,64,7.0,True,25.815316666666668,-2595,-2,-1,215,262,-47
BR1_2731242917,11,True,1,0,0,16468,171,40,6.4,True,5,False,0,0,0,14268,144,52,6.4,False,27.351416666666665,2200,6,1,211,196,15
BR1_2729938127,5,True,1,0,0,15455,189,52,6.6,True,6,False,0,1,0,15411,160,50,6.8,False,26.624133333333333,44,-1,1,241,210,31
BR1_2731458032,7,True,1,0,0,16977,204,35,6.8,False,6,False,0,0,0,16494,186,64,7.2,True,28.712716666666665,483,1,1,239,250,-11
BR1_2726917997,7,False,1,0,0,16502,194,64,7.6,True,2,True,0,0,0,14578,176,50,6.8,False,29.226816666666668,1924,5,1,258,226,32
BR1_2714130675,7,False,1,0,0,16106,126,60,7.2,True,12,True,0,1,0,18289,126,60,7.2,False,28.1996,-2183,-5,1,186,186,0
BR1_2730763058,3,True,1,0,0,15012,180,58,7.2,True,1,False,0,1,0,12995,145,46,6.6,False,27.236516666666667,2017,2,1,238,191,47
BR1_2708241485,4,False,0,0,0,14687,158,40,7.0,False,9,True,1,1,0,17907,176,56,7.0,True,29.8745,-3220,-5,-1,198,232,-34
BR1_2704959559,6,False,0,0,0,14985,156,56,7.0,False,7,True,0,0,0,16533,189,32,7.4,True,29.653033333333333,-1548,-1,0,212,221,-9
BR1_2730139352,7,True,1,0,0,16782,180,60,7.4,False,4,False,0,1,1,17366,188,59,7.2,True,28.828983333333333,-584,3,1,240,247,-7
BR1_2731641560,3,False,0,1,0,14655,142,49,6.6,False,10,True,1,0,0,18528,228,60,7.8,True,27.95865,-3873,-7,-1,191,288,-97
BR1_2724556754,8,True,0,0,0,16328,170,40,6.8,False,10,False,1,1,0,17982,193,64,7.2,True,29.677366666666668,-1654,-2,-1,210,257,-47
BR1_2718266375,4,False,0,1,0,16486,186,72,7.4,True,7,True,0,0,0,16252,184,52,7.0,False,28.5653,234,-3,0,258,236,22
BR1_2705756897,5,True,1,0,0,14692,144,44,7.0,False,6,False,0,0,0,16995,196,56,7.4,True,29.433566666666668,-2303,-1,1,188,252,-64
BR1_2703560014,4,False,0,0,0,14897,172,48,6.4,False,7,True,1,0,0,15707,178,56,6.6,True,26.809966666666668,-810,-3,-1,220,234,-14
BR1_2727862178,9,False,0,0,0,15536,159,52,6.2,True,11,True,0,0,0,17452,169,44,6.8,False,26.601866666666666,-1916,-2,0,211,213,-2
BR1_2727835196,8,False,1,0,0,17612,216,48,7.2,False,7,True,0,1,0,17456,203,60,7.0,True,28.856016666666665,156,1,1,264,263,1
BR1_2726122715,6,False,0,0,0,15585,169,39,6.8,False,9,True,1,1,1,18617,170,56,7.0,True,27.6336,-3032,-3,-1,208,226,-18
BR1_2716827021,8,True,0,0,0,14942,139,44,6.8,False,2,False,0,1,0,13247,164,48,6.6,True,25.719683333333332,1695,6,0,183,212,-29
BR1_2731567051,7,False,0,0,0,15873,194,56,7.0,False,9,True,1,0,0,18620,214,52,7.4,True,29.891183333333334,-2747,-2,-1,250,266,-16
BR1_2731552411,7,False,0,1,0,17183,186,62,7.0,True,2,True,0,0,0,13635,200,42,6.8,False,25.659283333333335,3548,5,0,248,242,6
BR1_2725281348,3,False,0,0,0,15540,219,56,7.0,False,8,True,0,0,0,17089,189,44,7.2,True,27.828883333333334,-1549,-5,0,275,233,42
BR1_2688047662,11,True,0,1,0,17491,142,46,5.8,False,6,False,1,0,1,18912,221,58,7.2,True,28.7046,-1421,5,-1,188,279,-91
BR1_2730946175,7,True,1,0,0,17752,205,48,7.0,True,8,False,0,0,0,17005,160,52,7.0,False,29.4947,747,-1,1,253,212,41
BR1_2730795689,14,True,1,1,0,20221,173,56,6.8,True,6,False,0,0,0,16421,178,47,6.8,False,28.5232,3800,8,1,229,225,4
BR1_2730461809,6,False,1,0,0,15970,168,52,7.0,False,11,True,0,1,0,18513,205,56,7.6,True,28.1593,-2543,-5,1,220,261,-41
BR1_2726727236,12,False,1,0,0,19430,190,51,7.2,True,8,True,0,0,0,17521,183,52,6.8,False,28.403033333333333,1909,4,1,241,235,6
BR1_2723956884,7,True,0,0,0,15494,183,48,6.6,True,6,False,0,0,0,14560,140,44,6.2,False,25.978083333333334,934,1,0,231,184,47
BR1_2730909390,4,True,0,1,0,15347,162,52,6.8,False,6,False,1,0,0,18284,197,64,7.0,True,27.565583333333333,-2937,-2,-1,214,261,-47
BR1_2730726597,5,True,0,0,0,16366,199,52,6.8,False,7,False,1,1,0,17102,175,48,7.0,True,28.656216666666666,-736,-2,-1,251,223,28
BR1_2731477315,6,True,1,0,0,15161,155,45,6.2,True,3,False,0,0,0,12609,116,48,6.6,False,25.17405,2552,3,1,200,164,36
BR1_2680949199,7,False,1,0,0,14379,128,48,6.0,False,8,True,0,0,0,15168,153,36,6.6,True,27.07135,-789,-1,1,176,189,-13
BR1_2729710350,8,True,1,0,0,18050,191,46,7.0,False,11,False,0,0,0,17749,152,33,6.4,True,29.36478333333333,301,-3,1,237,185,52
BR1_2729686311,3,False,0,0,0,13892,178,50,6.4,False,7,True,1,0,0,15578,180,50,6.4,True,26.67615,-1686,-4,-1,228,230,-2
BR1_2731283000,5,True,0,0,0,13353,138,41,6.0,False,10,False,0,0,0,15427,121,30,6.4,True,26.847516666666667,-2074,-5,0,179,151,28
BR1_2731487645,9,True,1,0,0,17196,172,64,7.4,True,7,False,0,1,0,17089,183,48,7.4,False,28.59965,107,2,1,236,231,5
BR1_2731474783,3,False,0,0,0,15542,172,52,7.2,False,7,True,0,1,0,18932,208,56,7.8,True,28.657466666666668,-3390,-4,0,224,264,-40
BR1_2718202406,3,True,1,0,0,14123,175,50,6.6,True,4,False,0,0,0,13537,136,56,6.6,False,25.642716666666665,586,-1,1,225,192,33
BR1_2730988230,4,True,0,0,0,14814,158,44,6.4,False,12,False,1,0,0,17608,167,40,6.4,True,26.706716666666665,-2794,-8,-1,202,207,-5
BR1_2719167570,2,False,0,0,0,15073,217,52,7.4,True,3,True,1,1,0,14770,179,68,7.0,False,27.60575,303,-1,-1,269,247,22
BR1_2729333075,9,False,1,1,0,17144,199,64,7.4,True,6,True,0,0,0,16106,186,40,6.8,False,27.645616666666665,1038,3,1,263,226,37
BR1_2729310664,7,False,0,0,0,14724,150,36,6.2,False,8,True,1,0,0,16271,163,48,6.6,True,25.478516666666668,-1547,-1,-1,186,211,-25
BR1_2702307323,11,False,0,0,0,17904,170,72,7.2,True,8,True,1,0,0,16971,177,52,6.8,False,28.535416666666666,933,3,-1,242,229,13
BR1_2700669395,4,False,0,1,0,14396,171,40,6.6,True,6,True,0,0,0,14331,150,36,6.6,False,26.289133333333332,65,-2,0,211,186,25
BR1_2707686522,15,True,1,0,0,20078,178,56,7.4,True,5,False,0,0,0,16355,150,39,6.4,False,29.087116666666667,3723,10,1,234,189,45
BR1_2731141275,5,False,0,0,0,15654,141,48,6.6,True,10,True,1,0,0,16718,165,28,6.4,False,29.70605,-1064,-5,-1,189,193,-4
BR1_2699240212,9,True,0,0,0,15802,143,40,6.6,True,4,False,1,0,0,14079,186,44,6.2,False,27.426183333333334,1723,5,-1,183,230,-47
BR1_2698586560,6,False,1,1,0,15963,129,56,6.6,False,13,True,0,0,0,20042,201,52,7.2,True,27.6217,-4079,-7,1,185,253,-68
BR1_2682906789,7,False,0,0,0,15998,183,48,7.2,False,10,True,1,1,0,16724,158,56,7.2,True,25.47565,-726,-3,-1,231,214,17
BR1_2727321003,4,True,0,0,0,12908,139,28,6.4,False,4,False,1,0,0,14838,177,56,6.6,True,27.02085,-1930,0,-1,167,233,-66
BR1_2695629009,7,True,0,1,1,18441,163,60,7.0,False,8,False,1,0,0,16673,122,54,6.6,True,28.683933333333332,1768,-1,-1,223,176,47
BR1_2720542532,9,True,0,0,0,17760,169,64,7.2,False,3,False,1,0,0,14788,163,40,6.8,True,27.89875,2972,6,-1,233,203,30
BR1_2699132610,4,False,1,0,0,13550,159,39,6.4,False,5,True,0,1,1,16072,164,62,7.0,True,25.53495,-2522,-1,1,198,226,-28
BR1_2730139291,14,False,1,0,0,19049,169,52,7.2,True,2,True,0,1,0,14763,165,67,6.4,False,27.532666666666668,4286,12,1,221,232,-11
BR1_2687264719,11,False,1,0,0,17890,183,52,7.6,True,7,True,0,1,0,17029,178,52,7.4,False,28.572966666666666,861,4,1,235,230,5
BR1_2730680203,3,False,0,0,0,14206,166,48,6.6,False,11,True,1,0,0,17155,170,44,7.0,True,25.451983333333335,-2949,-8,-1,214,214,0
BR1_2730631105,9,True,1,0,0,16270,148,48,6.6,True,8,False,0,1,0,15261,147,40,6.6,False,27.122016666666667,1009,1,1,196,187,9
BR1_2731252240,8,True,1,0,0,17581,194,64,7.0,True,8,False,0,0,0,17064,197,51,7.2,False,27.715516666666666,517,0,1,258,248,10
BR1_2700870968,6,False,1,0,0,15991,195,52,7.2,False,7,True,0,1,0,16560,199,44,7.0,True,28.113533333333333,-569,-1,1,247,243,4
BR1_2700193015,9,True,1,1,0,17526,167,60,7.0,True,3,False,0,0,0,12603,123,38,6.4,False,26.54145,4923,6,1,227,161,66
BR1_2713540657,5,True,0,0,0,14671,164,44,6.6,False,5,False,0,0,0,15554,176,44,7.0,True,26.468,-883,0,0,208,220,-12
BR1_2721356623,7,True,0,1,0,17868,222,70,7.2,False,11,False,0,0,0,19882,234,54,7.6,True,28.8368,-2014,-4,0,292,288,4
BR1_2717819214,4,False,1,0,0,14666,165,60,6.6,True,4,True,0,1,0,12912,124,39,6.2,False,25.148466666666668,1754,0,1,225,163,62
BR1_2716296200,3,False,0,0,0,13732,167,48,6.4,False,5,True,1,0,0,14838,173,64,7.0,True,26.1442,-1106,-2,-1,215,237,-22
BR1_2687104604,3,False,0,0,0,14648,203,60,7.0,False,7,True,1,0,0,16404,159,56,6.8,True,26.3706,-1756,-4,-1,263,215,48
BR1_2686893071,7,True,0,0,0,15251,157,44,6.8,True,5,False,0,0,0,14034,162,55,6.6,False,26.831616666666665,1217,2,0,201,217,-16
BR1_2722186126,5,True,0,0,0,15039,145,67,6.8,False,2,False,1,0,0,14047,186,56,6.8,True,26.6681,992,3,-1,212,242,-30
BR1_2729361207,3,False,0,0,0,12852,139,48,6.4,False,7,True,1,1,0,16483,210,60,7.0,True,25.670283333333334,-3631,-4,-1,187,270,-83
BR1_2697654034,17,True,0,1,0,20689,165,48,7.4,True,7,False,0,0,0,15827,146,54,6.8,False,27.077833333333334,4862,10,0,213,200,13
BR1_2730525877,7,True,1,0,0,18017,246,73,7.4,True,6,False,0,0,0,17840,220,55,7.2,False,29.519866666666665,177,1,1,319,275,44
BR1_2731211957,4,True,0,1,0,15987,199,60,7.0,True,4,False,1,0,0,15712,200,64,7.4,False,29.0359,275,0,-1,259,264,-5
BR1_2730677464,7,True,1,0,0,14648,148,36,6.4,False,4,False,0,1,0,14875,166,60,6.8,True,26.61915,-227,3,1,184,226,-42
BR1_2730039944,9,True,0,0,0,17765,198,58,7.0,True,1,False,0,0,0,13097,168,45,6.4,False,27.0131,4668,8,0,256,213,43
BR1_2705029533,2,False,0,0,0,12578,123,56,6.8,False,2,True,1,1,0,14111,183,68,7.0,True,27.371966666666665,-1533,0,-1,179,251,-72
BR1_2730292050,5,True,1,0,0,16542,213,52,7.4,True,3,False,0,1,0,14941,180,60,7.2,False,29.864016666666668,1601,2,1,265,240,25
BR1_2730709056,12,True,1,0,0,17483,171,36,6.4,False,5,False,0,1,0,16910,213,44,7.4,True,29.037816666666668,573,7,1,207,257,-50
BR1_2720477019,6,True,0,0,0,15594,175,52,6.8,True,1,False,0,0,0,12033,156,40,6.2,False,25.520666666666667,3561,5,0,227,196,31
BR1_2724493613,9,True,0,0,0,18276,209,64,7.4,True,3,False,0,0,0,14614,169,52,7.2,False,29.749766666666666,3662,6,0,273,221,52
BR1_2690840707,10,True,1,0,0,17374,183,36,6.8,False,10,False,0,1,1,19739,161,64,7.4,True,27.652316666666668,-2365,0,1,219,225,-6
BR1_2690823733,12,False,0,0,0,17932,189,28,6.4,True,5,True,1,0,0,13913,175,40,6.2,False,25.037066666666668,4019,7,-1,217,215,2
BR1_2688441656,9,False,0,0,0,18173,175,52,7.6,True,3,True,1,0,0,13660,152,49,7.0,False,28.401433333333333,4513,6,-1,227,201,26
BR1_2730783779,3,True,0,0,0,15284,183,68,7.4,False,3,False,1,0,0,15132,198,48,7.0,True,27.722433333333335,152,0,-1,251,246,5
BR1_2730743929,7,True,1,1,0,17284,175,56,6.8,True,8,False,0,0,0,15894,120,56,6.8,False,27.42105,1390,-1,1,231,176,55
BR1_2730611691,3,False,0,0,0,14942,194,48,7.0,False,8,True,1,1,0,17455,161,55,7.0,True,28.6477,-2513,-5,-1,242,216,26
BR1_2730269261,5,True,1,0,0,14597,145,48,6.4,False,7,False,0,1,0,16089,171,52,6.8,True,26.19285,-1492,-2,1,193,223,-30
BR1_2705286045,6,True,0,0,0,14412,128,44,6.2,False,6,False,1,0,0,14964,157,40,6.4,True,25.026933333333332,-552,0,-1,172,197,-25
BR1_2700402935,6,True,0,1,0,16765,173,52,6.8,False,7,False,1,0,0,16347,178,56,7.2,True,27.921083333333332,418,-1,-1,225,234,-9
BR1_2729037270,10,True,1,0,0,17613,155,48,6.6,True,10,False,0,0,0,18453,160,52,7.2,False,28.601033333333334,-840,0,1,203,212,-9
BR1_2729010379,5,True,0,0,0,15256,158,48,7.0,False,6,False,1,1,0,17037,190,52,7.2,True,28.422033333333335,-1781,-1,-1,206,242,-36
BR1_2724063255,4,True,0,0,0,13351,138,46,6.6,True,2,False,0,0,0,13887,170,44,6.8,False,26.703383333333335,-536,2,0,184,214,-30
BR1_2719468480,10,True,0,0,0,16152,172,52,7.0,True,3,False,1,0,0,13960,168,48,6.6,False,26.828416666666666,2192,7,-1,224,216,8
BR1_2668361597,11,False,0,0,0,18573,193,39,7.4,True,7,True,1,1,0,17098,162,68,7.0,False,28.577733333333335,1475,4,-1,232,230,2
BR1_2730919053,9,True,0,0,0,17598,168,60,7.0,False,10,False,1,0,0,18638,171,48,7.0,True,29.641083333333334,-1040,-1,-1,228,219,9
BR1_2726521312,5,True,0,1,0,15699,157,72,6.8,False,9,False,1,0,0,16676,184,40,6.6,True,26.480183333333333,-977,-4,-1,229,224,5
BR1_2715423104,10,False,0,0,0,17511,165,46,7.2,False,2,True,1,1,1,15845,174,49,6.8,True,27.780633333333334,1666,8,-1,211,223,-12
BR1_2730209278,9,True,0,0,0,17634,146,52,7.0,False,11,False,1,0,0,18318,194,56,7.0,True,27.9025,-684,-2,-1,198,250,-52
BR1_2730439563,9,False,1,0,0,17650,183,56,7.4,False,9,True,0,1,0,18254,168,56,7.4,True,29.0842,-604,0,1,239,224,15
BR1_2723992665,7,True,1,0,0,16913,200,51,6.8,True,5,False,0,0,0,14962,126,44,6.6,False,26.659066666666668,1951,2,1,251,170,81
BR1_2694672266,10,True,1,1,0,16410,171,48,7.2,True,2,False,0,0,0,13452,141,48,6.4,False,26.6674,2958,8,1,219,189,30
BR1_2694652924,5,True,0,0,0,15139,169,44,7.0,False,4,False,1,0,0,16197,197,68,7.2,True,28.698433333333334,-1058,1,-1,213,265,-52
BR1_2694557439,3,True,0,0,0,13452,138,48,6.8,False,5,False,1,0,0,16388,176,64,7.4,True,29.764466666666667,-2936,-2,-1,186,240,-54
BR1_2723346189,2,True,1,0,0,13506,179,62,6.6,True,2,False,0,1,0,13634,150,52,6.6,False,25.952783333333333,-128,0,1,241,202,39
BR1_2731320061,5,True,0,1,0,15714,158,50,6.8,False,3,False,0,0,0,15232,185,44,7.0,True,28.098716666666668,482,2,0,208,229,-21
BR1_2731217809,3,False,0,0,0,13203,153,44,6.2,False,10,True,1,0,0,16650,180,51,6.8,True,26.861333333333334,-3447,-7,-1,197,231,-34
BR1_2731373673,6,True,0,0,0,14474,141,48,6.8,True,4,False,1,1,0,13805,163,68,6.8,False,25.21975,669,2,-1,189,231,-42
BR1_2704527757,4,True,0,0,0,14475,197,40,6.8,True,8,False,1,0,0,15803,157,64,6.6,False,26.0408,-1328,-4,-1,237,221,16
BR1_2726857609,8,True,1,0,0,15354,154,40,6.2,True,4,False,0,0,0,14868,184,48,6.6,False,25.118433333333332,486,4,1,194,232,-38
BR1_2726831849,9,True,0,0,0,17450,157,64,7.6,True,2,False,0,0,0,15177,212,44,6.8,False,29.069483333333334,2273,7,0,221,256,-35
BR1_2726820006,3,True,0,0,0,14183,145,51,6.8,False,6,False,0,0,1,18931,235,46,7.4,True,28.80695,-4748,-3,0,196,281,-85
BR1_2730211468,1,False,1,0,0,12838,162,48,6.6,False,2,True,0,0,0,14349,195,60,6.8,True,26.9346,-1511,-1,1,210,255,-45
BR1_2731630665,7,True,1,0,0,16266,170,46,6.8,False,9,False,0,0,0,16579,137,52,7.0,True,27.646616666666667,-313,-2,1,216,189,27
BR1_2731273953,3,True,0,1,0,14138,147,48,6.8,False,2,False,1,0,0,13846,150,48,6.8,True,26.455333333333332,292,1,-1,195,198,-3
BR1_2731513661,6,False,0,1,0,17449,174,52,6.8,False,7,True,0,0,0,15929,171,56,6.8,True,27.8685,1520,-1,0,226,227,-1
BR1_2694912293,12,True,1,0,1,21579,216,48,7.4,True,7,False,0,0,0,15392,149,60,6.8,False,28.091383333333333,6187,5,1,264,209,55
BR1_2731351707,13,True,0,0,0,18483,174,42,6.6,False,13,False,1,0,0,17092,162,53,6.8,True,27.059416666666667,1391,0,-1,216,215,1
BR1_2731343200,5,True,0,0,0,15238,160,44,6.8,False,7,False,0,0,0,17109,206,32,6.8,True,29.054216666666665,-1871,-2,0,204,238,-34
BR1_2707200740,4,False,1,1,0,17159,235,71,7.6,True,5,True,0,0,0,15113,160,48,7.0,False,28.157683333333335,2046,-1,1,306,208,98
BR1_2703379103,5,False,0,0,0,14439,186,42,6.6,True,9,True,0,0,0,15910,153,42,6.6,False,26.334733333333332,-1471,-4,0,228,195,33
BR1_2727499721,2,False,1,1,0,16206,199,52,7.0,True,5,True,0,0,0,16152,206,40,7.6,False,27.5913,54,-3,1,251,246,5
BR1_2727418047,5,True,0,0,0,13949,153,36,6.4,False,10,False,0,0,0,16263,190,40,6.6,True,26.858016666666668,-2314,-5,0,189,230,-41
BR1_2727909839,11,True,0,0,0,17219,171,36,7.0,False,10,False,0,1,0,17946,174,58,7.2,True,28.5586,-727,1,0,207,232,-25
BR1_2694636363,4,True,1,0,0,13966,144,48,6.4,True,4,False,0,0,0,13533,145,48,6.6,False,27.22671666666667,433,0,1,192,193,-1
BR1_2730080129,16,True,1,1,0,22334,218,56,7.4,True,9,False,0,0,0,19536,245,44,7.4,False,29.42185,2798,7,1,274,289,-15
BR1_2729721208,4,False,0,1,0,14907,156,56,6.8,False,9,True,1,0,0,19070,222,55,7.2,True,28.077566666666666,-4163,-5,-1,212,277,-65
BR1_2728016299,8,True,0,1,0,17037,170,44,6.6,True,5,False,1,0,0,14297,146,44,6.6,False,26.134733333333333,2740,3,-1,214,190,24
BR1_2711424184,8,True,1,0,0,17387,174,52,7.0,False,6,False,0,1,0,15615,164,44,6.6,True,28.618383333333334,1772,2,1,226,208,18
BR1_2730104257,5,True,0,0,0,15523,177,48,7.0,False,6,False,1,1,0,17144,170,72,7.2,True,29.1378,-1621,-1,-1,225,242,-17
BR1_2729390101,16,True,1,0,0,20176,194,60,7.2,True,6,False,0,0,0,15914,157,36,6.8,False,29.401183333333332,4262,10,1,254,193,61
BR1_2666926907,4,True,1,0,0,13604,137,50,7.0,False,4,False,0,0,0,16149,222,49,7.4,True,27.543083333333332,-2545,0,1,187,271,-84
BR1_2666902318,7,True,1,1,0,15768,190,44,6.8,True,3,False,0,0,0,13052,149,44,6.8,False,26.98885,2716,4,1,234,193,41
BR1_2675858622,3,False,0,1,0,15479,192,28,7.2,False,13,True,1,0,0,17345,157,52,6.8,True,29.335566666666665,-1866,-10,-1,220,209,11
BR1_2673819760,11,True,1,0,0,18300,197,56,7.0,True,5,False,0,0,0,15484,173,60,6.6,False,26.092316666666665,2816,6,1,253,233,20
BR1_2729055922,7,True,0,0,0,16190,177,64,6.8,False,7,False,1,0,0,15414,165,52,6.6,True,26.36231666666667,776,0,-1,241,217,24
BR1_2728037215,9,False,1,1,0,16584,163,56,7.4,True,3,True,0,0,0,13657,132,40,6.2,False,29.202883333333332,2927,6,1,219,172,47
BR1_2722112221,10,True,1,0,0,18784,206,28,6.8,True,8,False,0,0,0,18262,224,28,7.0,False,29.771133333333335,522,2,1,234,252,-18
BR1_2722023791,8,True,1,0,0,16378,180,56,6.8,True,3,False,0,0,0,13491,137,48,6.6,False,26.633733333333332,2887,5,1,236,185,51
BR1_2730386416,6,False,0,0,0,15181,186,22,6.0,False,11,True,1,0,0,16709,159,48,6.0,True,27.249333333333333,-1528,-5,-1,208,207,1
BR1_2725254716,2,True,1,0,0,12567,164,40,6.6,False,3,False,0,0,0,15658,223,44,6.8,True,26.154666666666667,-3091,-1,1,204,267,-63
BR1_2731603139,4,True,0,0,0,14227,166,60,6.8,False,9,False,1,1,0,16396,177,56,6.8,True,27.08185,-2169,-5,-1,226,233,-7
BR1_2731320784,5,True,1,1,0,14150,136,52,6.6,False,7,False,0,0,0,14445,136,38,7.0,True,26.829516666666667,-295,-2,1,188,174,14
BR1_2730315028,9,True,0,1,0,17902,169,48,6.8,True,7,False,1,0,0,17167,168,52,6.6,False,28.540466666666667,735,2,-1,217,220,-3
BR1_2730191449,3,False,1,1,0,17766,216,68,7.4,True,6,True,0,0,0,16031,172,60,6.8,False,29.93205,1735,-3,1,284,232,52
BR1_2730165014,8,False,0,0,0,16328,143,52,6.6,True,6,True,1,1,0,15270,176,52,6.6,False,27.11425,1058,2,-1,195,228,-33
BR1_2729952090,2,False,0,0,0,13884,160,48,6.6,False,9,True,1,1,0,15478,143,60,6.4,True,25.86815,-1594,-7,-1,208,203,5
BR1_2730735829,2,False,0,1,0,14691,191,45,7.0,False,2,True,1,0,0,14039,159,66,7.2,True,29.39905,652,0,-1,236,225,11
BR1_2729738547,5,False,1,1,0,17051,183,48,6.8,True,7,True,0,0,0,16545,188,52,7.0,False,29.778933333333335,506,-2,1,231,240,-9
BR1_2729600606,9,True,1,1,0,16749,156,60,7.2,True,5,False,0,0,0,15911,197,48,7.4,False,28.259816666666666,838,4,1,216,245,-29
BR1_2727511198,8,False,0,0,0,16407,166,36,6.6,False,17,True,1,0,0,22237,199,47,7.0,True,28.9683,-5830,-9,-1,202,246,-44
BR1_2704679595,10,True,1,0,0,15339,129,32,5.8,True,2,False,0,0,0,13331,137,52,6.6,False,27.06325,2008,8,1,161,189,-28
BR1_2704620310,9,False,0,0,0,17002,146,40,6.6,False,11,True,1,1,0,17761,154,56,7.2,True,28.934266666666666,-759,-2,-1,186,210,-24
BR1_2728536101,8,True,1,0,0,16585,175,44,6.8,True,8,False,0,0,0,17249,159,62,7.0,False,28.466433333333335,-664,0,1,219,221,-2
BR1_2685330395,8,True,0,0,0,16276,168,44,6.8,True,4,False,1,0,0,15201,183,43,6.4,False,25.302983333333334,1075,4,-1,212,226,-14
BR1_2728227278,3,False,0,1,0,13248,137,44,6.6,False,3,True,1,0,0,14162,182,64,6.8,True,26.140383333333332,-914,0,-1,181,246,-65
BR1_2718995183,9,False,0,0,0,16720,122,40,6.6,False,15,True,1,1,0,20618,194,40,7.0,True,28.6188,-3898,-6,-1,162,234,-72
BR1_2718781063,10,False,0,0,0,15967,145,36,6.4,False,11,True,0,1,1,19119,144,44,6.2,True,28.414483333333333,-3152,-1,0,181,188,-7
BR1_2695718145,8,False,0,0,0,15606,161,36,6.8,True,8,True,0,0,0,17111,157,44,7.0,False,28.152483333333333,-1505,0,0,197,201,-4
BR1_2719190414,9,True,1,0,0,18614,191,60,7.0,True,7,False,0,1,0,16863,159,40,6.8,False,29.32655,1751,2,1,251,199,52
BR1_2731547796,12,True,1,0,0,17794,122,44,6.6,False,10,False,0,0,0,18910,191,40,7.0,True,29.902616666666667,-1116,2,1,166,231,-65
BR1_2731630653,5,False,0,0,0,13503,126,36,6.0,False,7,True,1,0,0,15974,146,52,6.6,True,26.628166666666665,-2471,-2,-1,162,198,-36
BR1_2731287353,6,True,0,0,0,15403,176,43,6.8,False,4,False,1,0,0,14482,173,52,6.6,True,26.591816666666666,921,2,-1,219,225,-6
BR1_2731264221,7,False,1,0,0,16478,162,60,7.2,True,6,True,0,0,0,17135,206,60,7.2,False,27.6577,-657,1,1,222,266,-44
BR1_2729779571,2,True,1,1,0,15220,216,48,7.4,False,1,False,0,0,0,15542,226,72,7.4,True,28.755116666666666,-322,1,1,264,298,-34
BR1_2731072208,8,True,0,0,0,15627,152,44,6.4,True,4,False,1,0,0,14053,142,64,6.2,False,27.153616666666668,1574,4,-1,196,206,-10
BR1_2730283924,10,False,1,0,0,18481,242,72,8.0,True,5,True,0,0,0,16031,181,56,7.4,False,29.533033333333332,2450,5,1,314,237,77
BR1_2723629664,6,False,0,0,0,15611,162,48,7.0,False,11,True,0,0,0,18981,196,60,7.4,True,29.977683333333335,-3370,-5,0,210,256,-46
BR1_2730789156,9,True,0,0,0,16413,161,44,6.4,True,6,False,0,0,0,13779,125,28,6.2,False,27.349533333333333,2634,3,0,205,153,52
BR1_2730343969,6,False,0,1,0,15621,145,60,7.0,False,8,True,1,0,0,18706,222,72,7.6,True,29.7337,-3085,-2,-1,205,294,-89
BR1_2728550250,4,False,1,0,0,16253,202,52,6.8,True,6,True,0,0,0,16127,197,36,7.0,False,27.60285,126,-2,1,254,233,21
BR1_2731209890,2,False,1,0,0,14737,186,56,6.8,True,1,True,0,0,0,13271,193,43,6.4,False,25.94615,1466,1,1,242,236,6
BR1_2729624244,3,False,0,0,0,13092,129,44,6.2,False,11,True,1,0,0,16316,148,44,7.0,True,25.44645,-3224,-8,-1,173,192,-19
BR1_2731295570,4,False,0,1,0,16300,185,51,7.4,True,9,True,1,0,0,16271,169,68,7.0,False,29.888866666666665,29,-5,-1,236,237,-1
BR1_2694586489,3,True,0,0,0,13262,143,43,6.2,True,4,False,0,1,0,15083,156,45,6.8,False,27.28535,-1821,-1,0,186,201,-15
BR1_2726402222,5,True,0,0,0,14465,161,36,6.8,False,8,False,1,1,0,17133,175,35,6.8,True,29.30255,-2668,-3,-1,197,210,-13
BR1_2726868136,10,True,1,0,0,16486,180,48,6.8,True,2,False,0,0,0,13560,174,52,6.8,False,26.01406666666667,2926,8,1,228,226,2
BR1_2685948018,2,False,0,0,0,13398,201,40,6.8,True,5,True,0,0,0,15373,216,51,7.0,False,26.598416666666665,-1975,-3,0,241,267,-26
BR1_2731629260,10,True,0,0,0,17372,192,31,6.6,True,9,False,0,0,0,16885,174,45,6.6,False,25.794816666666666,487,1,0,223,219,4
BR1_2731173355,6,False,1,0,0,14495,150,76,6.6,False,5,True,0,0,0,14577,193,32,6.4,True,26.59405,-82,1,1,226,225,1
BR1_2730176850,8,False,1,1,0,15241,132,40,6.8,True,5,True,0,0,0,14663,158,47,6.6,False,26.6337,578,3,1,172,205,-33
BR1_2730699215,16,True,1,0,0,20297,201,36,7.2,True,9,False,0,0,0,16755,154,52,7.0,False,27.7194,3542,7,1,237,206,31
BR1_2677721758,7,True,1,0,0,17083,220,56,7.6,True,2,False,0,1,0,14621,165,44,7.2,False,29.407616666666666,2462,5,1,276,209,67
BR1_2702061952,5,False,0,0,0,14725,166,52,6.4,True,8,True,1,0,0,16201,151,60,6.8,False,25.0663,-1476,-3,-1,218,211,7
BR1_2691052077,2,False,1,0,0,13807,187,56,6.6,True,4,True,0,1,0,14119,173,40,6.6,False,26.52165,-312,-2,1,243,213,30
BR1_2685263201,1,False,0,0,0,12173,155,40,6.6,False,9,True,1,0,0,15686,164,48,7.0,True,25.539316666666668,-3513,-8,-1,195,212,-17
BR1_2679069757,10,True,1,1,0,18283,182,68,7.0,True,3,False,0,0,0,14409,171,44,6.8,False,29.87986666666667,3874,7,1,250,215,35
BR1_2730757667,5,False,0,1,0,15802,166,52,7.0,False,8,True,1,0,0,17701,189,47,7.2,True,29.6838,-1899,-3,-1,218,236,-18
BR1_2731428707,6,False,0,0,0,15235,165,39,6.4,False,7,True,1,0,0,15384,152,48,6.6,True,26.92915,-149,-1,-1,204,200,4
BR1_2731274111,0,False,0,0,0,12235,159,44,6.6,False,5,True,0,0,0,15530,167,52,6.8,True,26.363933333333332,-3295,-5,0,203,219,-16
BR1_2729508333,7,False,0,0,0,15859,168,48,6.6,True,11,True,0,0,0,16576,151,48,6.4,False,27.167366666666666,-717,-4,0,216,199,17
BR1_2730275318,9,False,0,0,0,15496,143,32,6.2,False,10,True,1,0,0,17193,152,64,6.6,True,25.3654,-1697,-1,-1,175,216,-41
BR1_2663118958,4,True,0,0,1,16475,188,36,6.8,True,2,False,0,0,0,13705,178,52,6.6,False,25.17465,2770,2,0,224,230,-6
BR1_2662438403,6,True,0,0,0,14160,192,48,6.6,False,8,False,1,0,0,15643,130,60,6.6,True,26.014966666666666,-1483,-2,-1,240,190,50
BR1_2662189964,5,True,1,0,0,16097,194,68,7.2,True,6,False,0,0,0,16328,202,52,7.6,False,28.728766666666665,-231,-1,1,262,254,8
BR1_2731183770,6,True,0,0,0,15386,139,44,6.6,False,14,False,1,1,0,20655,187,51,7.4,True,27.76045,-5269,-8,-1,183,238,-55
BR1_2711923219,2,False,0,0,0,13071,170,52,6.8,True,2,True,0,0,0,13803,191,44,6.6,False,25.700683333333334,-732,0,0,222,235,-13
BR1_2731276586,7,False,1,0,0,14159,128,28,5.8,True,7,True,0,0,0,15156,149,31,5.8,False,27.2098,-997,0,1,156,180,-24
BR1_2718184132,11,True,0,1,0,19844,168,64,7.2,True,6,False,1,0,0,16388,123,60,6.8,False,28.05235,3456,5,-1,232,183,49
BR1_2717390699,7,False,1,0,0,16632,157,56,7.0,True,7,True,0,0,0,16287,189,52,7.2,False,29.82196666666667,345,0,1,213,241,-28
BR1_2716915746,7,True,0,0,0,15405,155,24,6.0,True,6,False,0,1,0,15032,138,42,6.6,False,25.97285,373,1,0,179,180,-1
BR1_2677531413,3,True,1,0,0,13497,164,44,6.4,False,4,False,0,0,0,14462,160,40,6.4,True,25.057783333333333,-965,-1,1,208,200,8
BR1_2730952340,8,True,0,1,0,17269,199,55,7.2,False,14,False,0,0,0,18983,184,47,7.0,True,28.58215,-1714,-6,0,254,231,23
BR1_2730839302,10,False,0,0,0,17384,148,72,7.2,False,13,True,1,1,0,20506,179,52,7.4,True,27.916516666666666,-3122,-3,-1,220,231,-11
BR1_2731093938,3,False,1,1,0,15637,216,48,7.0,False,6,True,0,0,0,15865,182,48,7.0,True,29.794216666666667,-228,-3,1,264,230,34
BR1_2730446670,7,True,0,1,0,15147,125,60,6.2,True,9,False,1,0,0,16573,196,36,6.8,False,25.570183333333333,-1426,-2,-1,185,232,-47
BR1_2729569554,4,True,0,0,0,14925,173,56,6.8,False,3,False,1,0,0,15700,204,56,6.8,True,29.710366666666665,-775,1,-1,229,260,-31
BR1_2728370562,2,True,1,1,0,14439,172,56,6.8,True,0,False,0,0,0,12015,157,56,6.6,False,26.230316666666667,2424,2,1,228,213,15
BR1_2674719723,11,False,1,1,0,18244,194,68,7.0,False,3,True,0,0,0,15672,175,52,6.8,True,27.91208333333333,2572,8,1,262,227,35
BR1_2674683516,12,True,1,0,0,19104,154,60,7.6,True,8,False,0,0,0,17252,192,43,7.4,False,27.8815,1852,4,1,214,235,-21
BR1_2718798145,7,False,0,1,1,18517,161,56,7.4,True,8,True,1,0,0,17361,173,44,7.2,False,28.0564,1156,-1,-1,217,217,0
BR1_2731191123,7,False,0,0,0,15302,171,40,6.4,True,10,True,0,0,0,16241,169,36,6.6,False,26.778683333333333,-939,-3,0,211,205,6
BR1_2731596680,10,True,0,1,0,18914,171,44,6.8,False,18,False,1,0,0,21199,149,60,6.8,True,29.645733333333332,-2285,-8,-1,215,209,6
BR1_2731375816,5,False,0,0,0,13739,125,46,6.4,False,8,True,1,0,0,15978,180,40,6.8,True,26.447766666666666,-2239,-3,-1,171,220,-49
BR1_2730274396,1,False,0,0,0,11941,125,40,6.2,False,4,True,1,0,0,14597,150,48,6.4,True,26.062083333333334,-2656,-3,-1,165,198,-33
BR1_2729945901,2,True,0,1,0,15925,199,64,7.2,False,5,False,1,0,0,15745,164,59,7.0,True,29.269,180,-3,-1,263,223,40
BR1_2714887209,7,True,0,0,0,15431,163,40,6.4,False,15,False,1,1,0,19981,140,56,6.6,True,26.85125,-4550,-8,-1,203,196,7
BR1_2731662027,6,True,1,0,0,15976,202,52,7.0,True,4,False,0,0,0,14148,162,60,6.6,False,26.901533333333333,1828,2,1,254,222,32
BR1_2683410163,7,True,0,1,0,17005,174,44,7.2,False,5,False,1,0,0,16224,195,56,7.0,True,29.683983333333334,781,2,-1,218,251,-33
BR1_2698480521,1,False,0,0,0,13514,165,40,6.6,False,13,True,1,1,1,20480,181,60,7.4,True,28.044233333333334,-6966,-12,-1,205,241,-36
BR1_2692159579,14,True,0,0,0,18977,167,28,6.6,True,5,False,1,0,0,14407,134,44,6.0,False,25.28785,4570,9,-1,195,178,17
BR1_2719869277,6,True,0,0,0,17322,216,47,7.2,True,2,False,1,0,0,12778,121,44,6.8,False,28.74416666666667,4544,4,-1,263,165,98
BR1_2731175252,5,False,1,0,0,16680,189,56,7.2,True,9,True,0,0,0,16949,160,36,7.0,False,27.890483333333332,-269,-4,1,245,196,49
BR1_2722280606,4,False,0,0,0,14920,171,47,7.2,False,6,True,0,0,0,17631,214,52,7.6,True,29.690566666666665,-2711,-2,0,218,266,-48
BR1_2729373063,6,True,0,0,0,13741,116,44,6.0,False,11,False,1,0,0,18227,158,52,6.8,True,25.427483333333335,-4486,-5,-1,160,210,-50
BR1_2728437978,2,False,0,0,0,12976,148,46,6.6,False,5,True,0,0,0,14567,154,46,7.0,True,27.493983333333333,-1591,-3,0,194,200,-6
BR1_2685028883,8,False,1,0,0,16736,172,59,7.2,False,9,True,0,0,0,16281,153,56,7.2,True,28.987333333333332,455,-1,1,231,209,22
BR1_2684756844,4,True,0,0,0,12802,140,40,6.4,False,4,False,1,0,0,13189,149,56,6.6,True,26.357266666666668,-387,0,-1,180,205,-25
BR1_2685180844,5,True,1,0,0,13761,156,36,6.6,False,10,False,0,0,0,17092,167,55,7.6,True,26.04008333333333,-3331,-5,1,192,222,-30
BR1_2731527140,1,False,0,0,0,12557,176,36,7.0,False,9,True,1,0,0,16100,188,48,6.8,True,26.97085,-3543,-8,-1,212,236,-24
BR1_2731513059,9,True,0,0,0,15578,134,32,6.2,False,7,False,1,0,0,15916,156,48,6.4,True,26.223333333333333,-338,2,-1,166,204,-38
BR1_2730497560,10,False,0,0,0,16642,175,48,7.2,True,7,True,0,0,0,15683,153,52,7.0,False,27.73285,959,3,0,223,205,18
BR1_2728781448,7,True,0,0,0,14546,145,36,6.4,False,10,False,1,0,0,17543,167,48,6.8,True,26.42985,-2997,-3,-1,181,215,-34
BR1_2723182869,9,True,0,1,1,19386,197,44,7.2,True,6,False,0,0,0,16742,194,44,6.6,False,27.9818,2644,3,0,241,238,3
BR1_2725587848,4,True,1,1,0,16855,178,68,7.0,True,12,False,0,0,0,19636,213,59,7.4,False,27.63685,-2781,-8,1,246,272,-26
BR1_2724321881,7,True,1,0,0,17563,190,64,7.2,True,7,False,0,0,0,16098,181,40,7.2,False,29.192933333333333,1465,0,1,254,221,33
BR1_2728999777,9,True,1,0,0,16996,139,56,6.8,True,5,False,0,0,0,14053,152,28,6.4,False,25.945416666666667,2943,4,1,195,180,15
BR1_2728034465,11,True,0,0,1,18392,169,40,6.8,False,12,False,0,1,0,20013,182,48,7.0,True,28.598316666666665,-1621,-1,0,209,230,-21
BR1_2699269582,5,False,1,1,0,15752,167,51,7.0,True,11,True,0,0,0,18286,179,48,7.4,False,29.87013333333333,-2534,-6,1,218,227,-9
BR1_2731095144,1,True,0,0,0,14645,214,52,7.2,False,5,False,0,1,0,17195,233,64,7.8,True,28.574716666666667,-2550,-4,0,266,297,-31
BR1_2731075129,4,True,0,0,0,16821,200,49,7.4,False,3,False,0,0,0,15873,185,66,7.2,True,29.532083333333333,948,1,0,249,251,-2
BR1_2718298787,5,False,0,0,0,14546,144,48,6.6,False,9,True,1,0,0,16993,179,59,7.0,True,25.171466666666667,-2447,-4,-1,192,238,-46
BR1_2723436930,5,True,1,0,0,16415,212,67,7.6,True,3,False,0,0,0,14169,162,52,6.8,False,29.615083333333335,2246,2,1,279,214,65
BR1_2723388973,6,True,1,1,0,16601,195,52,7.6,False,1,False,0,0,0,15145,212,56,7.4,True,27.771916666666666,1456,5,1,247,268,-21
BR1_2731200648,7,False,1,0,0,15451,139,64,7.0,False,2,True,0,1,0,14528,167,52,7.0,True,27.598366666666667,923,5,1,203,219,-16
BR1_2731414209,5,True,1,1,0,16570,169,72,7.2,False,4,False,0,0,0,15607,176,56,7.2,True,29.330716666666667,963,1,1,241,232,9
BR1_2723550408,3,True,0,1,0,15116,183,39,6.8,False,10,False,1,0,0,18017,215,52,6.8,True,29.715933333333332,-2901,-7,-1,222,267,-45
BR1_2720851146,10,True,1,0,0,19130,208,60,7.6,True,4,False,0,1,0,15096,172,48,6.8,False,28.29595,4034,6,1,268,220,48
BR1_2728172934,7,True,1,0,0,14603,127,52,6.2,True,7,False,0,0,0,14912,149,64,6.8,False,25.509716666666666,-309,0,1,179,213,-34
BR1_2723870555,2,True,1,0,0,14653,182,48,6.6,True,6,False,0,1,0,14718,149,36,5.8,False,26.12775,-65,-4,1,230,185,45
BR1_2697497786,8,False,0,1,0,17477,234,50,7.2,True,5,True,0,0,0,16574,228,52,7.2,False,29.878466666666668,903,3,0,284,280,4
BR1_2695385874,11,True,1,0,0,18341,214,62,7.4,True,4,False,0,0,0,14065,154,52,6.4,False,25.205433333333332,4276,7,1,276,206,70
BR1_2731227111,9,False,0,0,0,17428,179,52,6.8,True,6,True,0,0,0,16474,214,56,6.8,False,26.2363,954,3,0,231,270,-39
BR1_2731198555,2,True,0,0,0,14928,226,44,7.0,False,8,False,0,0,0,17875,248,56,7.6,True,29.661566666666666,-2947,-6,0,270,304,-34
BR1_2721039375,6,True,1,0,0,15015,161,48,6.6,True,5,False,0,0,0,14307,146,40,6.6,False,25.012433333333334,708,1,1,209,186,23
BR1_2721018994,5,False,1,0,0,15951,175,64,7.0,True,3,True,0,0,0,13210,153,52,6.6,False,25.89335,2741,2,1,239,205,34
BR1_2713820421,8,True,0,0,0,16481,143,48,6.6,False,9,False,1,0,0,15767,149,52,6.6,True,25.083916666666667,714,-1,-1,191,201,-10
BR1_2731164678,3,False,1,1,0,15626,182,56,6.4,True,5,True,0,0,0,16531,211,44,7.4,False,27.5517,-905,-2,1,238,255,-17
BR1_2727373466,10,False,1,0,0,17876,185,64,7.0,True,8,True,0,0,0,17088,216,48,6.8,False,25.990716666666668,788,2,1,249,264,-15
BR1_2730273397,9,True,1,0,0,16536,154,44,6.8,True,6,False,0,0,0,14440,179,28,6.2,False,26.1049,2096,3,1,198,207,-9
BR1_2711136936,9,True,1,0,0,16837,141,56,7.2,True,4,False,0,1,0,16929,211,56,7.0,False,27.599916666666665,-92,5,1,197,267,-70
BR1_2731510986,11,False,1,0,0,18527,181,36,7.4,True,7,True,0,0,0,17974,183,52,7.0,False,28.772666666666666,553,4,1,217,235,-18
BR1_2730997378,7,True,0,1,0,16605,185,52,7.2,False,5,False,1,0,0,16518,186,52,7.0,True,29.992816666666666,87,2,-1,237,238,-1
BR1_2730751167,8,True,0,1,0,15885,143,48,7.0,False,4,False,1,0,0,15599,174,52,7.0,True,29.28425,286,4,-1,191,226,-35
BR1_2731270488,3,True,0,0,0,13606,178,25,6.8,False,2,False,0,1,0,14891,229,50,7.4,True,29.824166666666667,-1285,1,0,203,279,-76
BR1_2706366749,8,False,0,1,0,17346,174,40,7.0,False,11,True,1,0,0,18624,153,52,7.0,True,27.95395,-1278,-3,-1,214,205,9
BR1_2698768498,4,False,0,0,0,13479,146,44,6.8,False,9,True,1,0,0,15496,127,60,6.8,True,25.921133333333334,-2017,-5,-1,190,187,3
BR1_2731610024,4,True,1,0,0,14532,132,43,7.2,False,9,False,0,0,0,16962,177,48,7.2,True,28.176266666666667,-2430,-5,1,175,225,-50
BR1_2730435325,10,True,1,0,0,17664,158,48,6.8,True,10,False,0,0,0,17815,161,60,6.8,False,29.564016666666667,-151,0,1,206,221,-15
BR1_2730248330,6,False,0,0,0,15733,171,56,7.0,False,10,True,1,0,0,18782,203,60,7.4,True,27.9345,-3049,-4,-1,227,263,-36
BR1_2696290839,7,True,1,0,0,16620,158,44,6.4,True,6,False,0,0,0,16704,182,56,7.2,False,27.65565,-84,1,1,202,238,-36
BR1_2703072353,4,False,0,0,0,14294,187,36,6.6,False,3,True,1,0,0,14399,170,48,6.6,True,26.16815,-105,1,-1,223,218,5
BR1_2703041661,2,True,0,1,0,15381,185,52,7.4,True,2,False,1,0,0,14337,179,59,7.2,False,28.548966666666665,1044,0,-1,237,238,-1
BR1_2686068214,7,False,1,1,0,16209,170,52,6.8,False,9,True,0,0,0,16907,184,36,7.0,True,28.211183333333334,-698,-2,1,222,220,2
BR1_2686052151,10,False,1,0,0,16581,164,52,6.6,True,11,True,0,1,0,16281,140,32,6.4,False,25.58905,300,-1,1,216,172,44
BR1_2722401485,7,False,0,0,0,16741,179,48,7.0,True,10,True,1,1,0,17375,138,39,7.0,False,29.655716666666667,-634,-3,-1,227,177,50
BR1_2699494226,12,True,1,0,0,18344,172,48,7.0,True,3,False,0,0,0,13841,131,60,6.2,False,25.099866666666667,4503,9,1,220,191,29
BR1_2676077344,6,False,0,0,0,14015,129,36,6.6,False,11,True,0,0,0,17736,168,44,7.0,True,27.463716666666667,-3721,-5,0,165,212,-47
BR1_2726915111,6,False,0,0,0,15852,186,56,7.0,False,6,True,0,0,0,16178,185,52,6.8,True,28.696266666666666,-326,0,0,242,237,5
BR1_2726711905,9,True,0,1,0,18932,204,56,7.2,False,8,False,1,0,0,17555,155,63,6.4,True,27.8019,1377,1,-1,260,218,42
BR1_2726705183,6,False,0,0,0,15482,158,44,6.6,True,6,True,0,0,0,14695,161,48,6.6,False,26.6824,787,0,0,202,209,-7
BR1_2725719111,3,False,0,0,0,12426,123,36,6.2,False,9,True,1,0,0,16219,174,60,6.8,True,26.168216666666666,-3793,-6,-1,159,234,-75
BR1_2724872016,2,True,0,1,0,13976,182,48,7.0,False,4,False,1,0,0,15981,202,52,7.4,True,28.415333333333333,-2005,-2,-1,230,254,-24
BR1_2723085637,8,False,0,0,0,15571,170,40,7.0,False,3,True,0,0,0,14483,208,40,6.6,True,25.983633333333334,1088,5,0,210,248,-38
BR1_2724189008,6,True,1,0,0,15413,174,56,6.8,True,4,False,0,1,0,13982,166,44,6.4,False,25.122183333333332,1431,2,1,230,210,20
BR1_2731329014,6,False,1,0,3,20113,188,52,6.8,True,6,True,0,0,0,16246,146,52,6.2,False,27.81736666666667,3867,0,1,240,198,42
BR1_2731605939,11,True,0,1,0,19575,193,55,7.4,True,9,False,1,0,0,16486,157,52,6.6,False,28.5319,3089,2,-1,248,209,39
BR1_2731417144,7,False,0,0,0,15517,159,56,6.8,True,2,True,1,0,0,13462,184,52,6.8,False,26.995383333333333,2055,5,-1,215,236,-21
BR1_2731582817,4,False,0,0,0,14154,176,52,6.8,False,2,True,0,1,0,14682,188,48,6.6,True,25.358033333333335,-528,2,0,228,236,-8
BR1_2726136512,3,False,0,0,0,14726,184,56,6.8,True,5,True,1,0,0,13749,142,52,6.6,False,27.172933333333333,977,-2,-1,240,194,46
BR1_2725325680,12,True,1,1,0,19635,209,62,7.4,True,5,False,0,0,0,15185,148,52,6.8,False,29.17953333333333,4450,7,1,271,200,71
BR1_2723304123,9,False,0,0,0,19218,204,60,7.4,True,6,True,0,1,0,17873,217,48,7.2,False,28.14175,1345,3,0,264,265,-1
BR1_2723004390,4,True,1,0,0,15100,181,52,6.4,False,9,False,0,1,0,17917,196,52,6.8,True,25.939683333333335,-2817,-5,1,233,248,-15
BR1_2669470116,5,False,0,0,0,14295,121,40,6.6,False,7,True,1,0,0,17237,202,52,7.6,True,28.203433333333333,-2942,-2,-1,161,254,-93
BR1_2703307372,5,True,1,0,0,14684,156,64,7.0,True,2,False,0,1,0,13251,159,40,6.6,False,27.0614,1433,3,1,220,199,21
BR1_2731613689,9,False,1,1,0,17913,169,56,7.4,True,8,True,0,0,0,17388,161,40,7.0,False,28.559833333333334,525,1,1,225,201,24
BR1_2731346150,7,True,0,0,0,17348,191,52,6.8,False,7,False,1,0,0,17729,215,56,7.2,True,28.589033333333333,-381,0,-1,243,271,-28
BR1_2731169887,5,True,1,0,0,14237,153,44,6.6,False,8,False,0,0,0,16129,175,48,6.8,True,26.810933333333335,-1892,-3,1,197,223,-26
BR1_2730111363,3,False,0,0,0,13571,141,48,6.6,False,6,True,1,0,0,16533,192,56,6.6,True,27.250216666666667,-2962,-3,-1,189,248,-59
BR1_2702914495,9,True,0,0,0,16030,137,36,6.4,False,7,False,1,0,0,16217,136,56,6.6,True,29.29555,-187,2,-1,173,192,-19
BR1_2701599321,3,True,1,0,0,13631,154,34,6.8,False,6,False,0,1,0,17465,194,50,7.6,True,27.865066666666667,-3834,-3,1,188,244,-56
BR1_2731556041,3,False,1,1,0,14115,138,49,6.6,False,8,True,0,0,0,18593,193,39,7.6,True,29.646933333333333,-4478,-5,1,187,232,-45
BR1_2731537225,7,False,1,1,0,17550,193,56,7.2,True,14,True,0,0,0,19786,161,52,7.6,False,28.379366666666666,-2236,-7,1,249,213,36
BR1_2720825011,4,True,0,1,0,15919,187,51,7.0,False,4,False,1,0,0,15074,181,40,7.0,True,29.214683333333333,845,0,-1,238,221,17
BR1_2716629686,4,False,0,1,0,15392,172,64,7.0,True,2,True,0,0,0,14635,191,52,6.6,False,27.713966666666668,757,2,0,236,243,-7
BR1_2673329921,9,True,1,1,0,16217,178,52,6.8,True,4,False,0,0,0,13927,172,40,6.4,False,27.197916666666668,2290,5,1,230,212,18
BR1_2673312413,2,False,0,0,0,13387,167,32,6.6,True,7,True,1,1,0,15637,167,38,6.8,False,29.87013333333333,-2250,-5,-1,199,205,-6
BR1_2673292643,6,False,0,1,0,15407,150,44,7.0,False,8,True,0,0,0,16853,181,44,7.2,True,29.748166666666666,-1446,-2,0,194,225,-31
BR1_2673217242,7,False,0,1,0,16851,189,48,7.0,False,10,True,1,0,0,16532,160,44,7.2,True,29.558183333333332,319,-3,-1,237,204,33
BR1_2731587440,11,True,1,0,0,18556,186,60,6.8,True,5,False,0,1,0,15297,159,44,6.6,False,27.593183333333332,3259,6,1,246,203,43
BR1_2726715812,4,True,0,0,0,13688,138,32,6.2,False,7,False,0,0,0,16593,183,64,7.2,True,26.326983333333335,-2905,-3,0,170,247,-77
BR1_2729785266,9,True,1,0,0,16489,139,60,7.2,True,3,False,0,0,0,14876,196,44,7.0,False,29.98045,1613,6,1,199,240,-41
BR1_2729577474,10,True,0,0,0,17395,128,52,7.2,False,8,False,1,1,0,16744,150,60,6.6,True,28.978133333333332,651,2,-1,180,210,-30
BR1_2730217021,14,False,1,1,0,19190,128,44,6.8,False,14,True,0,0,0,20361,181,56,7.0,True,29.851616666666665,-1171,0,1,172,237,-65
BR1_2707589140,9,True,1,0,0,17191,175,52,6.8,True,2,False,0,0,0,13982,164,44,6.8,False,28.874066666666668,3209,7,1,227,208,19
BR1_2730286419,7,False,0,0,0,15158,156,40,6.6,True,8,True,0,0,0,14123,87,44,6.4,False,27.4803,1035,-1,0,196,131,65
BR1_2710784839,6,True,1,0,0,15578,161,64,7.0,True,3,False,0,0,0,14616,182,54,7.0,False,29.55165,962,3,1,225,236,-11
BR1_2710780049,4,True,0,1,0,14265,155,60,6.4,True,5,False,0,0,0,14649,153,44,6.6,False,27.401616666666666,-384,-1,0,215,197,18
BR1_2727571694,12,True,0,1,0,17958,197,52,7.0,True,3,False,0,0,0,14574,180,44,6.6,False,26.6342,3384,9,0,249,224,25
BR1_2731633344,4,False,0,0,0,14364,146,36,6.0,True,6,True,0,0,0,14817,143,32,5.8,False,26.1631,-453,-2,0,182,175,7
BR1_2731229130,3,False,0,0,0,15024,169,48,7.0,False,10,True,1,0,0,17639,173,52,7.2,True,28.611183333333333,-2615,-7,-1,217,225,-8
BR1_2729786726,9,True,1,0,0,17147,203,36,6.6,False,9,False,0,0,0,18538,206,48,7.0,True,29.640633333333334,-1391,0,1,239,254,-15
BR1_2714933616,4,False,0,1,0,15029,146,48,6.8,False,12,True,1,0,0,21073,240,71,7.4,True,29.0097,-6044,-8,-1,194,311,-117
BR1_2724669038,9,False,1,1,0,18144,168,52,7.2,False,4,True,0,0,0,15302,200,52,6.8,True,29.851683333333334,2842,5,1,220,252,-32
BR1_2731577966,7,True,1,0,0,14902,161,36,6.4,False,10,False,0,0,0,16721,183,41,7.0,True,25.272183333333334,-1819,-3,1,197,224,-27
BR1_2730735403,7,True,0,0,0,17618,207,44,7.4,True,3,False,0,1,0,14568,148,52,7.0,False,29.4526,3050,4,0,251,200,51
BR1_2730603448,10,True,1,0,0,17938,142,64,7.0,True,8,False,0,1,0,16417,168,48,6.8,False,28.09495,1521,2,1,206,216,-10
BR1_2695018571,4,False,0,0,0,15706,182,60,7.2,True,4,True,1,0,0,15786,177,52,6.8,False,28.843316666666666,-80,0,-1,242,229,13
BR1_2692096083,3,False,0,0,0,14679,183,48,6.8,True,5,True,1,0,0,14569,151,44,6.6,False,26.195233333333334,110,-2,-1,231,195,36
BR1_2731270502,5,True,0,0,0,15409,170,56,7.0,False,7,False,1,0,0,16962,184,56,7.4,True,29.31775,-1553,-2,-1,226,240,-14
BR1_2713936009,4,False,0,0,0,13846,152,52,6.8,False,5,True,0,0,0,15480,197,48,6.8,True,26.734116666666665,-1634,-1,0,204,245,-41
BR1_2730322596,3,False,0,0,0,15127,176,42,7.0,False,10,True,1,0,0,18094,189,49,7.0,True,28.63655,-2967,-7,-1,218,238,-20
BR1_2731526728,10,False,0,0,0,18055,210,47,7.0,True,2,True,0,0,0,13174,177,36,6.4,False,25.41805,4881,8,0,257,213,44
BR1_2730306518,10,False,1,0,0,18963,209,64,7.6,True,5,True,0,0,0,17249,213,43,7.2,False,28.57765,1714,5,1,273,256,17
BR1_2718441972,7,True,0,1,0,18173,210,65,7.4,False,1,False,1,0,0,14613,221,50,7.0,True,28.486916666666666,3560,6,-1,275,271,4
BR1_2731469298,3,False,0,0,0,12859,134,60,6.4,False,7,True,0,1,0,17583,199,64,7.2,True,26.48978333333333,-4724,-4,0,194,263,-69
BR1_2711885583,5,False,1,0,0,16092,215,54,7.0,False,3,True,0,1,0,15538,168,44,7.0,True,29.672283333333333,554,2,1,269,212,57
BR1_2729663930,6,False,0,0,0,17818,234,58,7.4,True,5,True,1,1,0,15716,208,60,7.2,False,28.544316666666667,2102,1,-1,292,268,24
BR1_2729616061,8,False,0,1,0,17039,165,56,7.2,True,5,True,1,0,0,15599,169,60,7.2,False,29.952866666666665,1440,3,-1,221,229,-8
BR1_2729447795,7,False,0,1,0,17503,208,48,7.4,True,8,True,1,0,0,17782,203,52,7.4,False,28.1972,-279,-1,-1,256,255,1
BR1_2708944669,4,False,0,0,1,15781,191,44,6.4,False,7,True,0,0,0,15868,146,48,6.2,True,25.385666666666665,-87,-3,0,235,194,41
BR1_2715849315,1,False,0,1,0,12931,144,64,6.2,False,6,True,1,0,0,14652,173,48,6.6,True,27.159716666666668,-1721,-5,-1,208,221,-13
BR1_2729475439,7,True,0,0,0,18453,205,64,7.4,False,4,False,1,0,0,14991,175,40,7.0,True,28.56298333333333,3462,3,-1,269,215,54
BR1_2722997358,5,False,0,0,0,15460,199,36,6.4,True,2,True,0,0,0,13754,166,55,6.4,False,27.399566666666665,1706,3,0,235,221,14
BR1_2701074814,5,False,0,0,0,13657,163,28,6.6,False,7,True,0,1,0,15861,151,40,6.6,True,27.13585,-2204,-2,0,191,191,0
BR1_2731558360,12,True,1,0,0,20483,186,52,7.2,True,9,False,0,1,0,16979,178,40,6.8,False,28.974116666666667,3504,3,1,238,218,20
BR1_2667684852,5,True,1,0,0,16677,215,56,7.4,True,3,False,0,1,0,15617,188,36,7.2,False,29.54158333333333,1060,2,1,271,224,47
BR1_2731446319,9,True,0,0,0,16333,133,44,6.6,True,4,False,0,0,0,13188,131,47,6.6,False,27.299883333333334,3145,5,0,177,178,-1
BR1_2730791473,3,True,0,0,0,15805,231,48,7.4,False,6,False,1,1,0,16693,178,67,7.2,True,28.3252,-888,-3,-1,279,245,34
BR1_2729868668,7,True,1,0,0,16558,214,56,7.0,True,8,False,0,0,0,15310,163,32,6.6,False,26.292016666666665,1248,-1,1,270,195,75
BR1_2729840098,5,True,0,0,0,14501,186,40,6.6,True,3,False,1,0,0,14248,198,44,6.4,False,25.018116666666668,253,2,-1,226,242,-16
BR1_2730441699,7,True,1,1,1,18021,199,60,7.2,True,5,False,0,0,0,15909,194,56,7.0,False,29.491666666666667,2112,2,1,259,250,9
BR1_2711720207,9,False,1,0,0,16692,164,58,6.6,False,12,True,0,0,0,18663,169,45,7.0,True,27.77638333333333,-1971,-3,1,222,214,8
BR1_2711689464,8,False,1,0,0,17304,199,47,6.6,True,7,True,0,1,0,17076,133,52,6.8,False,29.701266666666665,228,1,1,246,185,61
BR1_2677743504,8,True,1,0,0,17211,184,52,7.2,True,5,False,0,0,0,15873,174,43,7.2,False,28.038516666666666,1338,3,1,236,217,19
BR1_2730668703,4,False,0,0,0,13883,145,44,6.2,False,5,True,1,0,0,15766,211,56,6.6,True,25.78545,-1883,-1,-1,189,267,-78
BR1_2730118887,5,False,0,0,0,15395,171,48,7.2,False,6,True,1,0,0,16529,194,60,7.2,True,27.990516666666668,-1134,-1,-1,219,254,-35
BR1_2726344715,8,True,1,1,0,16984,185,48,7.0,True,4,False,0,0,0,14719,147,52,6.6,False,28.01045,2265,4,1,233,199,34
BR1_2731210082,3,False,0,0,0,13915,139,43,6.2,False,9,True,1,0,0,15773,193,40,6.6,True,27.1333,-1858,-6,-1,182,233,-51
BR1_2730989885,2,True,0,0,0,11818,113,44,6.2,False,8,False,1,0,0,15660,172,48,7.0,True,26.159233333333333,-3842,-6,-1,157,220,-63
BR1_2705456908,5,True,0,0,0,14075,146,42,6.4,False,3,False,1,1,0,13972,157,52,6.4,True,25.996216666666665,103,2,-1,188,209,-21
BR1_2731030663,3,False,0,0,0,13334,132,38,6.4,False,9,True,1,0,0,16202,162,38,6.2,True,25.66905,-2868,-6,-1,170,200,-30
BR1_2725903718,2,False,0,0,0,13184,153,36,6.6,True,6,True,0,0,0,14241,149,36,6.8,False,26.26365,-1057,-4,0,189,185,4
BR1_2725275709,6,False,1,1,0,16378,183,64,7.0,True,5,True,0,0,0,14389,169,40,6.6,False,25.913283333333332,1989,1,1,247,209,38
BR1_2731333431,5,False,0,1,0,17107,184,50,7.2,False,4,True,1,0,0,15046,193,52,7.0,True,28.82415,2061,1,-1,234,245,-11
BR1_2731279101,16,True,1,1,0,20921,225,42,7.4,True,5,False,0,0,0,16175,186,57,6.8,False,29.44795,4746,11,1,267,243,24
BR1_2728535690,6,True,1,0,0,15635,173,56,7.0,True,2,False,0,0,0,12897,134,64,6.4,False,26.898583333333335,2738,4,1,229,198,31
BR1_2728511510,9,False,0,1,0,17067,161,55,6.8,True,11,True,0,0,0,17806,171,48,6.8,False,29.1492,-739,-2,0,216,219,-3
BR1_2731454031,8,False,0,0,0,16392,182,52,6.6,False,8,True,1,0,0,16070,132,59,6.6,True,26.585733333333334,322,0,-1,234,191,43
BR1_2729039916,5,False,0,0,0,14143,140,44,6.4,False,6,True,1,0,0,16017,196,52,6.6,True,26.93545,-1874,-1,-1,184,248,-64
BR1_2715425081,12,True,0,1,0,18881,197,56,7.6,True,5,False,1,0,0,15818,200,44,7.2,False,28.35695,3063,7,-1,253,244,9
BR1_2715692151,8,True,0,0,0,15741,162,44,6.8,False,6,False,0,0,0,14623,185,36,6.6,True,25.615066666666667,1118,2,0,206,221,-15
BR1_2729866772,3,False,0,0,0,14934,188,52,6.8,False,6,True,1,0,0,14764,156,40,6.6,True,26.540733333333332,170,-3,-1,240,196,44
BR1_2729272119,7,False,1,0,0,15473,177,36,6.4,True,3,True,0,0,0,13630,140,36,6.2,False,27.3228,1843,4,1,213,176,37
BR1_2731306388,7,False,1,0,0,15722,137,48,6.6,False,8,True,0,1,0,17670,193,48,7.0,True,28.733266666666665,-1948,-1,1,185,241,-56
BR1_2726533919,4,False,1,1,0,14435,157,48,6.6,True,5,True,0,0,0,14436,153,51,6.6,False,25.259566666666668,-1,-1,1,205,204,1
BR1_2727950319,1,False,0,0,0,14091,187,52,6.8,False,5,True,1,1,0,17899,247,68,7.6,True,29.96976666666667,-3808,-4,-1,239,315,-76
BR1_2727502910,9,True,0,0,0,18516,190,60,7.0,False,10,False,0,0,0,19928,220,55,7.2,True,28.751966666666668,-1412,-1,0,250,275,-25
BR1_2730664931,6,False,1,0,0,15268,187,28,6.8,False,12,True,0,1,0,19587,182,50,7.4,True,27.958583333333333,-4319,-6,1,215,232,-17
BR1_2727913709,7,True,0,0,0,16570,177,52,6.6,False,9,False,1,1,0,18435,163,72,7.4,True,29.551516666666668,-1865,-2,-1,229,235,-6
BR1_2722939725,8,True,0,0,0,17017,167,55,7.0,False,4,False,1,0,0,15380,173,56,6.8,True,28.525033333333333,1637,4,-1,222,229,-7
BR1_2731028689,5,False,0,0,0,14352,165,48,6.8,False,7,True,1,0,0,16248,172,56,7.0,True,27.092983333333333,-1896,-2,-1,213,228,-15
BR1_2731013762,7,False,0,0,0,16387,192,44,6.6,True,8,True,0,1,0,18353,222,60,7.2,False,29.750633333333333,-1966,-1,0,236,282,-46
BR1_2722859818,11,True,1,0,0,18062,189,68,7.8,True,3,False,0,0,0,14175,177,48,7.2,False,28.127683333333334,3887,8,1,257,225,32
BR1_2724925900,8,False,0,1,0,15826,151,51,6.6,False,8,True,1,0,0,15952,142,48,6.2,True,25.791016666666668,-126,0,-1,202,190,12
BR1_2721768571,5,True,1,0,0,15832,185,48,7.2,False,7,False,0,1,0,17138,190,64,7.6,True,27.684516666666667,-1306,-2,1,233,254,-21
BR1_2718681106,11,True,0,0,0,16880,144,51,7.0,True,5,False,1,0,0,14573,182,44,6.4,False,27.08655,2307,6,-1,195,226,-31
BR1_2731629346,2,False,0,0,0,14578,170,40,6.8,True,10,True,1,0,0,17665,183,44,6.8,False,28.42755,-3087,-8,-1,210,227,-17
BR1_2695608467,7,True,0,0,0,17634,192,48,7.0,True,5,False,1,0,0,15263,168,56,6.6,False,29.772183333333334,2371,2,-1,240,224,16
BR1_2728442576,4,True,0,0,0,12975,106,44,5.8,False,6,False,0,0,0,15376,165,40,6.6,True,26.4137,-2401,-2,0,150,205,-55
BR1_2717891822,9,False,0,0,0,17657,197,48,6.8,True,11,True,0,1,0,18735,197,56,7.0,False,28.19705,-1078,-2,0,245,253,-8
BR1_2728874878,6,False,0,0,0,15286,132,46,6.6,False,7,True,1,1,0,17324,188,56,6.8,True,27.809266666666666,-2038,-1,-1,178,244,-66
BR1_2729565022,9,True,0,1,0,17811,148,52,7.0,True,5,False,1,0,0,15205,184,40,6.8,False,27.5032,2606,4,-1,200,224,-24
BR1_2727809566,7,True,0,1,1,17719,171,56,7.0,True,8,False,1,0,0,16152,136,56,6.6,False,26.539916666666667,1567,-1,-1,227,192,35
BR1_2721511611,6,False,1,0,0,15306,146,40,6.8,False,10,True,0,1,0,18134,190,52,7.2,True,27.6808,-2828,-4,1,186,242,-56
BR1_2711161902,11,True,1,0,0,19244,184,60,7.4,True,6,False,0,1,0,17455,190,64,7.2,False,27.650316666666665,1789,5,1,244,254,-10
BR1_2711121328,8,True,0,0,0,16851,186,68,7.2,True,3,False,0,0,0,14052,182,44,6.6,False,27.34595,2799,5,0,254,226,28
BR1_2731263050,7,False,1,1,0,15290,167,43,6.8,True,2,True,0,0,0,13049,180,24,6.0,False,27.068566666666666,2241,5,1,210,204,6
BR1_2697441925,8,True,0,0,0,15868,169,48,6.2,False,12,False,1,0,0,16711,118,40,6.2,True,25.729066666666668,-843,-4,-1,217,158,59
BR1_2727340722,11,True,1,1,0,19980,180,64,7.8,True,6,False,0,0,0,17068,222,56,7.0,False,28.703916666666668,2912,5,1,244,278,-34
BR1_2722264854,7,True,0,0,0,17645,193,49,7.4,True,5,False,1,0,0,15498,141,58,7.0,False,28.177016666666667,2147,2,-1,242,199,43
BR1_2707520564,9,True,0,0,0,15487,122,51,6.2,True,8,False,1,0,0,16062,166,48,6.6,False,27.311316666666666,-575,1,-1,173,214,-41
BR1_2686773949,16,True,1,0,0,17672,132,43,6.6,True,6,False,0,0,0,15619,174,48,6.0,False,27.359683333333333,2053,10,1,175,222,-47
BR1_2729572665,7,False,0,0,0,15500,136,48,6.4,False,6,True,1,1,0,16236,164,44,6.4,True,26.41115,-736,1,-1,184,208,-24
BR1_2729550471,5,True,0,1,0,16261,157,64,7.2,False,3,False,0,0,0,14994,170,48,7.2,True,29.26195,1267,2,0,221,218,3
BR1_2731379224,7,True,0,1,1,18127,172,48,7.2,False,1,False,1,0,0,14043,191,47,7.2,True,29.143466666666665,4084,6,-1,220,238,-18
BR1_2731369779,8,True,1,1,0,17460,162,68,7.4,True,5,False,0,0,0,15762,207,64,7.2,False,29.040466666666667,1698,3,1,230,271,-41
BR1_2729285543,5,True,0,0,0,14481,180,31,6.4,False,5,False,1,1,0,15551,173,63,7.0,True,26.714033333333333,-1070,0,-1,211,236,-25
BR1_2729025363,3,True,1,0,0,13956,199,41,7.0,True,1,False,0,0,0,12434,150,38,6.4,False,26.7334,1522,2,1,240,188,52
BR1_2728977388,7,False,0,0,0,15764,168,36,6.8,True,7,True,1,1,0,15613,154,60,6.6,False,26.186133333333334,151,0,-1,204,214,-10
BR1_2697920354,5,False,1,0,0,16012,219,60,7.4,False,6,True,0,0,0,16594,217,60,7.6,True,29.337366666666668,-582,-1,1,279,277,2
BR1_2697563035,11,True,0,1,0,20027,183,56,7.4,True,7,False,1,0,0,15902,150,44,6.8,False,29.110683333333334,4125,4,-1,239,194,45
BR1_2731614425,7,True,0,1,0,15758,173,44,6.6,False,7,False,1,0,0,15628,160,48,6.4,True,25.3319,130,0,-1,217,208,9
BR1_2731623065,11,True,0,0,0,15761,136,44,6.4,False,7,False,0,0,0,16130,144,48,6.4,True,26.144683333333333,-369,4,0,180,192,-12
BR1_2688180418,4,True,0,0,0,14553,196,46,6.8,False,8,False,1,0,0,16379,225,54,7.4,True,25.105633333333333,-1826,-4,-1,242,279,-37
BR1_2680532067,2,False,1,0,0,14811,181,48,6.6,False,9,True,0,0,0,17106,167,52,7.2,True,28.473716666666668,-2295,-7,1,229,219,10
BR1_2716108639,9,True,0,1,1,19857,223,76,7.8,False,11,False,0,0,0,18640,201,52,7.2,True,29.984116666666665,1217,-2,0,299,253,46
BR1_2701085802,2,False,0,0,0,12814,160,44,6.4,False,4,True,1,1,1,16669,186,60,6.8,True,26.817683333333335,-3855,-2,-1,204,246,-42
BR1_2727567628,8,True,1,0,0,17630,180,58,7.0,True,2,False,0,0,0,13835,166,36,6.6,False,29.52705,3795,6,1,238,202,36
BR1_2724507210,4,False,0,1,0,14743,184,40,6.6,True,7,True,1,0,0,14715,150,52,6.6,False,26.76268333333333,28,-3,-1,224,202,22
BR1_2692844567,11,False,0,1,0,18814,215,48,7.0,True,6,True,1,0,0,16545,171,60,6.6,False,27.821433333333335,2269,5,-1,263,231,32
BR1_2674601467,11,True,1,0,0,19578,212,52,7.6,True,3,False,0,0,0,15181,171,60,7.2,False,27.68935,4397,8,1,264,231,33
BR1_2731508121,9,False,1,1,0,18922,168,72,7.2,True,7,True,0,0,0,16682,194,40,7.2,False,29.798483333333333,2240,2,1,240,234,6
BR1_2707056359,9,False,1,0,0,16041,176,43,6.8,False,7,True,0,1,0,15776,158,56,6.6,True,26.244033333333334,265,2,1,219,214,5
BR1_2714480356,4,True,0,1,0,15152,190,44,6.6,True,6,False,1,0,0,15921,182,47,7.0,False,28.008016666666666,-769,-2,-1,234,229,5
BR1_2713411844,6,False,1,0,0,15012,148,56,6.6,False,9,True,0,0,0,16438,211,40,6.6,True,27.056283333333333,-1426,-3,1,204,251,-47
BR1_2708342059,5,True,0,0,0,16872,205,54,7.0,False,7,False,1,1,0,15762,157,40,7.0,True,29.151433333333333,1110,-2,-1,259,197,62
BR1_2715244932,8,True,1,0,0,16411,168,42,6.4,True,8,False,0,0,0,15344,124,40,6.4,False,27.307416666666665,1067,0,1,210,164,46
BR1_2731532747,9,False,0,1,0,17689,182,56,7.0,False,10,True,0,0,0,18366,209,60,7.2,True,28.446116666666665,-677,-1,0,238,269,-31
BR1_2731305565,6,True,0,0,0,15949,167,56,6.8,False,8,False,1,1,1,18822,180,60,7.2,True,27.60705,-2873,-2,-1,223,240,-17
BR1_2730818049,8,False,0,1,0,16864,158,46,6.6,True,8,True,1,0,0,17294,160,52,7.0,False,28.613133333333334,-430,0,-1,204,212,-8
BR1_2731174355,6,True,1,1,0,17843,248,64,7.8,True,1,False,0,0,0,14224,209,40,7.2,False,28.106083333333334,3619,5,1,312,249,63
BR1_2730811738,6,False,0,0,0,14869,142,48,6.2,False,9,True,1,1,0,16655,158,52,6.4,True,27.48281666666667,-1786,-3,-1,190,210,-20
BR1_2731464062,7,False,0,0,0,15718,154,52,7.0,False,12,True,1,0,0,18731,162,52,7.6,True,29.784966666666666,-3013,-5,-1,206,214,-8
BR1_2731452369,5,False,0,0,0,15661,176,52,6.6,False,7,True,1,0,0,16452,190,52,7.0,True,27.829616666666666,-791,-2,-1,228,242,-14
BR1_2731627062,6,False,0,0,0,15682,161,48,6.6,False,9,True,0,0,0,15761,165,52,7.0,True,26.789816666666667,-79,-3,0,209,217,-8
BR1_2726541459,1,True,0,0,0,12556,129,55,6.4,True,3,False,1,0,0,14116,154,64,6.8,False,26.878166666666665,-1560,-2,-1,184,218,-34
BR1_2731359434,11,True,0,0,0,18785,142,51,6.6,False,12,False,1,0,0,18185,165,52,6.8,True,28.7733,600,-1,-1,193,217,-24
BR1_2731434360,6,True,0,1,0,15362,154,52,7.0,False,3,False,0,0,0,15998,199,71,7.4,True,27.88065,-636,3,0,206,270,-64
BR1_2731296856,10,False,1,0,0,18396,181,56,7.4,True,8,True,0,1,0,16298,161,52,6.6,False,27.713783333333332,2098,2,1,237,213,24
BR1_2718085814,4,True,0,0,0,14015,131,44,6.2,False,6,False,1,0,0,15364,157,40,6.8,True,27.263483333333333,-1349,-2,-1,175,197,-22
BR1_2687552593,9,True,1,0,0,17254,204,56,7.4,True,3,False,0,0,0,14442,182,44,7.2,False,29.652583333333332,2812,6,1,260,226,34
BR1_2686374896,11,False,1,0,0,17174,161,44,6.6,True,2,True,0,0,0,13497,149,42,6.0,False,27.46105,3677,9,1,205,191,14
BR1_2685903323,12,True,1,0,0,17810,182,44,6.6,True,11,False,0,0,0,16799,93,48,6.8,False,27.424533333333333,1011,1,1,226,141,85
BR1_2685842530,6,True,1,0,0,16442,195,56,7.0,False,7,False,0,0,0,15438,172,36,6.6,True,26.698983333333334,1004,-1,1,251,208,43
BR1_2731197724,3,False,1,0,0,14490,161,40,6.8,False,7,True,0,0,0,17109,187,68,7.0,True,29.002266666666667,-2619,-4,1,201,255,-54
BR1_2731150978,12,False,1,0,0,18943,180,40,6.8,True,7,True,0,1,0,16365,145,48,6.4,False,29.582666666666668,2578,5,1,220,193,27
BR1_2730751730,7,False,0,1,0,17475,181,64,7.2,True,3,True,1,0,0,14546,159,52,7.0,False,28.6862,2929,4,-1,245,211,34
BR1_2731370236,4,False,1,0,0,16155,220,60,7.0,True,2,True,0,1,0,14564,156,44,7.0,False,29.581516666666666,1591,2,1,280,200,80
BR1_2730533811,11,True,0,1,1,19016,169,48,7.4,True,4,False,1,0,0,15628,181,56,7.0,False,29.421316666666666,3388,7,-1,217,237,-20
BR1_2729046560,9,False,0,0,0,17740,200,36,6.6,True,10,True,1,0,0,18340,160,44,6.8,False,28.105733333333333,-600,-1,-1,236,204,32
BR1_2712740709,14,False,0,1,0,20050,159,48,7.0,False,15,True,1,0,0,22486,192,56,7.2,True,29.129766666666665,-2436,-1,-1,207,248,-41
BR1_2690917337,5,False,0,1,0,15747,153,48,7.0,True,4,True,1,0,0,13930,130,48,6.6,False,28.57845,1817,1,-1,201,178,23
BR1_2731300481,5,True,0,0,0,13813,136,44,6.2,False,7,False,0,0,0,15820,170,44,6.6,True,25.59315,-2007,-2,0,180,214,-34
BR1_2730204997,3,False,0,1,0,14869,157,52,6.8,False,8,True,1,0,0,16227,173,48,7.0,True,25.944816666666668,-1358,-5,-1,209,221,-12
BR1_2730438419,8,False,1,0,0,16427,173,60,6.8,True,7,True,0,0,0,15605,155,48,6.6,False,27.38345,822,1,1,233,203,30
BR1_2730322720,12,True,1,1,0,18457,151,72,7.2,True,4,False,0,0,0,14961,147,56,7.0,False,29.6397,3496,8,1,223,203,20
BR1_2718770786,9,False,0,1,0,17812,184,58,7.4,False,5,True,0,0,0,16412,178,48,6.8,True,28.496766666666666,1400,4,0,242,226,16
BR1_2731351324,9,False,1,0,0,18071,187,52,7.4,True,4,True,0,1,0,15516,161,48,6.8,False,29.41818333333333,2555,5,1,239,209,30
BR1_2731518998,11,True,1,0,0,17486,165,52,7.4,True,4,False,0,0,0,13492,159,20,6.4,False,25.186833333333333,3994,7,1,217,179,38
BR1_2731077117,13,True,1,1,0,18464,144,52,6.4,True,5,False,0,0,0,13752,108,44,5.8,False,27.133183333333335,4712,8,1,196,152,44
BR1_2689290593,11,False,0,0,0,18436,173,13,6.6,False,13,True,1,0,0,20996,195,58,7.2,True,29.15515,-2560,-2,-1,186,253,-67
BR1_2689281454,4,False,1,0,0,14078,154,36,6.8,False,8,True,0,1,0,17947,159,68,7.0,True,28.7504,-3869,-4,1,190,227,-37
BR1_2731323971,2,False,0,0,0,14393,201,52,7.2,False,7,True,0,1,0,18705,204,56,7.4,True,29.470466666666667,-4312,-5,0,253,260,-7
BR1_2731308793,5,False,0,1,0,15109,176,56,7.0,True,10,True,1,0,0,15460,166,36,6.6,False,25.1997,-351,-5,-1,232,202,30
BR1_2700115309,4,True,0,0,0,15637,167,44,7.0,False,9,False,1,0,0,17375,210,52,7.4,True,29.0811,-1738,-5,-1,211,262,-51
BR1_2700080804,6,False,1,0,0,15197,152,56,6.8,False,5,True,0,1,0,16455,162,59,6.8,True,28.609783333333333,-1258,1,1,208,221,-13
BR1_2699317231,5,False,0,1,0,16761,199,56,7.2,False,11,True,1,0,0,19213,232,56,7.2,True,28.1025,-2452,-6,-1,255,288,-33
BR1_2714658667,6,False,1,0,0,15693,182,44,6.8,True,1,True,0,0,0,12522,151,56,6.6,False,25.779566666666668,3171,5,1,226,207,19
BR1_2713675554,8,True,0,0,0,16346,158,36,6.8,False,11,False,1,0,0,18813,191,48,6.8,True,28.479433333333333,-2467,-3,-1,194,239,-45
BR1_2727578589,4,False,0,1,0,16106,225,52,7.2,True,6,True,1,0,0,16031,200,60,7.0,False,27.830683333333333,75,-2,-1,277,260,17
BR1_2723120950,5,True,0,1,0,15008,183,48,6.6,False,7,False,1,0,0,14336,131,44,6.6,True,27.1787,672,-2,-1,231,175,56
BR1_2722913956,5,True,0,1,0,16300,203,60,7.2,True,2,False,0,0,0,13799,149,56,6.4,False,29.398333333333333,2501,3,0,263,205,58
BR1_2693254412,13,False,0,0,0,18110,174,52,7.0,True,9,True,1,1,0,17275,142,59,7.0,False,27.18685,835,4,-1,226,201,25
BR1_2693218267,4,True,0,0,1,16192,182,40,7.2,True,2,False,1,0,0,14313,152,56,6.8,False,27.559583333333332,1879,2,-1,222,208,14
BR1_2722797094,5,True,1,0,0,14000,152,40,6.6,True,2,False,0,1,0,13227,171,36,6.8,False,25.59725,773,3,1,192,207,-15
BR1_2709439408,11,True,1,0,0,17346,138,33,6.6,True,9,False,0,0,0,16327,174,35,6.2,False,27.077266666666667,1019,2,1,171,209,-38
BR1_2703794452,6,True,0,0,0,16579,200,56,7.2,True,1,False,0,0,0,14194,199,44,7.2,False,29.164416666666668,2385,5,0,256,243,13
BR1_2698535709,4,False,0,1,0,13844,146,56,6.8,True,4,True,0,0,0,14593,174,40,7.0,False,27.354933333333335,-749,0,0,202,214,-12
BR1_2730798181,6,False,1,1,0,17235,215,55,7.0,False,7,True,0,0,0,17109,210,59,7.0,True,28.633233333333333,126,-1,1,270,269,1
BR1_2727422156,2,False,0,0,0,14073,185,36,6.4,False,9,True,1,1,0,17005,190,59,7.0,True,26.8834,-2932,-7,-1,221,249,-28
BR1_2727276738,10,False,0,0,0,18077,152,32,7.0,False,11,True,1,1,0,18856,179,68,7.2,True,28.374166666666667,-779,-1,-1,184,247,-63
BR1_2729911588,10,True,1,0,0,16265,149,42,6.6,True,6,False,0,0,0,14375,167,40,6.6,False,25.4578,1890,4,1,191,207,-16
BR1_2723903614,7,True,0,0,0,16218,187,64,7.0,False,10,False,1,0,0,18351,185,52,7.4,True,28.79775,-2133,-3,-1,251,237,14
BR1_2729795677,1,False,0,0,0,12194,153,37,6.2,False,14,True,1,1,0,18445,149,54,6.8,True,26.187033333333332,-6251,-13,-1,190,203,-13
BR1_2727440060,8,False,0,1,0,17542,173,52,6.8,True,3,True,1,0,1,15903,145,52,6.8,False,29.42315,1639,5,-1,225,197,28
BR1_2727000469,3,False,0,1,0,14730,177,44,6.8,False,5,True,1,0,0,17434,187,64,7.6,True,28.551133333333333,-2704,-2,-1,221,251,-30
BR1_2723213444,8,False,1,0,0,15556,134,40,6.8,False,10,True,0,0,0,17340,149,56,7.0,True,25.480216666666667,-1784,-2,1,174,205,-31
BR1_2712514574,5,False,0,0,0,13555,119,40,6.4,False,5,True,1,0,0,15288,166,52,6.8,True,26.69905,-1733,0,-1,159,218,-59
BR1_2721913368,6,False,0,0,0,14397,146,44,6.8,False,11,True,0,0,0,17662,183,48,6.8,True,27.323366666666665,-3265,-5,0,190,231,-41
BR1_2729107336,7,True,0,0,0,14730,91,41,6.2,False,12,False,1,0,0,18154,185,48,6.8,True,26.485833333333332,-3424,-5,-1,132,233,-101
BR1_2716963223,8,True,1,0,0,15315,191,52,6.8,True,5,False,0,0,0,15197,167,56,6.8,False,25.9824,118,3,1,243,223,20
BR1_2713997070,6,False,0,0,0,16323,174,32,6.8,False,11,True,1,0,0,18983,216,72,7.4,True,27.65465,-2660,-5,-1,206,288,-82
BR1_2713879977,7,False,0,1,0,17628,206,63,7.4,True,6,True,1,0,0,15669,139,48,6.4,False,28.998033333333332,1959,1,-1,269,187,82
BR1_2731164571,5,False,0,1,0,16355,215,47,7.2,True,8,True,1,0,0,18185,195,68,7.0,False,28.687033333333332,-1830,-3,-1,262,263,-1
BR1_2718803737,9,True,1,0,0,15970,157,40,6.8,True,3,False,0,0,0,13592,157,52,6.4,False,26.99,2378,6,1,197,209,-12
BR1_2730757543,15,True,1,0,0,19786,160,64,6.8,True,7,False,0,0,0,16390,168,48,6.4,False,28.590233333333334,3396,8,1,224,216,8
BR1_2692508147,7,True,0,0,0,15051,164,31,6.6,True,2,False,1,0,0,12319,139,52,6.4,False,27.296916666666668,2732,5,-1,195,191,4
BR1_2692477063,7,True,0,0,0,17278,207,54,7.2,True,5,False,0,0,0,15181,169,48,7.2,False,29.504766666666665,2097,2,0,261,217,44
BR1_2692445763,3,False,1,0,0,13901,168,60,6.6,True,3,True,0,1,0,13443,178,36,6.8,False,27.494216666666667,458,0,1,228,214,14
BR1_2692431369,7,True,0,1,0,16250,133,56,6.6,False,12,False,1,0,0,18557,205,48,6.8,True,28.630816666666668,-2307,-5,-1,189,253,-64
BR1_2671420681,2,True,1,0,0,12481,139,56,6.4,False,2,False,0,0,0,14085,188,40,6.6,True,25.171833333333332,-1604,0,1,195,228,-33
BR1_2671409255,6,True,0,1,0,16467,167,52,7.6,True,0,False,1,0,0,13059,144,58,6.8,False,29.9761,3408,6,-1,219,202,17
BR1_2719084203,7,False,0,0,0,15037,153,36,6.4,False,6,True,0,0,0,13801,133,36,6.4,True,27.1394,1236,1,0,189,169,20
BR1_2715266897,8,False,0,0,0,16259,171,36,7.2,False,5,True,1,1,0,17214,203,43,6.6,True,28.744683333333334,-955,3,-1,207,246,-39
BR1_2704361417,4,False,0,0,0,13402,149,48,6.0,False,7,True,1,0,0,14158,107,51,6.4,True,25.680133333333334,-756,-3,-1,197,158,39
BR1_2731657931,5,False,0,1,0,15796,160,50,7.4,False,2,True,0,0,0,14242,199,52,7.0,True,28.682666666666666,1554,3,0,210,251,-41
BR1_2731594371,6,False,1,0,0,16713,177,64,7.4,False,8,True,0,0,0,17958,220,64,7.4,True,29.06736666666667,-1245,-2,1,241,284,-43
BR1_2731257363,5,True,1,0,0,15411,165,56,6.8,True,1,False,0,0,0,12118,144,52,6.6,False,26.84125,3293,4,1,221,196,25
BR1_2731196637,3,False,0,0,0,14726,137,44,6.4,False,11,True,0,1,1,20289,208,44,7.4,True,29.803516666666667,-5563,-8,0,181,252,-71
BR1_2722223012,6,True,0,1,0,15458,200,48,6.6,False,7,False,0,0,0,15536,165,40,6.4,True,25.237016666666666,-78,-1,0,248,205,43
BR1_2721714887,10,True,0,0,0,19311,195,60,7.4,True,11,False,0,0,0,16911,144,16,6.4,False,28.000133333333334,2400,-1,0,255,160,95
BR1_2719740782,4,False,0,0,0,16231,189,44,6.8,False,15,True,1,1,0,21322,208,72,7.6,True,27.803566666666665,-5091,-11,-1,233,280,-47
BR1_2723359967,5,True,0,0,0,14455,165,35,6.4,True,6,False,1,0,0,15100,172,50,6.6,False,25.005883333333333,-645,-1,-1,200,222,-22
BR1_2673069968,7,True,1,1,0,17574,184,60,7.6,True,3,False,0,0,0,16009,218,56,7.2,False,28.292483333333333,1565,4,1,244,274,-30
BR1_2710232843,7,True,1,0,0,14857,160,44,6.4,False,8,False,0,0,0,16051,180,32,6.6,True,27.20305,-1194,-1,1,204,212,-8
BR1_2730107502,7,False,1,0,0,16297,146,48,6.8,True,6,True,0,0,0,15670,151,48,6.8,False,28.924633333333333,627,1,1,194,199,-5
BR1_2728946475,1,False,0,0,0,13556,167,48,7.2,False,7,True,1,1,0,17988,168,64,7.4,True,27.677783333333334,-4432,-6,-1,215,232,-17
BR1_2722954198,7,True,1,0,0,16878,180,54,7.0,True,2,False,0,0,0,13368,167,46,6.6,False,29.974516666666666,3510,5,1,234,213,21
BR1_2731611866,5,True,1,0,0,15384,190,52,7.0,True,1,False,0,0,0,12391,140,48,6.4,False,26.253633333333333,2993,4,1,242,188,54
BR1_2731314510,5,True,1,0,0,15914,203,60,7.4,True,3,False,0,0,0,14694,182,56,7.2,False,28.6712,1220,2,1,263,238,25
BR1_2731296076,8,True,0,0,0,17104,166,48,6.6,False,8,False,1,0,0,17377,164,52,6.6,True,29.985116666666666,-273,0,-1,214,216,-2
BR1_2711678315,2,False,0,0,0,12789,124,35,6.2,False,14,True,1,1,0,18827,176,46,7.2,True,27.65065,-6038,-12,-1,159,222,-63
BR1_2710071871,5,False,0,0,0,16219,177,64,7.0,False,10,True,0,0,0,18661,173,52,7.2,True,28.360283333333335,-2442,-5,0,241,225,16
BR1_2705534529,4,False,0,1,0,13877,160,40,6.2,False,6,True,0,0,0,15957,177,46,6.6,True,27.062816666666667,-2080,-2,0,200,223,-23
BR1_2693145255,6,False,0,0,0,17458,230,36,7.0,True,4,True,0,1,0,16270,182,56,7.0,False,28.118216666666665,1188,2,0,266,238,28
BR1_2693137184,4,True,1,0,0,16088,180,48,7.0,False,7,False,0,1,0,16856,184,63,7.2,True,29.4025,-768,-3,1,228,247,-19
BR1_2730246327,8,False,1,0,0,18079,176,52,7.2,True,13,True,0,0,0,19819,216,56,7.4,False,29.660716666666666,-1740,-5,1,228,272,-44
BR1_2702404298,5,True,1,0,0,16737,202,48,7.2,True,2,False,0,0,0,14029,130,52,6.8,False,29.5882,2708,3,1,250,182,68
BR1_2731463673,15,False,0,0,0,19983,174,44,7.0,True,12,True,1,0,0,17957,147,59,6.8,False,28.049133333333334,2026,3,-1,218,206,12
BR1_2731581718,3,True,1,0,0,13445,156,60,6.4,False,5,False,0,1,0,16060,199,56,7.0,True,25.439266666666665,-2615,-2,1,216,255,-39
BR1_2730347435,4,True,0,0,0,13995,147,39,6.2,False,15,False,1,0,0,18929,211,56,7.2,True,25.081516666666666,-4934,-11,-1,186,267,-81
BR1_2730300037,9,True,1,1,0,19248,204,52,7.8,True,5,False,0,0,0,15509,187,52,7.4,False,28.277216666666668,3739,4,1,256,239,17
BR1_2731438847,7,False,0,1,0,17106,189,37,7.0,True,4,True,1,0,0,14411,140,46,6.4,False,29.208066666666667,2695,3,-1,226,186,40
BR1_2730522550,7,True,0,0,0,14613,154,36,6.2,True,5,False,0,0,0,14991,192,44,6.8,False,25.809266666666666,-378,2,0,190,236,-46
BR1_2693189522,3,False,1,0,0,14600,198,50,7.0,False,4,True,0,0,0,15387,207,55,7.6,True,29.604533333333332,-787,-1,1,248,262,-14
BR1_2692276691,6,True,0,1,0,16226,177,57,7.2,True,5,False,1,0,0,15476,179,56,7.4,False,28.33585,750,1,-1,234,235,-1
BR1_2722913253,5,True,1,0,0,15112,151,40,6.8,False,10,False,0,0,0,18237,171,48,6.8,True,27.782983333333334,-3125,-5,1,191,219,-28
BR1_2722256941,3,True,0,0,0,14508,195,36,6.8,False,6,False,1,1,0,17851,210,44,7.2,True,27.502383333333334,-3343,-3,-1,231,254,-23
BR1_2726131964,10,True,0,0,0,16917,168,36,7.2,True,4,False,0,0,0,13435,139,40,6.4,False,27.13025,3482,6,0,204,179,25
BR1_2684515604,4,False,1,0,0,15778,198,60,7.2,True,3,True,0,0,0,15325,203,48,7.0,False,28.713983333333335,453,1,1,258,251,7
BR1_2684497088,3,False,0,0,0,13975,176,52,6.6,False,7,True,0,1,0,15667,174,59,7.2,True,26.659883333333333,-1692,-4,0,228,233,-5
BR1_2709189105,5,False,1,0,0,13918,112,60,6.2,False,9,True,0,0,0,17034,192,32,7.0,True,26.605483333333332,-3116,-4,1,172,224,-52
BR1_2725856975,6,False,0,0,0,14231,162,32,6.6,False,7,True,0,1,0,15630,165,52,6.6,True,25.448083333333333,-1399,-1,0,194,217,-23
BR1_2730372847,7,False,0,1,0,16919,145,28,7.2,False,7,True,1,0,0,16277,156,72,7.2,True,29.432133333333333,642,0,-1,173,228,-55
BR1_2730364286,4,False,0,0,0,14122,169,25,6.6,False,6,True,1,0,0,15644,173,64,6.6,True,27.441266666666667,-1522,-2,-1,194,237,-43
BR1_2689478195,7,True,0,0,0,15804,148,52,6.4,True,5,False,0,0,0,14687,127,44,6.6,False,28.816816666666668,1117,2,0,200,171,29
BR1_2729516158,9,True,1,1,1,18785,190,40,7.2,True,6,False,0,0,0,14740,127,58,6.4,False,28.648116666666667,4045,3,1,230,185,45
BR1_2728759055,10,True,1,0,0,17835,220,52,7.4,True,3,False,0,0,0,12629,129,44,6.2,False,26.69145,5206,7,1,272,173,99
BR1_2731630987,3,False,0,0,0,13877,166,44,6.4,True,6,True,1,0,0,15822,177,52,6.8,False,27.493566666666666,-1945,-3,-1,210,229,-19
BR1_2731144432,5,True,0,1,0,16306,160,60,6.6,False,10,False,1,0,0,18943,203,60,7.0,True,27.66415,-2637,-5,-1,220,263,-43
BR1_2731436419,4,True,0,1,0,15760,176,52,7.2,False,5,False,1,0,0,15487,189,52,7.4,True,29.7934,273,-1,-1,228,241,-13
BR1_2731427195,0,False,1,0,0,13892,216,48,7.0,False,4,True,0,1,0,15712,200,48,6.8,True,28.956766666666667,-1820,-4,1,264,248,16
BR1_2730470403,7,False,0,0,0,15819,204,40,7.0,False,17,True,1,1,0,22370,213,52,8.0,True,27.64785,-6551,-10,-1,244,265,-21
BR1_2729694970,7,False,0,1,0,16455,156,60,7.0,False,15,True,1,0,0,20868,193,52,7.2,True,28.416566666666668,-4413,-8,-1,216,245,-29
BR1_2710444425,2,False,0,0,0,13562,190,44,6.2,False,8,True,1,0,0,15426,139,56,6.4,True,25.068633333333334,-1864,-6,-1,234,195,39
BR1_2716819123,6,True,0,0,0,13671,115,43,6.2,False,8,False,0,0,1,17368,162,64,7.0,True,25.92765,-3697,-2,0,158,226,-68
BR1_2716773594,3,False,0,0,0,13333,134,48,6.4,False,11,True,1,0,0,17444,214,40,6.8,True,26.278983333333333,-4111,-8,-1,182,254,-72
BR1_2714839900,9,False,1,1,0,18278,206,48,7.6,True,4,True,0,0,0,15080,184,52,7.0,False,28.893716666666666,3198,5,1,254,236,18
BR1_2695340551,4,False,0,0,0,13480,135,44,6.4,False,7,True,1,1,0,16642,171,44,7.0,True,25.574916666666667,-3162,-3,-1,179,215,-36
BR1_2695313883,3,False,1,0,0,14195,175,56,6.8,False,10,True,0,0,0,17549,193,56,7.4,True,29.9106,-3354,-7,1,231,249,-18
BR1_2722496749,6,True,0,1,0,17987,201,59,7.4,False,5,False,1,0,0,15949,178,64,7.0,True,29.39005,2038,1,-1,260,242,18
BR1_2677835674,1,False,0,0,0,14539,188,60,7.0,False,13,True,1,0,0,19732,206,32,7.2,True,29.302266666666668,-5193,-12,-1,248,238,10
BR1_2730910547,7,True,1,0,0,15711,135,48,6.4,False,8,False,0,0,0,15724,157,43,6.4,True,25.96185,-13,-1,1,183,200,-17
BR1_2730813820,12,False,1,0,0,20871,216,64,7.6,True,1,True,0,0,0,14153,193,44,7.0,False,28.025466666666667,6718,11,1,280,237,43
BR1_2730726935,8,False,1,1,0,16573,157,73,6.8,True,5,True,0,0,0,14354,131,36,6.2,False,25.502216666666666,2219,3,1,230,167,63
BR1_2730666977,8,False,1,0,0,17371,217,48,7.4,True,5,True,0,1,0,15877,174,40,7.2,False,28.521833333333333,1494,3,1,265,214,51
BR1_2730334368,3,False,0,1,0,15670,232,52,7.2,False,6,True,1,0,0,16695,188,80,7.2,True,27.959466666666668,-1025,-3,-1,284,268,16
BR1_2728474699,11,False,1,1,0,18481,166,55,6.8,True,3,True,0,0,0,14482,190,36,6.2,False,25.861866666666668,3999,8,1,221,226,-5
BR1_2710841111,6,True,0,0,0,11743,90,20,5.6,False,3,False,0,1,0,15248,193,74,7.0,True,26.047716666666666,-3505,3,0,110,267,-157
BR1_2723068134,9,True,0,0,0,19003,151,84,7.2,True,13,False,1,0,0,18842,171,35,6.8,False,29.947533333333332,161,-4,-1,235,206,29
BR1_2731430929,9,True,0,1,0,18131,165,51,7.0,True,12,False,1,0,0,19923,196,62,7.4,False,29.567,-1792,-3,-1,216,258,-42
BR1_2731420868,11,True,1,0,0,19349,211,60,7.6,True,9,False,0,0,0,17551,190,24,6.4,False,27.77485,1798,2,1,271,214,57
BR1_2727394318,15,True,1,1,0,19746,157,56,6.6,True,6,False,0,0,0,15061,151,52,6.0,False,25.701083333333333,4685,9,1,213,203,10
BR1_2684284494,6,False,0,0,0,15791,188,48,6.8,True,5,True,0,0,0,14633,154,40,6.6,False,27.418466666666667,1158,1,0,236,194,42
BR1_2730034748,10,True,0,1,0,18733,161,48,7.0,True,9,False,0,0,0,16981,164,44,6.6,False,26.903683333333333,1752,1,0,209,208,1
BR1_2729455185,11,False,1,1,0,18404,141,72,7.0,True,7,True,0,0,0,16772,194,52,7.2,False,29.368616666666668,1632,4,1,213,246,-33
BR1_2729297358,8,False,1,0,0,16553,163,52,6.6,True,4,True,0,0,0,13520,117,36,6.2,False,26.4859,3033,4,1,215,153,62
BR1_2726954776,4,False,1,0,0,15017,168,56,6.8,False,7,True,0,1,0,16773,191,52,7.2,True,28.665416666666665,-1756,-3,1,224,243,-19
BR1_2725783136,6,True,0,0,0,14850,166,28,6.4,True,7,False,0,0,0,15006,180,32,6.6,False,27.035133333333334,-156,-1,0,194,212,-18
BR1_2681366468,6,True,0,1,0,15513,134,44,6.4,True,7,False,0,0,0,14880,149,44,6.2,False,26.651616666666666,633,-1,0,178,193,-15
BR1_2715306783,4,True,1,0,0,16324,181,48,7.2,False,6,False,0,0,0,15434,147,67,7.6,True,28.464783333333333,890,-2,1,229,214,15
BR1_2724978865,8,True,1,1,0,18999,219,68,7.4,True,5,False,0,0,0,16033,162,56,7.2,False,29.635,2966,3,1,287,218,69
BR1_2723029676,12,True,1,1,1,19260,131,68,7.4,False,7,False,0,0,0,16762,171,40,6.6,True,28.65725,2498,5,1,199,211,-12
BR1_2722969360,5,True,0,0,0,15669,169,60,7.0,False,8,False,1,0,0,17947,167,64,7.2,True,27.717316666666665,-2278,-3,-1,229,231,-2
BR1_2731548386,5,False,0,0,0,15223,160,34,7.0,False,6,True,1,0,0,15546,149,40,6.6,True,29.78555,-323,-1,-1,194,189,5
BR1_2731514436,5,True,1,0,0,13850,153,40,6.2,True,3,False,0,1,0,13722,138,47,6.4,False,25.64795,128,2,1,193,185,8
BR1_2731316765,10,True,0,1,0,16581,149,28,6.8,False,13,False,0,0,0,20320,187,68,7.4,True,28.43915,-3739,-3,0,177,255,-78
BR1_2731267394,10,True,1,0,0,17776,197,50,6.8,True,4,False,0,0,0,12943,95,52,6.2,False,26.467566666666666,4833,6,1,247,147,100
BR1_2681210508,11,False,0,0,0,17318,141,52,7.0,True,8,True,0,0,0,14332,122,44,6.4,False,26.966,2986,3,0,193,166,27
BR1_2677947708,3,True,0,0,0,14382,188,46,6.6,False,4,False,1,0,0,15297,170,57,6.8,True,26.259816666666666,-915,-1,-1,234,227,7
BR1_2702738143,6,False,0,0,0,15872,153,52,6.8,False,11,True,1,0,0,17962,166,56,6.6,True,29.55255,-2090,-5,-1,205,222,-17
BR1_2690406963,9,False,1,0,0,16551,143,52,6.4,True,8,True,0,0,0,15887,180,40,6.4,False,25.80303333333333,664,1,1,195,220,-25
BR1_2719133524,0,False,0,0,0,13864,170,64,7.2,False,3,True,0,0,0,15523,204,60,7.6,True,28.546333333333333,-1659,-3,0,234,264,-30
BR1_2731495160,6,False,1,1,0,16131,171,48,7.2,True,4,True,0,0,0,17228,230,72,7.4,False,29.983483333333332,-1097,2,1,219,302,-83
BR1_2727748206,6,False,0,0,0,13332,112,38,6.2,False,9,True,1,1,0,17722,191,58,6.8,True,27.419583333333332,-4390,-3,-1,150,249,-99
BR1_2683775101,5,False,0,0,0,12783,114,16,6.2,False,17,True,1,1,1,20787,146,44,6.8,True,25.1235,-8004,-12,-1,130,190,-60
BR1_2729495322,9,True,0,1,0,18705,223,64,7.2,False,2,False,1,0,0,14887,183,52,7.0,True,28.630783333333333,3818,7,-1,287,235,52
BR1_2708338850,5,False,1,0,0,14794,138,40,7.0,False,7,True,0,0,0,18955,213,54,7.2,True,29.499433333333332,-4161,-2,1,178,267,-89
BR1_2724530569,5,True,0,0,0,13260,137,36,6.2,False,7,False,0,0,0,15253,151,44,6.2,True,25.6341,-1993,-2,0,173,195,-22
BR1_2729143417,7,True,1,0,0,17552,192,48,6.8,True,6,False,0,0,0,15954,179,44,7.2,False,27.927983333333334,1598,1,1,240,223,17
BR1_2711247371,9,False,0,0,0,15469,137,36,6.8,False,6,True,1,0,0,14686,154,51,6.4,True,25.672816666666666,783,3,-1,173,205,-32
BR1_2708202157,3,True,1,0,0,14212,177,52,7.0,False,11,False,0,1,0,19107,177,56,7.4,True,29.17255,-4895,-8,1,229,233,-4
BR1_2725719145,8,True,0,0,0,17811,224,44,7.2,True,3,False,1,0,0,13738,141,60,7.0,False,28.7234,4073,5,-1,268,201,67
BR1_2728984101,9,False,0,0,0,17500,172,24,6.2,False,14,True,1,0,0,19399,175,42,6.8,True,27.87365,-1899,-5,-1,196,217,-21
BR1_2731524838,7,True,1,0,0,15522,138,52,6.6,True,2,False,0,1,0,13545,185,44,6.6,False,26.24738333333333,1977,5,1,190,229,-39
BR1_2730332110,3,False,0,0,0,13173,133,48,6.6,False,4,True,1,0,0,15237,215,51,7.2,True,25.36541666666667,-2064,-1,-1,181,266,-85
BR1_2730252530,6,True,0,0,0,16086,195,56,6.6,True,5,False,1,0,0,14696,149,48,6.2,False,26.621583333333334,1390,1,-1,251,197,54
BR1_2730195393,9,False,1,0,0,17904,221,46,7.8,True,4,True,0,1,0,15806,188,36,7.2,False,28.531933333333335,2098,5,1,267,224,43
BR1_2722463095,6,True,1,0,0,15900,159,60,6.8,True,5,False,0,0,0,15551,173,36,6.8,False,29.825783333333334,349,1,1,219,209,10
BR1_2698951516,8,False,1,0,0,16508,170,48,7.2,True,8,True,0,1,0,17765,168,60,7.2,False,27.646516666666667,-1257,0,1,218,228,-10
BR1_2698910873,6,True,0,0,0,16284,194,48,7.2,True,6,False,1,1,0,15273,155,60,7.0,False,27.615,1011,0,-1,242,215,27
BR1_2731468594,9,True,0,1,0,16221,155,36,6.8,False,6,False,0,0,0,15848,173,47,7.0,True,26.78725,373,3,0,191,220,-29
BR1_2731627672,7,True,1,0,0,15203,161,51,6.6,True,6,False,0,0,0,15946,203,49,7.0,False,25.6625,-743,1,1,212,252,-40
BR1_2707462765,7,False,0,0,0,16447,184,56,7.0,True,8,True,0,0,0,16201,143,40,6.8,False,29.364116666666668,246,-1,0,240,183,57
BR1_2728762387,13,True,1,0,0,19397,183,44,7.2,False,10,False,0,0,0,18365,202,48,7.2,True,28.359666666666666,1032,3,1,227,250,-23
BR1_2703247848,6,False,0,0,0,16711,207,80,7.2,False,8,True,0,0,0,17996,224,48,7.4,True,29.59636666666667,-1285,-2,0,287,272,15
BR1_2726242029,7,True,1,0,0,16131,151,48,7.0,True,6,False,0,1,0,16310,170,40,7.0,False,29.506916666666665,-179,1,1,199,210,-11
BR1_2683662618,9,False,0,0,0,15810,151,39,6.6,True,4,True,1,0,0,14245,154,48,6.6,False,25.430183333333332,1565,5,-1,190,202,-12
BR1_2702533435,6,True,0,0,0,14315,131,40,6.2,False,11,False,1,1,0,17669,130,44,6.4,True,27.076033333333335,-3354,-5,-1,171,174,-3
BR1_2702083162,8,False,0,1,0,14747,131,37,6.4,False,12,True,1,0,0,17963,175,58,6.8,True,27.17725,-3216,-4,-1,168,233,-65
BR1_2724105723,3,False,0,0,0,14615,190,44,6.8,False,6,True,0,0,0,16799,193,55,7.2,True,28.738883333333334,-2184,-3,0,234,248,-14
BR1_2728475880,5,False,0,0,0,16047,183,68,7.6,True,9,True,1,1,0,18490,172,60,6.8,False,29.73218333333333,-2443,-4,-1,251,232,19
BR1_2728004126,14,False,0,1,0,20962,189,45,7.4,True,10,True,0,0,0,17061,155,38,6.8,False,28.041066666666666,3901,4,0,234,193,41
BR1_2727518509,8,True,0,0,0,17363,193,56,7.0,False,12,False,1,1,0,19485,185,52,7.6,True,28.109366666666666,-2122,-4,-1,249,237,12
BR1_2727347256,2,False,0,0,0,14362,192,48,6.8,True,4,True,1,0,0,14439,191,56,6.8,False,26.2961,-77,-2,-1,240,247,-7
BR1_2731335970,7,False,0,0,0,16791,181,44,6.8,False,7,True,1,1,0,17226,167,64,7.4,True,29.135416666666668,-435,0,-1,225,231,-6
BR1_2731452834,3,True,0,0,0,13098,158,44,6.2,False,9,False,1,1,0,16197,135,44,6.4,True,26.350466666666666,-3099,-6,-1,202,179,23
BR1_2731436829,5,False,0,0,1,16936,169,39,7.2,False,10,True,1,1,0,18871,159,76,7.0,True,29.68335,-1935,-5,-1,208,235,-27
BR1_2731039965,5,False,0,0,0,16157,182,44,6.8,False,9,True,0,0,0,17825,233,60,7.2,True,29.930016666666667,-1668,-4,0,226,293,-67
BR1_2730368907,11,True,1,0,1,20414,207,59,7.4,True,1,False,0,0,0,14187,179,52,6.6,False,28.261333333333333,6227,10,1,266,231,35
BR1_2712716014,2,False,0,0,0,13038,139,48,6.0,False,4,True,0,0,0,15393,177,44,6.0,True,26.52975,-2355,-2,0,187,221,-34
BR1_2723371301,9,True,0,1,1,19556,167,47,7.4,True,13,False,1,0,0,18404,202,44,7.2,False,29.14,1152,-4,-1,214,246,-32
BR1_2730937824,12,True,0,0,0,18241,219,32,6.8,True,4,False,0,0,0,13516,127,35,6.2,False,26.6666,4725,8,0,251,162,89
BR1_2730919827,6,True,1,0,0,14779,159,48,7.0,True,1,False,0,0,0,12713,177,44,6.4,False,26.441366666666667,2066,5,1,207,221,-14
BR1_2726146139,6,True,0,0,0,14331,158,38,6.4,False,3,False,1,0,0,13909,174,44,6.2,True,25.212766666666667,422,3,-1,196,218,-22
BR1_2725771658,5,True,0,0,0,14026,150,48,6.4,False,10,False,1,1,0,16959,170,48,6.6,True,27.403483333333334,-2933,-5,-1,198,218,-20
BR1_2725743338,3,True,1,1,0,14526,155,51,6.8,False,6,False,0,0,0,16678,210,48,7.4,True,29.08203333333333,-2152,-3,1,206,258,-52
BR1_2731301910,9,False,0,0,0,16479,151,52,6.6,True,9,True,0,0,0,15241,113,48,6.2,False,27.395833333333332,1238,0,0,203,161,42
BR1_2731057106,6,False,0,1,0,16518,174,76,7.4,True,4,True,0,0,0,16096,208,44,7.2,False,27.765966666666667,422,2,0,250,252,-2
BR1_2731152923,5,False,0,0,0,14660,196,32,6.8,False,10,True,1,0,0,15835,163,48,6.8,True,26.147916666666667,-1175,-5,-1,228,211,17
BR1_2719793726,7,True,1,0,0,15599,192,45,7.0,False,7,False,0,0,0,18107,204,57,7.6,True,27.505133333333333,-2508,0,1,237,261,-24
BR1_2722807725,11,True,1,0,0,17847,157,52,7.0,False,5,False,0,1,0,15808,192,36,7.0,True,28.120583333333332,2039,6,1,209,228,-19
BR1_2722780405,3,False,0,1,0,15008,142,52,6.6,False,9,True,1,0,0,17484,173,52,7.2,True,28.680066666666665,-2476,-6,-1,194,225,-31
BR1_2731181302,7,False,0,0,0,14507,141,44,6.4,False,4,True,0,1,0,13955,152,48,6.6,True,26.563383333333334,552,3,0,185,200,-15
BR1_2731662568,9,False,1,1,0,17268,146,64,6.8,True,13,True,0,0,0,18663,161,48,7.2,False,29.587766666666667,-1395,-4,1,210,209,1
BR1_2731142731,5,False,1,0,0,15297,167,52,6.8,False,5,True,0,1,0,16428,189,52,7.0,True,29.34385,-1131,0,1,219,241,-22
BR1_2730743539,10,True,0,0,0,17611,203,36,7.2,False,7,False,1,0,0,16040,151,56,6.6,True,28.7399,1571,3,-1,239,207,32
BR1_2730588290,9,True,1,0,0,18210,197,60,7.6,True,4,False,0,1,0,14869,181,40,7.0,False,28.014766666666667,3341,5,1,257,221,36
BR1_2710090678,3,False,0,0,0,14246,175,44,6.6,False,5,True,0,0,0,16212,184,52,6.8,True,28.557316666666665,-1966,-2,0,219,236,-17
BR1_2717528182,10,True,1,0,0,16539,113,40,5.4,True,7,False,0,0,0,17172,166,49,6.8,False,29.12715,-633,3,1,153,215,-62
BR1_2730705666,6,True,0,0,0,16756,194,52,7.0,False,7,False,1,1,0,17035,209,44,7.2,True,28.062716666666667,-279,-1,-1,246,253,-7
BR1_2731631606,2,False,0,0,0,13452,169,52,6.6,False,3,True,1,1,0,14074,180,44,6.8,True,25.8952,-622,-1,-1,221,224,-3
BR1_2731031635,7,False,0,0,0,16203,174,52,7.2,False,6,True,1,1,0,16528,183,67,7.2,True,28.178316666666667,-325,1,-1,226,250,-24
BR1_2722855404,3,False,0,1,0,13428,158,44,6.4,False,3,True,1,0,0,15409,207,60,6.8,True,26.88345,-1981,0,-1,202,267,-65
BR1_2724333987,8,True,0,0,0,16192,194,60,6.8,True,3,False,0,0,0,12340,94,37,6.4,False,25.815383333333333,3852,5,0,254,131,123
BR1_2731494593,14,True,1,0,0,19163,198,46,7.0,True,12,False,0,0,0,18167,149,48,7.0,False,29.8426,996,2,1,244,197,47
BR1_2731429019,1,False,1,1,0,14081,168,68,7.2,True,9,True,0,0,1,19148,171,56,7.4,False,28.449866666666665,-5067,-8,1,236,227,9
BR1_2715877924,9,True,1,0,0,16231,178,36,6.8,True,3,False,0,1,0,14123,191,40,6.6,False,25.151883333333334,2108,6,1,214,231,-17
BR1_2718100224,3,True,0,0,0,13708,150,71,6.4,False,9,False,1,0,0,16478,224,39,6.8,True,26.271683333333332,-2770,-6,-1,221,263,-42
BR1_2718065801,9,True,1,0,0,16352,156,44,7.0,True,3,False,0,1,0,15843,154,68,7.0,False,29.10285,509,6,1,200,222,-22
BR1_2729249842,9,True,1,0,0,16621,171,44,6.4,True,6,False,0,1,0,14963,177,46,6.6,False,25.883983333333333,1658,3,1,215,223,-8
BR1_2720555659,12,True,1,0,0,18863,181,44,7.2,True,3,False,0,1,0,14735,142,48,6.8,False,28.008166666666668,4128,9,1,225,190,35
BR1_2713543460,5,False,0,1,0,15188,154,52,6.4,False,8,True,1,0,0,15220,145,56,6.4,True,25.011333333333333,-32,-3,-1,206,201,5
BR1_2731175578,4,False,0,0,0,15290,182,52,6.8,False,9,True,1,0,0,16952,150,44,6.6,True,28.835333333333335,-1662,-5,-1,234,194,40
BR1_2693955755,5,False,1,0,0,13298,123,44,6.2,False,8,True,0,0,0,16246,152,36,6.6,True,27.4913,-2948,-3,1,167,188,-21
BR1_2729945500,6,False,0,1,0,15846,187,52,6.6,False,6,True,1,0,0,16832,194,68,7.2,True,26.742316666666667,-986,0,-1,239,262,-23
BR1_2729897576,5,True,0,0,0,14638,146,42,6.4,False,8,False,1,0,0,17035,184,50,7.2,True,28.2916,-2397,-3,-1,188,234,-46
BR1_2705361200,4,True,0,0,0,15940,218,48,7.2,True,6,False,1,0,0,16111,234,48,7.4,False,27.7579,-171,-2,-1,266,282,-16
BR1_2703125489,13,True,0,0,0,20556,176,48,7.2,False,8,False,1,0,0,17802,169,64,7.0,True,27.947966666666666,2754,5,-1,224,233,-9
BR1_2729659467,11,False,0,1,1,17577,155,44,6.6,True,10,True,1,0,0,16563,118,40,5.8,False,25.986316666666667,1014,1,-1,199,158,41
BR1_2729583509,8,True,0,0,0,15747,143,35,7.2,False,8,False,1,1,0,18686,189,71,7.6,True,29.36841666666667,-2939,0,-1,178,260,-82
BR1_2728450120,7,True,1,1,0,16210,154,44,6.4,False,6,False,0,0,0,17277,181,48,7.0,True,29.558733333333333,-1067,1,1,198,229,-31
BR1_2674857251,5,True,0,0,0,16417,196,40,7.0,False,11,False,1,0,0,18672,204,44,7.2,True,28.016633333333335,-2255,-6,-1,236,248,-12
BR1_2731617962,9,True,0,0,0,18557,183,56,7.2,False,9,False,0,0,0,18462,205,40,7.2,True,28.944983333333333,95,0,0,239,245,-6
BR1_2722603159,5,True,1,0,0,17448,194,56,7.6,True,5,False,0,1,0,15635,167,52,6.6,False,28.88105,1813,0,1,250,219,31
BR1_2697574696,8,True,0,1,0,16796,182,56,7.6,False,6,False,1,0,0,16720,201,56,7.4,True,29.503933333333332,76,2,-1,238,257,-19
BR1_2697217136,10,True,1,1,0,16659,145,54,6.2,True,4,False,0,0,0,14302,164,44,6.6,False,27.332316666666667,2357,6,1,199,208,-9
BR1_2694525872,11,True,1,1,0,19858,211,67,7.4,True,7,False,0,0,0,16281,165,40,7.0,False,27.69633333333333,3577,4,1,278,205,73
BR1_2729311770,6,False,0,0,0,15978,171,56,7.2,False,4,True,1,0,0,15505,187,52,7.2,True,28.786733333333334,473,2,-1,227,239,-12
BR1_2729083396,8,True,1,0,0,17111,186,55,7.2,True,5,False,0,0,0,13492,144,36,6.4,False,27.47875,3619,3,1,241,180,61
BR1_2730072278,3,True,1,0,0,15630,214,60,7.2,True,0,False,0,0,0,11714,156,36,5.6,False,25.004216666666668,3916,3,1,274,192,82
BR1_2693771350,11,True,1,0,0,18242,179,53,6.8,True,5,False,0,0,0,15807,161,44,6.8,False,28.602366666666665,2435,6,1,232,205,27
BR1_2693393257,11,True,0,0,0,17297,164,44,6.6,True,7,False,0,0,1,17085,187,44,6.8,False,26.943983333333332,212,4,0,208,231,-23
BR1_2701196849,12,True,1,0,0,18785,159,56,7.2,True,3,False,0,1,0,15231,181,56,7.2,False,29.206916666666668,3554,9,1,215,237,-22
BR1_2701118759,10,False,0,1,0,18275,150,59,6.6,False,8,True,1,0,0,18298,220,36,7.0,True,29.2484,-23,2,-1,209,256,-47
BR1_2722646787,9,True,0,0,0,17997,171,44,7.2,False,7,False,1,1,0,17124,181,55,7.2,True,28.277183333333333,873,2,-1,215,236,-21
BR1_2676297026,6,True,1,0,0,14969,150,48,6.8,False,6,False,0,0,0,14902,144,51,6.6,True,26.706416666666666,67,0,1,198,195,3
BR1_2730257687,9,True,0,0,0,16162,180,60,7.0,True,2,False,1,0,0,12523,158,44,6.4,False,27.06555,3639,7,-1,240,202,38
BR1_2731342257,16,True,1,1,1,20553,150,43,6.8,True,11,False,0,0,0,17677,141,53,6.4,False,27.35845,2876,5,1,193,194,-1
BR1_2731045740,2,True,0,0,0,12208,113,44,6.4,False,9,False,1,1,0,16480,201,52,7.2,True,25.624983333333333,-4272,-7,-1,157,253,-96
BR1_2723841638,11,True,0,0,0,18263,173,44,7.2,False,10,False,1,1,1,19268,172,64,7.2,True,27.77655,-1005,1,-1,217,236,-19
BR1_2726856934,12,True,0,0,0,16490,135,40,6.4,False,8,False,0,0,0,16480,156,48,6.6,True,25.13521666666667,10,4,0,175,204,-29
BR1_2726839353,4,True,0,0,0,15835,162,72,7.4,True,3,False,1,1,0,15094,180,40,6.8,False,27.87845,741,1,-1,234,220,14
BR1_2705812404,12,False,1,0,0,19220,176,44,7.2,False,9,True,0,0,0,17729,177,56,7.2,True,29.603633333333335,1491,3,1,220,233,-13
BR1_2721196427,3,True,0,0,0,12023,102,26,6.2,False,6,False,0,0,0,15467,158,61,6.6,True,27.231883333333332,-3444,-3,0,128,219,-91
BR1_2720803354,6,False,0,0,0,14167,145,48,6.4,True,7,True,1,0,0,15648,142,40,6.6,False,25.162233333333333,-1481,-1,-1,193,182,11
BR1_2730986572,12,False,1,1,0,20479,199,68,7.2,True,4,True,0,0,0,14807,167,46,7.0,False,28.11955,5672,8,1,267,213,54
BR1_2723967035,9,True,1,0,0,16686,179,52,6.8,True,5,False,0,1,0,15293,177,52,7.0,False,26.029983333333334,1393,4,1,231,229,2
BR1_2708982333,5,False,0,0,0,14807,141,60,6.4,False,10,True,1,1,0,17876,166,60,7.0,True,28.661516666666667,-3069,-5,-1,201,226,-25
BR1_2728691419,7,False,1,0,0,15723,133,50,7.2,False,17,True,0,0,0,20549,145,45,7.2,True,27.6009,-4826,-10,1,183,190,-7
BR1_2676357748,8,True,0,0,0,16368,137,56,6.8,False,5,False,1,0,0,16730,220,64,7.4,True,28.34,-362,3,-1,193,284,-91
BR1_2675976023,2,True,0,0,0,12772,139,40,6.2,False,6,False,1,0,0,14810,150,56,6.8,True,26.54146666666667,-2038,-4,-1,179,206,-27
BR1_2675901483,10,True,0,0,0,16279,119,24,6.2,False,7,False,0,0,0,16758,196,32,6.8,True,29.191916666666668,-479,3,0,143,228,-85
BR1_2730223858,12,True,1,0,0,18380,173,48,6.4,True,12,False,0,0,0,18258,145,55,6.6,False,29.777266666666666,122,0,1,221,200,21
BR1_2727529754,3,True,0,0,0,15991,204,52,7.0,True,6,False,1,1,0,16921,202,76,7.2,False,28.9061,-930,-3,-1,256,278,-22
BR1_2695029396,1,False,0,1,0,15513,215,72,7.6,True,4,True,1,0,0,16451,203,72,7.4,False,29.573233333333334,-938,-3,-1,287,275,12
BR1_2712648033,11,True,1,0,0,19039,156,68,6.8,True,6,False,0,0,0,15597,158,40,6.6,False,27.587216666666666,3442,5,1,224,198,26
BR1_2731676871,1,False,0,1,0,11352,76,56,6.2,False,3,True,1,0,0,14436,178,52,6.8,True,27.094166666666666,-3084,-2,-1,132,230,-98
BR1_2681268203,6,False,0,1,0,15343,176,58,6.8,True,5,True,1,0,0,15808,167,44,6.6,False,28.0268,-465,1,-1,234,211,23
BR1_2704014522,3,True,0,0,0,13670,156,38,6.4,True,6,False,1,0,0,14025,159,47,6.6,False,27.208883333333333,-355,-3,-1,194,206,-12
BR1_2720099654,12,False,0,0,0,20274,230,56,7.4,True,7,True,0,0,0,16911,187,68,7.2,False,27.661533333333335,3363,5,0,286,255,31
BR1_2712884358,7,True,1,0,0,15618,199,52,6.4,True,2,False,0,0,0,12494,142,43,6.4,False,25.9125,3124,5,1,251,185,66
BR1_2712668383,6,False,1,0,0,15340,191,40,7.0,True,4,True,0,1,0,13661,143,44,6.4,False,26.666,1679,2,1,231,187,44
BR1_2719884943,1,False,0,1,0,13566,142,72,7.0,False,6,True,1,0,0,16316,180,40,7.0,True,28.973216666666666,-2750,-5,-1,214,220,-6
BR1_2730885983,9,False,0,0,0,16977,143,40,6.4,False,11,True,1,0,0,17891,172,60,6.8,True,29.915066666666668,-914,-2,-1,183,232,-49
BR1_2730884323,7,True,0,0,0,15252,124,76,6.6,False,13,False,1,0,0,16783,192,31,7.0,True,25.059466666666665,-1531,-6,-1,200,223,-23
BR1_2730081162,9,True,0,0,0,14563,124,36,6.2,False,6,False,1,0,0,16101,157,51,6.4,True,27.409,-1538,3,-1,160,208,-48
BR1_2730927309,4,False,0,0,0,12214,96,40,6.4,False,6,True,1,1,0,15814,142,64,6.8,True,26.914983333333332,-3600,-2,-1,136,206,-70
BR1_2712460311,1,False,0,0,0,12557,177,17,6.2,False,3,True,1,0,0,15574,228,58,7.0,True,25.6467,-3017,-2,-1,194,286,-92
BR1_2712406584,6,False,0,1,1,13807,89,40,6.2,False,8,True,0,0,0,17331,166,48,6.8,True,25.00915,-3524,-2,0,129,214,-85
BR1_2731233128,7,True,0,1,1,17718,181,48,6.2,True,7,False,0,0,0,16424,162,52,6.0,False,26.903766666666666,1294,0,0,229,214,15
BR1_2730837801,4,False,0,0,0,14708,174,48,7.2,True,6,True,0,1,0,17678,245,56,7.6,False,29.056483333333333,-2970,-2,0,222,301,-79
BR1_2728613973,16,True,0,0,0,19007,149,44,6.8,True,5,False,0,0,0,15484,182,44,6.4,False,25.87376666666667,3523,11,0,193,226,-33
BR1_2700770361,5,False,0,1,0,14575,144,36,6.8,False,9,True,1,0,0,16749,180,64,6.8,True,27.618516666666668,-2174,-4,-1,180,244,-64
BR1_2725692173,7,False,0,1,0,17807,207,36,6.8,True,9,True,1,0,0,17547,179,60,7.0,False,27.57825,260,-2,-1,243,239,4
BR1_2730966996,4,False,0,0,0,14038,172,52,6.6,False,5,True,0,0,0,16396,205,72,7.0,True,25.74975,-2358,-1,0,224,277,-53
BR1_2730784183,7,False,0,0,0,15487,152,48,6.8,False,5,True,0,0,0,16218,201,40,7.2,True,28.318933333333334,-731,2,0,200,241,-41
BR1_2708505166,4,False,0,0,0,13836,133,52,6.0,False,2,True,1,1,1,14402,149,52,6.4,True,25.375133333333334,-566,2,-1,185,201,-16
BR1_2731554075,7,True,1,1,0,16887,181,60,7.2,True,3,False,0,0,0,14534,175,32,6.6,False,28.74128333333333,2353,4,1,241,207,34
BR1_2717594821,11,True,0,0,0,18628,205,38,7.2,False,10,False,0,0,0,18115,166,40,6.8,True,28.645366666666668,513,1,0,243,206,37
BR1_2731682047,0,False,0,0,0,13233,169,60,7.0,False,7,True,1,1,0,17962,174,64,7.2,True,29.721733333333333,-4729,-7,-1,229,238,-9
BR1_2728421198,16,True,1,0,0,20226,161,65,7.0,True,4,False,0,1,0,13514,161,34,6.0,False,25.29445,6712,12,1,226,195,31
BR1_2728392361,8,True,0,0,0,16223,171,28,6.6,True,8,False,1,0,0,15591,150,52,6.4,False,27.126066666666667,632,0,-1,199,202,-3
BR1_2731313558,9,True,1,0,0,16454,180,60,6.4,False,6,False,0,0,0,15217,137,44,6.2,True,26.110316666666666,1237,3,1,240,181,59
BR1_2731366984,15,False,1,0,0,19291,177,56,6.8,True,11,True,0,0,0,17968,164,32,6.6,False,28.0283,1323,4,1,233,196,37
BR1_2717178991,6,True,0,0,0,14197,141,56,6.2,False,5,False,1,0,0,15158,178,47,6.6,True,27.1391,-961,1,-1,197,225,-28
BR1_2703147008,5,False,0,0,0,15037,162,52,6.6,False,10,True,1,0,0,17239,169,56,7.4,True,29.072333333333333,-2202,-5,-1,214,225,-11
BR1_2703048919,4,True,0,1,0,14481,159,54,6.8,True,1,False,0,0,0,11686,135,32,6.0,False,25.390916666666666,2795,3,0,213,167,46
BR1_2729459688,4,True,0,0,0,14138,152,35,6.8,False,5,False,1,0,0,14489,152,44,6.6,True,27.4162,-351,-1,-1,187,196,-9
BR1_2729350150,13,True,1,0,0,19668,171,52,6.8,True,12,False,0,0,0,18485,177,36,6.8,False,29.023933333333332,1183,1,1,223,213,10
BR1_2731628848,11,False,1,0,0,18856,195,54,7.2,False,9,True,0,0,0,17827,173,52,7.4,True,28.784266666666667,1029,2,1,249,225,24
BR1_2731538886,4,False,0,0,0,13967,143,36,7.2,False,5,True,0,0,0,16362,183,64,7.6,True,28.90365,-2395,-1,0,179,247,-68
BR1_2731644634,3,False,0,1,0,15082,169,68,7.0,True,1,True,0,0,0,12591,167,44,6.8,False,25.394883333333333,2491,2,0,237,211,26
BR1_2731284523,4,False,0,0,0,14209,155,44,6.8,False,7,True,1,0,0,15474,153,42,6.6,True,26.18335,-1265,-3,-1,199,195,4
BR1_2731637460,3,True,1,0,0,15027,185,45,7.0,False,8,False,0,1,0,17664,209,56,7.8,True,29.305683333333334,-2637,-5,1,230,265,-35
BR1_2697188957,4,False,0,0,0,15187,174,54,7.2,False,9,True,1,0,0,17226,196,52,7.8,True,28.055416666666666,-2039,-5,-1,228,248,-20
BR1_2697190490,5,False,1,0,0,15217,189,44,6.8,False,8,True,0,1,0,18104,187,52,7.0,True,25.88785,-2887,-3,1,233,239,-6
BR1_2731520254,9,False,1,0,0,17016,127,52,6.8,False,9,True,0,1,1,19387,206,56,7.2,True,29.449766666666665,-2371,0,1,179,262,-83
BR1_2731155690,4,True,0,0,0,17004,195,60,7.4,False,5,False,1,0,0,16806,209,56,7.0,True,28.09635,198,-1,-1,255,265,-10
BR1_2714251833,7,True,1,1,0,17903,213,56,7.2,True,3,False,0,0,0,15173,216,60,7.6,False,27.938783333333333,2730,4,1,269,276,-7
BR1_2729932980,8,False,0,1,0,16617,143,64,7.2,False,8,True,1,0,0,18942,215,56,7.0,True,27.752933333333335,-2325,0,-1,207,271,-64
BR1_2722267011,12,True,1,0,0,18218,155,56,6.8,True,14,False,0,0,0,18953,171,44,6.8,False,27.514466666666667,-735,-2,1,211,215,-4
BR1_2731505336,7,True,0,0,0,14679,115,39,6.2,False,11,False,0,0,0,18040,194,32,7.2,True,26.862,-3361,-4,0,154,226,-72
BR1_2730201147,4,False,0,1,0,14426,127,52,6.4,False,8,True,0,0,0,15342,182,44,6.8,True,25.959116666666667,-916,-4,0,179,226,-47
BR1_2718888534,1,True,0,1,0,13795,176,52,6.8,True,2,False,0,0,0,14604,200,56,6.8,False,26.199166666666667,-809,-1,0,228,256,-28
BR1_2718145745,6,False,1,0,0,16437,195,56,7.0,True,5,True,0,1,0,16623,175,60,7.0,False,29.742316666666667,-186,1,1,251,235,16
BR1_2730531516,7,False,0,0,0,14403,190,28,6.6,False,9,True,1,0,0,15920,127,56,6.6,True,26.240516666666668,-1517,-2,-1,218,183,35
BR1_2681778385,5,True,0,1,0,13622,165,48,6.8,False,12,False,1,0,0,17450,164,46,7.2,True,25.24605,-3828,-7,-1,213,210,3
BR1_2731660459,10,False,0,1,0,18730,197,40,6.8,True,9,True,0,0,0,17216,172,52,6.8,False,29.55475,1514,1,0,237,224,13
BR1_2731637773,8,True,0,0,0,16085,155,50,6.8,True,5,False,0,0,0,15381,185,40,6.6,False,26.32835,704,3,0,205,225,-20
BR1_2731369493,6,False,1,0,0,13894,140,44,6.4,True,10,True,0,1,1,17609,142,52,6.6,False,27.4492,-3715,-4,1,184,194,-10
BR1_2719012242,10,True,1,1,0,18441,188,59,7.0,True,6,False,0,0,0,15781,170,58,6.8,False,29.291033333333335,2660,4,1,247,228,19
BR1_2730324257,10,False,1,1,0,18498,167,55,7.0,False,10,True,0,0,0,18165,155,40,6.6,True,29.374983333333333,333,0,1,222,195,27
BR1_2731118487,7,True,0,0,0,15353,168,39,6.6,False,5,False,1,0,0,15643,189,72,6.8,True,26.106083333333334,-290,2,-1,207,261,-54
BR1_2723019270,3,True,0,0,0,14417,135,56,6.8,False,11,False,0,1,0,18506,204,60,7.4,True,28.0314,-4089,-8,0,191,264,-73
BR1_2717700300,5,False,0,0,0,14973,197,14,6.4,False,7,True,0,0,0,17032,187,50,7.2,True,27.649166666666666,-2059,-2,0,211,237,-26
BR1_2730040594,8,True,0,0,0,15140,125,36,6.4,False,6,False,0,1,0,15821,162,40,6.2,True,26.4437,-681,2,0,161,202,-41
BR1_2730642009,7,False,1,0,0,17613,192,52,7.4,True,9,True,0,1,0,19232,227,76,7.8,False,29.199783333333333,-1619,-2,1,244,303,-59
BR1_2730620153,4,True,0,1,0,15289,156,48,6.4,False,12,False,1,0,0,19418,178,48,7.2,True,28.0361,-4129,-8,-1,204,226,-22
BR1_2722700867,9,False,1,1,0,18745,209,59,7.4,False,8,True,0,0,0,17313,171,40,7.0,True,28.241583333333335,1432,1,1,268,211,57
BR1_2710661297,4,True,1,0,0,15033,170,24,6.4,False,3,False,0,0,0,16205,208,50,7.2,True,27.686583333333335,-1172,1,1,194,258,-64
BR1_2679959149,6,False,0,0,0,15292,153,48,6.8,True,7,True,0,0,0,16193,199,44,7.0,False,29.388266666666667,-901,-1,0,201,243,-42
BR1_2731569467,3,False,1,1,0,13236,142,48,6.4,False,6,True,0,0,0,14507,130,68,6.4,True,26.55613333333333,-1271,-3,1,190,198,-8
BR1_2691711352,5,False,1,1,0,16202,181,60,7.4,True,4,True,0,0,0,15629,195,44,7.2,False,28.17716666666667,573,1,1,241,239,2
BR1_2691702318,6,False,0,0,0,16657,188,48,7.0,False,8,True,1,0,0,16712,162,60,7.2,True,28.649733333333334,-55,-2,-1,236,222,14
BR1_2721745577,7,True,1,0,0,17110,175,65,7.4,False,6,False,0,1,0,17067,191,58,7.4,True,28.810016666666666,43,1,1,240,249,-9
BR1_2724250213,7,False,0,0,0,15754,144,56,6.4,True,7,True,0,0,0,15256,169,44,6.6,False,25.36165,498,0,0,200,213,-13
BR1_2726824629,3,False,0,0,0,14250,154,52,6.6,True,7,True,0,0,0,17291,192,44,6.8,False,29.591,-3041,-4,0,206,236,-30
BR1_2730393510,11,True,0,0,0,17884,174,40,7.2,False,13,False,1,0,0,19111,204,48,7.2,True,28.39425,-1227,-2,-1,214,252,-38
BR1_2730387430,4,False,0,0,0,14087,162,44,6.2,False,3,True,1,1,0,14883,176,56,6.4,True,25.05295,-796,1,-1,206,232,-26
BR1_2729776616,4,True,0,0,0,15525,209,60,7.2,False,5,False,1,1,0,16828,183,68,7.4,True,28.458366666666667,-1303,-1,-1,269,251,18
BR1_2730151541,15,True,0,1,0,19533,155,58,7.0,False,8,False,1,0,0,16196,174,45,6.8,True,28.10955,3337,7,-1,213,219,-6
BR1_2731431159,7,True,0,1,1,18353,197,58,7.0,True,7,False,1,0,0,16205,164,36,6.6,False,29.413283333333332,2148,0,-1,255,200,55
BR1_2731423010,10,False,1,0,0,18113,199,68,7.0,True,5,True,0,0,0,17826,222,44,7.0,False,28.6192,287,5,1,267,266,1
BR1_2730574475,6,True,1,0,0,16600,148,52,6.8,False,6,False,0,1,0,16763,194,40,7.2,True,29.196983333333332,-163,0,1,200,234,-34
BR1_2730954536,3,True,1,0,0,12114,132,17,6.4,False,5,False,0,0,0,15059,164,56,6.6,True,27.497333333333334,-2945,-2,1,149,220,-71
BR1_2707164119,7,True,0,1,0,15857,185,44,6.4,True,4,False,0,0,0,13984,143,44,6.6,False,26.840883333333334,1873,3,0,229,187,42
BR1_2707118453,9,True,1,1,0,17598,199,60,7.2,True,7,False,0,0,0,17810,192,64,7.6,False,29.254616666666667,-212,2,1,259,256,3
BR1_2689885085,10,True,0,0,0,17471,155,55,7.4,False,8,False,1,0,0,17032,190,43,7.0,True,28.0425,439,2,-1,210,233,-23
BR1_2715745582,11,False,1,1,0,17114,158,48,6.6,True,6,True,0,0,0,14820,142,54,6.4,False,28.084766666666667,2294,5,1,206,196,10
BR1_2715373551,7,True,0,0,0,13360,141,4,6.0,False,9,False,1,0,0,16250,156,56,6.8,True,27.403566666666666,-2890,-2,-1,145,212,-67
BR1_2729591035,5,False,1,0,0,14966,181,50,7.0,True,4,True,0,1,0,14304,164,54,6.6,False,25.7966,662,1,1,231,218,13
BR1_2711443512,9,False,0,0,0,18008,159,43,6.2,False,10,True,1,1,0,17553,176,36,6.8,True,29.22755,455,-1,-1,202,212,-10
BR1_2729317432,7,True,0,1,0,17185,179,76,6.8,True,9,False,1,0,0,16116,171,44,6.8,False,27.216716666666667,1069,-2,-1,255,215,40
BR1_2729072083,10,True,0,0,0,16300,156,48,6.6,True,9,False,0,0,0,16666,187,34,6.8,False,26.5176,-366,1,0,204,221,-17
BR1_2726955267,8,False,0,0,0,15704,167,44,6.6,False,14,True,1,0,0,18129,148,48,7.0,True,26.585283333333333,-2425,-6,-1,211,196,15
BR1_2721844059,7,False,1,1,0,17320,208,64,7.4,True,11,True,0,0,0,18362,185,49,7.4,False,29.838483333333333,-1042,-4,1,272,234,38
BR1_2729862095,7,True,1,0,0,16013,151,56,6.8,True,6,False,0,0,0,14310,134,48,6.6,False,26.758516666666665,1703,1,1,207,182,25
BR1_2729846899,2,False,1,0,0,12531,129,44,6.2,False,12,True,0,0,0,17816,164,28,6.6,True,26.161483333333333,-5285,-10,1,173,192,-19
BR1_2731325165,1,False,0,0,0,13278,173,49,6.8,True,1,True,0,0,0,12590,160,56,6.4,False,25.5632,688,0,0,222,216,6
BR1_2731036053,4,True,0,0,0,12956,138,28,6.0,False,8,False,1,1,0,16925,185,57,6.8,True,26.295733333333335,-3969,-4,-1,166,242,-76
BR1_2727744066,5,False,1,0,0,15365,131,36,7.0,True,5,True,0,1,2,18467,191,52,7.2,False,27.774933333333333,-3102,0,1,167,243,-76
BR1_2713126192,5,False,0,0,0,15455,158,56,7.4,False,5,True,1,0,0,15630,196,48,7.0,True,28.262283333333333,-175,0,-1,214,244,-30
BR1_2730844137,11,False,0,1,0,16753,140,32,6.4,False,11,True,1,0,0,17980,159,40,6.4,True,26.6137,-1227,0,-1,172,199,-27
BR1_2729401585,6,True,1,0,0,15695,185,45,6.8,True,4,False,0,0,0,13552,131,50,6.4,False,27.396333333333335,2143,2,1,230,181,49
BR1_2726588713,8,True,0,0,0,16278,168,44,6.8,True,4,False,0,0,0,15366,178,48,7.0,False,28.587283333333332,912,4,0,212,226,-14
BR1_2716078324,8,True,1,0,0,18088,212,48,7.0,True,10,False,0,1,0,18227,197,52,7.4,False,29.463833333333334,-139,-2,1,260,249,11
BR1_2720357125,5,False,1,0,0,16061,201,52,6.8,True,5,True,0,1,0,15892,172,56,7.2,False,27.967316666666665,169,0,1,253,228,25
BR1_2731553672,2,False,1,0,0,14489,206,48,6.8,True,4,True,0,0,0,14719,205,48,6.6,False,26.78345,-230,-2,1,254,253,1
BR1_2711658882,4,True,0,0,0,15172,173,56,7.0,False,11,False,1,1,0,19414,215,54,7.4,True,27.906466666666667,-4242,-7,-1,229,269,-40
BR1_2710545829,4,False,1,1,0,15000,148,60,6.2,True,8,True,0,0,0,15529,156,39,6.8,False,25.6981,-529,-4,1,208,195,13
BR1_2722242090,9,True,0,0,0,17496,180,60,7.2,False,16,False,1,1,0,21991,209,44,7.2,True,29.2854,-4495,-7,-1,240,253,-13
BR1_2714355545,4,False,0,0,0,13969,132,52,6.2,False,7,True,0,0,0,16448,161,64,7.0,True,27.754416666666668,-2479,-3,0,184,225,-41
BR1_2730000784,8,True,0,1,0,15429,122,41,6.4,False,8,False,1,0,0,15977,140,48,6.0,True,27.42495,-548,0,-1,163,188,-25
BR1_2718909121,11,False,1,1,0,18709,158,56,7.2,True,9,True,0,0,0,18243,183,40,6.8,False,29.806416666666667,466,2,1,214,223,-9
BR1_2717620882,10,False,1,0,0,17750,129,44,6.8,False,13,True,0,0,1,20905,188,56,7.0,True,29.39056666666667,-3155,-3,1,173,244,-71
BR1_2728426371,6,True,0,1,0,18018,226,52,7.4,False,6,False,1,0,0,16553,188,52,6.6,True,29.8476,1465,0,-1,278,240,38
BR1_2716933462,4,True,1,0,0,14935,198,56,6.4,False,3,False,0,0,0,14497,205,48,6.8,True,27.0203,438,1,1,254,253,1
BR1_2731594299,3,True,0,0,0,15459,200,52,7.2,False,5,False,1,1,0,17051,214,68,7.6,True,28.325883333333334,-1592,-2,-1,252,282,-30
BR1_2725796092,7,False,0,0,0,14856,101,36,6.0,False,8,True,1,0,0,15021,129,36,6.2,True,25.58045,-165,-1,-1,137,165,-28
BR1_2725765201,7,True,1,0,0,16034,139,64,6.4,False,7,False,0,0,0,15467,155,52,6.4,True,25.5749,567,0,1,203,207,-4
BR1_2729004808,6,False,0,0,0,16641,187,56,7.0,False,7,True,0,1,1,18912,196,64,7.4,True,28.943283333333333,-2271,-1,0,243,260,-17
BR1_2724287210,5,True,1,0,0,16661,230,64,7.4,True,5,False,0,1,0,15433,173,60,7.6,False,28.270333333333333,1228,0,1,294,233,61
BR1_2724275316,8,True,0,1,0,17929,194,60,7.4,False,3,False,1,0,0,14611,161,53,6.6,True,29.211833333333335,3318,5,-1,254,214,40
BR1_2728457421,7,False,0,0,0,15739,167,60,6.6,False,5,True,1,1,1,16900,205,48,6.6,True,26.5929,-1161,2,-1,227,253,-26
BR1_2731170877,12,True,1,0,0,17658,129,56,7.2,True,3,False,0,1,0,14645,159,60,7.2,False,27.566033333333333,3013,9,1,185,219,-34
BR1_2730208839,2,False,0,1,0,14870,181,48,6.8,False,5,True,1,0,0,16854,226,60,7.0,True,29.9143,-1984,-3,-1,229,286,-57
BR1_2706574657,4,True,0,1,0,15164,159,52,6.8,False,6,False,1,0,0,14699,188,48,7.0,True,25.799,465,-2,-1,211,236,-25
BR1_2706554553,7,False,1,1,1,19446,212,56,7.8,True,8,True,0,0,0,16946,177,52,7.0,False,28.02255,2500,-1,1,268,229,39
BR1_2731591118,8,False,1,0,0,17157,198,36,6.8,True,8,True,0,0,0,17046,146,52,6.8,False,28.5491,111,0,1,234,198,36
BR1_2690228776,1,False,0,1,0,14147,166,56,6.6,False,8,True,1,0,0,17038,191,66,7.0,True,27.647566666666666,-2891,-7,-1,222,257,-35
BR1_2714403501,9,True,0,0,0,17047,166,40,6.2,True,7,False,1,0,0,14491,127,44,6.2,False,26.890083333333333,2556,2,-1,206,171,35
BR1_2724361043,15,False,0,1,1,21498,158,48,7.2,True,9,True,0,0,0,17009,152,48,6.6,False,29.984933333333334,4489,6,0,206,200,6
BR1_2728851054,4,False,0,1,0,16475,211,52,7.4,False,6,True,1,0,0,18263,251,64,7.4,True,29.06995,-1788,-2,-1,263,315,-52
BR1_2728872204,11,True,1,0,0,16453,139,42,6.2,True,4,False,0,0,0,14082,126,32,6.4,False,25.5403,2371,7,1,181,158,23
BR1_2731633849,7,False,0,0,0,16787,173,52,6.8,False,9,True,0,1,0,16926,139,47,6.6,True,26.604033333333334,-139,-2,0,225,186,39
BR1_2726388017,2,False,0,0,0,12406,144,48,6.4,False,8,True,0,1,0,16885,205,55,7.2,True,25.899783333333332,-4479,-6,0,192,260,-68
BR1_2731605025,3,True,0,0,0,14560,149,48,6.4,False,17,False,1,1,0,20904,240,48,8.0,True,28.761583333333334,-6344,-14,-1,197,288,-91
BR1_2713942753,3,False,0,0,0,13089,106,56,6.2,False,11,True,1,0,1,17241,158,48,6.8,True,27.360483333333335,-4152,-8,-1,162,206,-44
BR1_2712818312,6,False,0,0,0,16094,190,41,7.0,False,6,True,0,1,0,17379,205,62,7.2,True,29.499383333333334,-1285,0,0,231,267,-36
BR1_2730802436,16,True,0,0,1,20423,88,4,4.6,True,19,False,0,1,2,25464,164,52,6.8,False,29.387083333333333,-5041,-3,0,92,216,-124
BR1_2697040200,6,False,1,0,0,15959,158,48,6.8,False,8,True,0,0,0,17981,226,56,7.0,True,29.67985,-2022,-2,1,206,282,-76
BR1_2731556442,1,False,0,0,0,12612,148,40,6.2,True,8,True,1,0,0,14957,163,58,7.0,False,26.1735,-2345,-7,-1,188,221,-33
BR1_2731661800,6,False,0,1,0,15535,128,48,6.6,False,9,True,1,0,0,18036,210,48,7.0,True,29.896116666666668,-2501,-3,-1,176,258,-82
BR1_2699070455,6,False,0,0,0,16791,168,48,6.8,False,10,True,1,1,0,17986,174,56,7.6,True,27.929266666666667,-1195,-4,-1,216,230,-14
BR1_2713595299,5,False,0,1,0,16606,192,64,7.4,True,2,True,1,0,0,14328,150,68,6.8,False,29.329883333333335,2278,3,-1,256,218,38
BR1_2726230619,11,True,1,0,0,18483,173,52,7.4,True,4,False,0,0,0,14832,138,40,6.8,False,28.51245,3651,7,1,225,178,47
BR1_2722961057,5,True,0,0,0,14781,158,32,6.4,False,6,False,1,0,0,15901,169,40,7.0,True,28.212616666666666,-1120,-1,-1,190,209,-19
BR1_2731519181,7,False,0,0,0,15203,142,40,6.2,False,16,True,1,0,0,19050,160,44,6.6,True,27.456983333333334,-3847,-9,-1,182,204,-22
BR1_2730584999,7,False,1,1,0,17564,180,52,7.0,False,15,True,0,0,0,21105,215,68,7.8,True,28.691683333333334,-3541,-8,1,232,283,-51
BR1_2731664326,11,False,0,0,0,18072,171,54,7.4,True,2,True,0,0,0,13994,171,56,6.8,False,28.553066666666666,4078,9,0,225,227,-2
BR1_2731465100,7,True,0,0,0,16202,161,44,7.0,False,3,False,1,1,0,15196,163,72,7.2,True,28.5473,1006,4,-1,205,235,-30
BR1_2731605938,14,False,1,0,0,21802,246,69,7.6,True,2,True,0,0,0,12596,141,26,6.0,False,29.460766666666668,9206,12,1,315,167,148
BR1_2730932005,7,True,1,0,0,14422,129,28,6.8,False,9,False,0,0,0,17775,186,43,7.0,True,29.15515,-3353,-2,1,157,229,-72
BR1_2728013795,3,False,0,0,0,14094,160,48,6.8,False,8,True,1,0,0,17513,192,48,7.0,True,29.036216666666668,-3419,-5,-1,208,240,-32
BR1_2721735123,9,True,1,0,0,17304,180,51,7.4,True,3,False,0,1,0,14936,176,58,7.2,False,29.882316666666668,2368,6,1,231,234,-3
BR1_2697021587,6,True,1,0,0,16365,179,48,7.0,True,3,False,0,0,0,14017,153,64,6.6,False,25.023833333333332,2348,3,1,227,217,10
BR1_2728520881,10,True,1,0,0,17050,143,52,6.6,True,6,False,0,0,0,14974,143,44,6.4,False,26.8266,2076,4,1,195,187,8
BR1_2725243575,2,False,0,0,0,12025,123,52,6.2,False,4,True,1,0,0,14277,189,44,6.6,True,25.755366666666667,-2252,-2,-1,175,233,-58
BR1_2717920131,8,False,0,0,0,16167,167,44,6.8,False,9,True,1,1,0,18987,173,72,7.4,True,29.649366666666666,-2820,-1,-1,211,245,-34
BR1_2714950223,4,True,0,0,0,13601,132,40,6.2,False,5,False,1,0,0,15895,185,48,6.6,True,26.25225,-2294,-1,-1,172,233,-61
BR1_2721211348,5,False,0,0,0,13542,127,32,6.2,False,5,True,0,0,0,15492,171,52,6.4,True,25.26406666666667,-1950,0,0,159,223,-64
BR1_2720747522,10,False,1,0,0,17568,150,47,6.6,False,8,True,0,0,0,17177,192,45,6.8,True,28.780816666666666,391,2,1,197,237,-40
BR1_2720152872,6,True,0,0,1,16651,178,40,6.8,False,7,False,1,1,0,18877,184,51,7.0,True,28.082183333333333,-2226,-1,-1,218,235,-17
BR1_2731228684,9,False,1,0,0,16671,178,44,6.8,True,7,True,0,0,0,15906,162,40,7.0,False,28.806383333333333,765,2,1,222,202,20
BR1_2718796441,12,True,0,0,0,17877,197,48,7.0,False,5,False,1,0,0,15486,135,68,6.8,True,28.209883333333334,2391,7,-1,245,203,42
BR1_2688639529,6,False,1,0,0,15073,134,56,6.4,True,3,True,0,0,0,13768,183,36,6.2,False,25.218966666666667,1305,3,1,190,219,-29
BR1_2688515894,7,False,0,0,0,17962,234,64,7.4,True,4,True,1,0,0,15567,185,48,7.2,False,28.043583333333334,2395,3,-1,298,233,65
BR1_2728950204,6,False,0,0,0,14077,148,44,6.6,False,4,True,1,0,0,13899,183,48,6.6,True,27.347283333333333,178,2,-1,192,231,-39
BR1_2731163436,6,False,1,0,0,15866,153,44,7.0,False,10,True,0,1,0,18748,172,52,7.4,True,28.679483333333334,-2882,-4,1,197,224,-27
BR1_2731086651,10,True,0,1,0,17814,174,44,7.0,True,6,False,1,0,0,17209,179,72,7.2,False,28.100733333333334,605,4,-1,218,251,-33
BR1_2730827714,5,True,1,1,0,15702,182,60,7.0,False,1,False,0,0,0,15619,224,48,6.8,True,29.319933333333335,83,4,1,242,272,-30
BR1_2731575882,6,False,1,0,0,17101,207,76,7.2,True,2,True,0,1,0,14500,197,48,7.2,False,28.164866666666665,2601,4,1,283,245,38
BR1_2723340831,8,True,1,0,0,16435,191,48,7.0,True,4,False,0,1,0,15408,160,52,6.8,False,29.2344,1027,4,1,239,212,27
BR1_2727778023,7,True,0,0,0,16827,196,36,6.4,False,16,False,0,0,0,20811,205,48,7.2,True,29.815083333333334,-3984,-9,0,232,253,-21
BR1_2686104879,5,False,0,0,0,14671,185,56,6.8,False,5,True,0,1,0,15206,167,56,7.0,True,25.863666666666667,-535,0,0,241,223,18
BR1_2685502578,6,True,1,0,0,14872,156,52,6.8,False,6,False,0,1,0,15961,130,44,7.0,True,26.61395,-1089,0,1,208,174,34
BR1_2725029340,1,False,1,0,0,11967,146,30,6.6,False,10,True,0,0,0,16294,167,46,6.8,True,26.69015,-4327,-9,1,176,213,-37
BR1_2719804619,2,False,0,0,0,13209,125,64,6.6,True,7,True,1,0,0,17244,201,44,7.2,False,29.69275,-4035,-5,-1,189,245,-56
BR1_2726954281,4,False,0,0,0,13637,165,28,6.4,False,8,True,1,1,0,17264,191,76,7.0,True,25.688383333333334,-3627,-4,-1,193,267,-74
BR1_2698648877,10,False,1,0,0,17775,195,63,7.6,True,4,True,0,1,0,15181,153,52,7.0,False,29.55655,2594,6,1,258,205,53
BR1_2694297033,2,False,1,0,0,14566,186,50,7.0,True,3,True,0,1,0,14405,177,49,6.6,False,26.17415,161,-1,1,236,226,10
BR1_2731614599,3,False,0,0,0,12506,130,52,6.4,False,4,True,0,0,0,14927,210,40,6.8,True,26.18585,-2421,-1,0,182,250,-68
BR1_2693383638,7,False,1,1,0,14839,160,36,6.4,True,4,True,0,0,0,14206,147,40,6.8,False,25.43648333333333,633,3,1,196,187,9
BR1_2693361299,10,False,0,0,0,18143,176,36,6.6,False,13,True,0,0,0,19417,166,39,6.8,True,27.964016666666666,-1274,-3,0,212,205,7
BR1_2722921122,1,True,0,0,0,15333,241,44,6.8,False,4,False,0,1,0,14369,135,64,7.4,True,28.011533333333333,964,-3,0,285,199,86
BR1_2731120570,2,True,1,0,0,15991,212,48,7.2,False,7,False,0,1,0,17816,203,68,7.4,True,29.30815,-1825,-5,1,260,271,-11
BR1_2730987925,8,True,1,0,0,16201,129,52,6.2,False,7,False,0,1,0,17240,130,36,6.6,True,27.534033333333333,-1039,1,1,181,166,15
BR1_2730976810,5,False,0,1,0,16159,169,46,7.0,True,3,True,1,0,0,14536,161,66,7.2,False,29.2023,1623,2,-1,215,227,-12
BR1_2731420855,9,False,1,0,0,17507,193,48,7.2,True,4,True,0,1,0,15644,191,56,7.0,False,29.380216666666666,1863,5,1,241,247,-6
BR1_2709209810,2,False,0,0,0,12480,143,44,6.4,False,7,True,1,1,0,16238,178,64,7.0,True,26.182583333333334,-3758,-5,-1,187,242,-55
BR1_2698930041,3,False,1,0,0,12216,130,56,6.4,False,6,True,0,0,0,14824,141,44,6.8,True,26.2028,-2608,-3,1,186,185,1
BR1_2698900755,10,False,0,0,0,17758,177,36,7.0,False,12,True,1,0,0,18810,173,60,7.2,True,28.128,-1052,-2,-1,213,233,-20
BR1_2720674314,4,True,0,1,0,16918,206,44,7.0,False,4,False,1,0,0,16709,203,68,7.2,True,28.05645,209,0,-1,250,271,-21
BR1_2727163175,4,True,1,0,0,16843,204,52,7.4,True,4,False,0,0,0,14870,147,68,7.4,False,29.36385,1973,0,1,256,215,41
BR1_2730858909,5,True,1,0,0,14084,144,47,6.6,True,2,False,0,0,0,13817,181,48,6.8,False,26.50348333333333,267,3,1,191,229,-38
BR1_2699959586,11,False,1,0,0,16704,128,60,6.8,True,5,True,0,1,0,14890,180,48,6.4,False,25.60435,1814,6,1,188,228,-40
BR1_2730078325,8,False,1,0,0,17281,164,52,6.6,True,8,True,0,1,0,17073,151,51,6.8,False,27.742333333333335,208,0,1,216,202,14
BR1_2727916736,14,True,1,0,0,18428,158,36,6.6,True,5,False,0,0,0,14382,131,48,6.2,False,25.829633333333334,4046,9,1,194,179,15
BR1_2727475292,7,True,0,0,0,16279,173,39,7.0,False,7,False,1,0,0,16407,199,57,7.0,True,27.78248333333333,-128,0,-1,212,256,-44
BR1_2726946738,7,True,1,0,0,14893,141,56,5.4,False,6,False,0,0,1,16530,178,51,6.8,True,26.764866666666666,-1637,1,1,197,229,-32
BR1_2731610918,6,False,1,0,0,14079,150,16,6.2,False,8,True,0,1,0,16313,155,52,6.4,True,26.28505,-2234,-2,1,166,207,-41
BR1_2727502459,3,False,0,1,0,13848,150,48,6.2,False,5,True,1,0,0,16285,224,40,7.0,True,26.696366666666666,-2437,-2,-1,198,264,-66
BR1_2729448405,11,False,1,0,0,17613,124,42,6.6,False,14,True,0,0,0,18865,174,33,6.4,True,28.677216666666666,-1252,-3,1,166,207,-41
BR1_2725689123,4,False,0,0,0,14600,143,44,6.4,False,9,True,1,0,0,16750,188,57,7.0,True,25.081383333333335,-2150,-5,-1,187,245,-58
BR1_2713434279,4,True,1,0,0,14881,157,56,6.8,False,3,False,0,1,1,17314,199,48,7.2,True,28.727366666666665,-2433,1,1,213,247,-34
BR1_2700981351,6,False,1,0,0,15428,141,52,7.2,False,6,True,0,1,0,17094,220,56,7.2,True,28.555233333333334,-1666,0,1,193,276,-83
BR1_2730342146,10,True,0,1,0,18491,182,56,7.2,True,6,False,1,0,0,17202,222,56,7.2,False,29.162583333333334,1289,4,-1,238,278,-40
BR1_2722491177,8,False,0,0,0,18453,214,48,7.2,False,4,True,1,1,0,16438,190,64,7.2,True,27.526583333333335,2015,4,-1,262,254,8
BR1_2722368246,4,True,1,0,0,14216,154,52,6.4,False,4,False,0,0,0,15059,173,48,6.8,True,27.377033333333333,-843,0,1,206,221,-15
BR1_2701770138,7,False,1,0,0,16058,175,48,6.6,True,4,True,0,0,0,15058,180,44,6.4,False,26.275083333333335,1000,3,1,223,224,-1
BR1_2719379555,4,True,1,0,0,16246,198,48,7.2,True,5,False,0,1,0,14791,151,48,7.4,False,28.240633333333335,1455,-1,1,246,199,47
BR1_2691151810,15,True,0,0,0,20388,163,44,7.0,True,10,False,1,0,0,17900,140,48,6.6,False,28.95325,2488,5,-1,207,188,19
BR1_2701878971,7,False,1,0,0,15778,160,56,6.6,True,8,True,0,0,0,14856,131,36,6.2,False,27.3103,922,-1,1,216,167,49
BR1_2727227126,7,True,0,0,0,14002,126,36,6.0,False,17,False,1,0,0,18773,178,36,6.8,True,26.210283333333333,-4771,-10,-1,162,214,-52
BR1_2730589512,12,True,0,0,0,16843,159,20,6.2,True,4,False,1,1,0,14075,114,52,6.4,False,25.650466666666667,2768,8,-1,179,166,13
BR1_2720828814,10,True,0,0,0,17752,159,48,6.8,True,5,False,1,1,0,16065,183,44,6.8,False,28.263366666666666,1687,5,-1,207,227,-20
BR1_2727117109,7,True,0,1,0,16227,192,48,7.2,False,2,False,1,0,0,13991,182,56,6.6,True,25.897266666666667,2236,5,-1,240,238,2
BR1_2730934270,15,True,1,0,0,20544,180,60,7.4,True,7,False,0,0,0,16717,181,48,7.2,False,29.446483333333333,3827,8,1,240,229,11
BR1_2728597322,6,False,0,1,0,16067,172,48,6.8,False,5,True,1,0,0,16265,152,64,6.8,True,28.091833333333334,-198,1,-1,220,216,4
BR1_2727086317,11,True,1,1,0,19286,194,68,7.8,True,8,False,0,0,0,16861,192,39,7.4,False,28.064583333333335,2425,3,1,262,231,31
BR1_2715366341,7,False,1,0,0,14405,134,44,6.6,True,6,True,0,0,0,14535,162,40,6.6,False,26.984783333333333,-130,1,1,178,202,-24
BR1_2673804993,4,True,0,0,0,13678,172,32,6.8,False,8,False,1,0,0,16673,148,64,6.6,True,25.078733333333332,-2995,-4,-1,204,212,-8
BR1_2673328572,10,True,1,1,0,17141,151,40,6.8,True,5,False,0,0,0,14254,146,40,6.4,False,25.63296666666667,2887,5,1,191,186,5
BR1_2729851706,4,True,1,0,0,14524,168,48,7.2,True,3,False,0,0,0,13776,184,51,6.6,False,26.64695,748,1,1,216,235,-19
BR1_2729671921,6,False,0,0,0,13605,118,36,6.4,False,12,True,1,0,0,17767,169,57,6.8,True,26.924033333333334,-4162,-6,-1,154,226,-72
BR1_2676637916,10,True,0,1,0,19552,234,64,7.6,True,3,False,1,0,0,15279,189,40,7.2,False,29.75225,4273,7,-1,298,229,69
BR1_2676532993,8,True,1,0,0,18088,193,59,7.8,True,5,False,0,0,0,15336,192,44,7.4,False,29.55555,2752,3,1,252,236,16
BR1_2701736606,3,True,1,0,0,13917,155,48,6.4,True,3,False,0,0,0,13095,156,44,6.4,False,26.994416666666666,822,0,1,203,200,3
BR1_2729730903,9,False,1,0,0,18562,211,72,7.4,False,5,True,0,0,0,15727,176,48,7.2,True,28.8908,2835,4,1,283,224,59
BR1_2729109773,7,True,1,1,0,16716,150,67,7.2,True,8,False,0,0,0,16590,168,44,6.8,False,28.876266666666666,126,-1,1,217,212,5
BR1_2731490529,12,True,1,0,0,18886,205,47,7.4,True,4,False,0,0,0,15765,201,64,7.2,False,27.712116666666667,3121,8,1,252,265,-13
BR1_2731459661,7,True,0,0,0,15768,176,44,6.8,True,5,False,0,0,0,15341,175,54,6.8,False,25.958466666666666,427,2,0,220,229,-9
BR1_2728546802,5,True,0,1,0,18231,229,66,7.6,True,7,False,1,0,0,17003,203,56,7.4,False,27.644816666666667,1228,-2,-1,295,259,36
BR1_2725151657,4,False,0,1,0,16284,184,40,7.2,False,7,True,1,0,1,19007,199,80,7.4,True,28.9651,-2723,-3,-1,224,279,-55
BR1_2730216109,5,True,1,0,0,15967,192,52,7.2,True,3,False,0,0,0,15177,177,48,7.2,False,29.877783333333333,790,2,1,244,225,19
BR1_2703872704,3,True,1,0,0,14370,154,48,6.6,True,6,False,0,0,0,12110,95,39,5.6,False,25.389616666666665,2260,-3,1,202,134,68
BR1_2729526432,11,False,0,1,0,18440,140,49,7.2,True,6,True,1,0,0,16551,175,58,7.0,False,27.751833333333334,1889,5,-1,189,233,-44
BR1_2728217616,4,True,0,0,0,13801,119,48,6.0,False,5,False,1,0,0,16592,185,48,7.0,True,28.272566666666666,-2791,-1,-1,167,233,-66
BR1_2729281182,1,False,0,0,0,12624,152,44,6.8,False,1,True,0,0,0,13180,194,36,6.6,True,25.548683333333333,-556,0,0,196,230,-34
BR1_2728298791,3,False,0,0,0,12895,145,30,6.0,False,12,True,1,1,0,18138,144,49,6.6,True,27.130433333333333,-5243,-9,-1,175,193,-18
BR1_2728004107,5,False,0,0,0,16669,158,52,6.8,False,12,True,1,1,0,18152,155,56,7.0,True,29.707566666666665,-1483,-7,-1,210,211,-1
BR1_2696528352,9,True,1,0,0,16076,152,44,6.6,False,1,False,0,1,0,14639,191,48,6.6,True,29.702733333333335,1437,8,1,196,239,-43
BR1_2731379490,5,False,0,0,0,17296,217,64,7.4,True,8,True,1,1,1,18698,202,56,7.6,False,28.412666666666667,-1402,-3,-1,281,258,23
BR1_2726765431,6,False,0,1,0,16146,150,52,7.0,False,9,True,1,0,1,19700,160,64,7.2,True,28.948366666666665,-3554,-3,-1,202,224,-22
BR1_2699811243,4,True,0,0,0,14224,163,40,6.8,False,8,False,1,0,0,15109,182,44,7.0,True,26.575383333333335,-885,-4,-1,203,226,-23
BR1_2709842327,10,True,0,0,0,17806,157,41,6.8,False,11,False,1,1,0,20474,201,68,7.8,True,29.139483333333335,-2668,-1,-1,198,269,-71
BR1_2709738537,4,False,0,0,0,13427,134,60,6.0,False,9,True,1,1,0,16073,149,52,6.6,True,25.504916666666666,-2646,-5,-1,194,201,-7
BR1_2722668709,5,True,0,0,0,15148,170,52,7.2,False,4,False,1,0,0,16090,215,60,7.6,True,29.470083333333335,-942,1,-1,222,275,-53
BR1_2722656308,8,False,0,0,0,16503,163,44,7.0,False,10,True,1,0,0,18201,215,40,6.8,True,27.4706,-1698,-2,-1,207,255,-48
BR1_2731418027,9,False,0,0,0,16982,193,47,7.2,True,6,True,0,0,0,15307,168,36,6.8,False,25.680833333333332,1675,3,0,240,204,36
BR1_2731414067,4,False,1,0,0,13098,149,40,6.4,False,7,True,0,1,0,16195,183,48,6.8,True,27.179116666666665,-3097,-3,1,189,231,-42
BR1_2731065546,5,True,0,1,0,17335,200,52,7.0,True,2,False,1,0,0,13979,173,64,7.0,False,28.5933,3356,3,-1,252,237,15
BR1_2674612522,7,True,0,1,0,16539,155,52,6.6,True,5,False,1,0,1,16146,195,40,6.8,False,29.0753,393,2,-1,207,235,-28
BR1_2726747000,4,True,0,1,0,14736,190,48,6.8,False,4,False,1,0,0,14833,171,60,6.8,True,27.156683333333334,-97,0,-1,238,231,7
BR1_2726730988,5,False,0,1,0,14797,125,40,6.2,False,8,True,1,0,0,14668,141,42,6.8,True,27.21463333333333,129,-3,-1,165,183,-18
BR1_2730782592,7,True,1,0,0,14801,166,48,6.6,True,7,False,0,1,0,14885,174,28,6.4,False,26.4557,-84,0,1,214,202,12
BR1_2730729112,12,False,0,0,0,17185,104,36,6.0,False,11,True,1,1,0,17533,121,63,6.2,True,27.199083333333334,-348,1,-1,140,184,-44
BR1_2727007113,8,True,0,0,0,16271,176,40,6.8,True,3,False,0,0,0,14086,183,48,6.4,False,26.94558333333333,2185,5,0,216,231,-15
BR1_2712619369,10,True,1,0,0,18665,208,56,7.0,True,5,False,0,0,0,14248,122,52,6.2,False,25.931216666666668,4417,5,1,264,174,90
BR1_2707597663,7,False,1,0,0,15618,167,48,6.6,True,6,True,0,0,0,15179,168,47,6.6,False,26.17385,439,1,1,215,215,0
BR1_2726106514,8,True,0,0,0,16469,155,46,6.8,False,6,False,0,0,0,16768,178,66,7.2,True,29.92428333333333,-299,2,0,201,244,-43
BR1_2706249182,5,True,1,1,0,15968,195,52,7.2,True,4,False,0,0,0,14725,177,40,7.2,False,29.078166666666668,1243,1,1,247,217,30
BR1_2693316466,4,True,0,1,0,14613,161,56,7.0,True,3,False,1,0,0,13341,148,56,6.6,False,25.136033333333334,1272,1,-1,217,204,13
BR1_2730198181,7,False,1,0,0,16779,173,60,6.8,True,6,True,0,0,0,17424,232,52,7.2,False,28.7839,-645,1,1,233,284,-51
BR1_2730107498,3,False,0,1,0,15382,192,56,7.2,False,3,True,1,0,0,15050,202,52,7.2,True,29.2129,332,0,-1,248,254,-6
BR1_2731303873,8,True,0,0,0,17105,165,44,7.0,True,7,False,0,1,0,16536,190,48,7.2,False,27.762566666666668,569,1,0,209,238,-29
BR1_2698209128,4,True,0,0,0,15663,205,64,7.0,False,6,False,1,0,1,18801,213,60,7.2,True,27.556533333333334,-3138,-2,-1,269,273,-4
BR1_2690409985,10,True,1,0,0,18188,218,40,7.2,True,7,False,0,0,0,17134,179,48,7.0,False,27.845483333333334,1054,3,1,258,227,31
BR1_2680234694,4,True,1,0,0,13918,164,44,6.8,False,2,False,0,0,0,14008,178,52,7.0,True,25.455016666666666,-90,2,1,208,230,-22
BR1_2717627956,11,True,1,0,0,15502,127,36,6.2,True,5,False,0,0,0,14108,123,40,6.0,False,26.378966666666667,1394,6,1,163,163,0
BR1_2731035490,4,True,0,1,0,13630,135,36,5.6,False,2,False,1,0,0,14246,181,62,6.8,True,27.33106666666667,-616,2,-1,171,243,-72
BR1_2731022322,5,False,1,0,0,15652,189,40,7.2,True,3,True,0,1,0,14595,151,52,7.2,False,27.62165,1057,2,1,229,203,26
BR1_2731001729,3,False,0,0,0,12829,164,60,5.8,False,10,True,1,0,0,16916,174,52,6.6,True,25.0914,-4087,-7,-1,224,226,-2
BR1_2731069248,5,False,1,0,0,14896,197,52,6.8,True,5,True,0,0,0,14644,195,48,6.8,False,26.50225,252,0,1,249,243,6
BR1_2727477523,7,False,1,0,0,14738,178,52,6.8,True,8,True,0,0,0,14780,118,40,6.2,False,25.292933333333334,-42,-1,1,230,158,72
BR1_2723007019,6,False,1,1,0,14652,138,72,6.4,False,10,True,0,0,0,17493,177,40,6.6,True,26.198666666666668,-2841,-4,1,210,217,-7
BR1_2701090910,8,True,0,0,0,16902,192,28,7.0,True,3,False,1,0,0,13018,112,48,6.2,False,27.9881,3884,5,-1,220,160,60
BR1_2701060969,5,True,0,0,0,14686,179,24,6.4,False,7,False,1,0,0,15898,168,44,6.8,True,26.041433333333334,-1212,-2,-1,203,212,-9
BR1_2719059422,10,True,1,0,0,17049,176,36,7.2,True,0,False,0,0,0,13536,195,48,7.0,False,27.823666666666668,3513,10,1,212,243,-31
BR1_2699482265,6,True,0,0,0,17184,175,48,7.0,False,5,False,0,1,0,17464,250,48,7.4,True,28.011666666666667,-280,1,0,223,298,-75
BR1_2699386557,0,False,1,0,0,10803,119,44,6.0,False,6,True,0,0,0,15775,188,58,7.0,True,25.505133333333333,-4972,-6,1,163,246,-83
BR1_2699276104,9,False,1,0,0,17245,155,40,6.8,False,12,True,0,0,0,19737,169,68,6.6,True,28.848833333333335,-2492,-3,1,195,237,-42
BR1_2730230062,6,False,0,0,0,16726,160,39,7.2,False,9,True,0,0,0,17297,193,48,7.4,True,29.400916666666667,-571,-3,0,199,241,-42
BR1_2731632128,2,False,0,0,0,14538,201,48,7.0,False,7,True,1,1,0,17719,219,64,7.6,True,29.985366666666668,-3181,-5,-1,249,283,-34
BR1_2731571171,11,True,0,0,0,17966,186,68,7.4,False,7,False,1,0,0,18274,217,52,7.2,True,28.587116666666667,-308,4,-1,254,269,-15
BR1_2701972159,4,True,1,0,0,13511,139,47,6.4,True,5,False,0,0,0,13632,143,28,6.2,False,25.30453333333333,-121,-1,1,186,171,15
BR1_2731637355,2,True,0,0,0,13034,208,28,6.4,False,10,False,1,0,0,17581,194,52,6.8,True,25.954183333333333,-4547,-8,-1,236,246,-10
BR1_2722727231,8,True,1,0,0,16280,186,48,7.2,True,3,False,0,0,0,14243,158,52,6.6,False,28.4874,2037,5,1,234,210,24
BR1_2721112173,6,True,0,1,0,17168,189,64,7.2,True,4,False,0,0,0,15440,171,40,7.0,False,28.82755,1728,2,0,253,211,42
BR1_2727681900,8,True,0,0,0,17295,193,44,7.0,False,5,False,1,0,0,15637,163,44,6.6,True,27.897283333333334,1658,3,-1,237,207,30
BR1_2727234415,10,False,1,0,0,18519,188,60,7.4,False,8,True,0,0,0,17824,190,44,7.0,True,29.519283333333334,695,2,1,248,234,14
BR1_2723428283,8,False,1,0,0,15933,133,48,6.2,False,7,True,0,1,0,16171,156,48,6.4,True,26.5168,-238,1,1,181,204,-23
BR1_2720106137,7,False,0,0,0,16999,183,40,7.0,True,4,True,1,0,0,14153,153,40,6.8,False,29.051333333333332,2846,3,-1,223,193,30
BR1_2720091239,7,True,1,0,0,16938,171,54,7.0,False,6,False,0,0,0,15495,162,62,7.2,True,29.7369,1443,1,1,225,224,1
BR1_2730323422,11,False,0,0,0,17610,155,64,7.0,True,9,True,1,0,0,17190,192,36,6.4,False,25.407983333333334,420,2,-1,219,228,-9
BR1_2731215246,6,True,1,0,0,16315,178,52,6.8,False,5,False,0,0,0,16528,211,52,7.2,True,28.5702,-213,1,1,230,263,-33
BR1_2722367149,3,False,1,1,0,17106,246,60,7.4,True,7,True,0,0,0,16924,198,56,7.4,False,29.01985,182,-4,1,306,254,52
BR1_2700426759,2,False,0,0,0,14883,231,46,7.2,False,5,True,1,0,0,16039,213,64,7.6,True,29.41375,-1156,-3,-1,277,277,0
BR1_2699116371,5,False,0,0,0,14415,156,44,6.8,False,6,True,1,0,0,14221,124,46,6.6,True,26.263533333333335,194,-1,-1,200,170,30
BR1_2700262631,10,True,1,1,0,17803,201,40,6.6,True,5,False,0,0,0,15197,158,48,6.4,False,25.1548,2606,5,1,241,206,35
BR1_2699979884,1,True,0,0,0,13811,192,48,7.0,False,6,False,1,0,0,16731,159,64,7.4,True,27.928616666666667,-2920,-5,-1,240,223,17
BR1_2731222476,11,False,0,0,0,17941,176,60,7.2,False,12,True,0,0,0,19292,232,40,7.0,True,28.477416666666667,-1351,-1,0,236,272,-36
BR1_2698656584,4,False,0,0,0,14825,155,44,6.8,False,7,True,0,1,0,16734,201,51,7.0,True,27.558366666666668,-1909,-3,0,199,252,-53
BR1_2698637287,12,True,0,0,0,18027,144,44,6.4,True,5,False,1,0,0,15841,166,52,6.6,False,25.145066666666665,2186,7,-1,188,218,-30
BR1_2711979403,5,False,0,1,0,15812,204,44,7.0,True,7,True,1,0,0,14335,144,56,6.6,False,27.144666666666666,1477,-2,-1,248,200,48
BR1_2710482352,7,False,0,1,0,17170,188,59,7.4,False,7,True,1,0,0,16933,203,60,7.6,True,27.59785,237,0,-1,247,263,-16
BR1_2731140852,3,False,1,0,0,13458,116,52,6.8,False,8,True,0,1,1,19246,166,61,7.2,True,28.49745,-5788,-5,1,168,227,-59
BR1_2681924691,6,True,1,0,0,14547,188,44,7.0,True,6,False,0,0,0,15359,146,44,6.8,False,26.737666666666666,-812,0,1,232,190,42
BR1_2728899723,6,True,0,1,0,15549,174,49,7.2,False,5,False,0,0,0,15803,182,43,7.4,True,28.9402,-254,1,0,223,225,-2
BR1_2730429986,8,False,0,0,0,18016,171,48,6.8,False,16,True,1,0,0,21289,168,52,7.4,True,27.725716666666667,-3273,-8,-1,219,220,-1
BR1_2728349950,5,False,1,0,0,15388,128,48,6.8,True,7,True,0,1,0,17349,195,40,7.2,False,29.8237,-1961,-2,1,176,235,-59
BR1_2731571962,4,False,0,0,0,15518,191,56,7.4,False,6,True,0,0,0,16025,179,56,7.2,True,28.445683333333335,-507,-2,0,247,235,12
BR1_2731444899,6,True,1,0,0,15804,193,60,6.8,True,1,False,0,1,0,12645,143,48,6.8,False,26.600466666666666,3159,5,1,253,191,62
BR1_2731437386,6,False,1,1,0,17173,190,68,7.2,False,5,True,0,0,0,15302,208,36,7.0,True,28.025266666666667,1871,1,1,258,244,14
BR1_2730306380,5,True,0,0,0,15915,183,48,7.0,False,4,False,1,1,0,15548,181,48,6.8,True,28.215883333333334,367,1,-1,231,229,2
BR1_2729891095,10,True,1,0,0,17113,183,51,7.0,True,7,False,0,0,0,16194,144,64,7.0,False,29.585933333333333,919,3,1,234,208,26
BR1_2701899231,6,False,0,0,0,15911,182,39,6.6,True,7,True,0,0,0,14092,130,28,6.6,False,25.4718,1819,-1,0,221,158,63
BR1_2697692748,0,False,0,0,0,12011,146,44,6.2,False,6,True,0,1,0,15489,185,44,6.8,True,26.432683333333333,-3478,-6,0,190,229,-39
BR1_2725691908,4,False,0,0,0,13987,184,48,6.6,False,9,True,1,1,0,16896,163,52,7.0,True,27.403,-2909,-5,-1,232,215,17
BR1_2725613987,8,True,1,0,0,17289,204,44,7.4,False,4,False,0,0,0,15150,173,44,6.6,True,29.540416666666665,2139,4,1,248,217,31
BR1_2730543000,6,False,1,0,0,16513,191,60,7.6,False,6,True,0,1,0,17650,231,47,7.2,True,29.62548333333333,-1137,0,1,251,278,-27
BR1_2730138370,7,False,1,0,0,15896,181,48,6.6,True,4,True,0,0,0,13463,145,38,6.4,False,25.887516666666667,2433,3,1,229,183,46
BR1_2729459821,14,False,0,0,0,17615,180,36,6.2,True,5,True,1,0,0,15407,129,40,5.8,False,26.482916666666668,2208,9,-1,216,169,47
BR1_2699684202,10,True,1,0,0,18608,212,54,7.4,True,4,False,0,0,0,15230,168,54,7.0,False,28.64143333333333,3378,6,1,266,222,44
BR1_2706735766,5,True,0,0,0,15704,186,40,7.0,True,6,False,0,0,0,16643,189,64,7.2,False,29.04445,-939,-1,0,226,253,-27
BR1_2718702487,8,False,0,1,0,15928,135,40,6.2,True,12,True,1,0,0,17934,183,52,6.8,False,27.021583333333332,-2006,-4,-1,175,235,-60
BR1_2720310084,11,True,1,0,0,18158,175,64,7.4,True,4,False,0,0,0,15215,160,40,6.8,False,28.597283333333333,2943,7,1,239,200,39
BR1_2719572753,3,True,1,0,0,14700,186,60,6.8,False,2,False,0,1,0,14024,172,44,6.4,True,25.4543,676,1,1,246,216,30
BR1_2712170638,6,True,0,0,0,17993,208,68,7.4,False,7,False,1,1,0,17450,154,60,7.0,True,28.42165,543,-1,-1,276,214,62
BR1_2711588401,5,False,0,0,0,14213,156,24,6.4,False,7,True,1,0,0,14199,131,44,6.4,True,26.6099,14,-2,-1,180,175,5
BR1_2709762416,8,True,0,1,0,16400,166,56,7.0,False,7,False,1,0,0,16961,194,48,7.6,True,29.962883333333334,-561,1,-1,222,242,-20
BR1_2683769047,4,False,1,0,0,14762,157,44,6.6,True,3,True,0,0,0,13551,148,60,6.8,False,26.199066666666667,1211,1,1,201,208,-7
BR1_2680663301,1,False,0,0,0,11517,137,32,6.2,False,12,True,1,0,0,17268,192,48,7.0,True,26.121116666666666,-5751,-11,-1,169,240,-71
BR1_2726882332,11,True,0,1,0,15774,132,44,6.6,True,6,False,1,0,0,14073,151,48,6.2,False,25.7831,1701,5,-1,176,199,-23
BR1_2723838862,7,False,1,0,0,15988,187,56,7.0,False,11,True,0,0,0,17786,174,62,7.4,True,29.4375,-1798,-4,1,243,236,7
BR1_2721102164,6,True,0,0,0,16553,187,56,7.2,False,10,False,0,0,0,18420,202,60,7.6,True,29.16425,-1867,-4,0,243,262,-19
BR1_2721073174,6,False,0,0,0,16171,196,60,7.4,True,6,True,1,1,0,16905,200,44,7.2,False,29.198816666666666,-734,0,-1,256,244,12
BR1_2731190956,4,False,1,0,0,15449,197,60,7.2,True,1,True,0,0,0,14549,212,48,7.2,False,29.063483333333334,900,3,1,257,260,-3
BR1_2731670328,6,True,1,0,0,15287,161,32,6.6,True,4,False,0,1,0,14008,155,56,6.6,False,27.2757,1279,2,1,193,211,-18
BR1_2731639775,9,False,1,0,0,17390,196,43,6.8,True,11,True,0,0,0,19069,183,44,6.8,False,28.156466666666667,-1679,-2,1,239,227,12
BR1_2731582071,4,True,0,0,0,15392,173,44,6.2,False,12,False,1,0,0,20688,239,48,7.2,True,29.494983333333334,-5296,-8,-1,217,287,-70
BR1_2693919824,2,False,1,0,0,13801,175,36,6.8,False,9,True,0,0,0,17701,187,36,7.0,True,28.96765,-3900,-7,1,211,223,-12
BR1_2718796595,7,True,1,0,0,16554,202,47,7.2,False,6,False,0,1,0,17882,167,76,7.4,True,29.62615,-1328,1,1,249,243,6
BR1_2728598447,4,True,0,0,0,13797,143,56,7.0,False,2,False,0,0,0,14474,211,48,6.8,True,26.11405,-677,2,0,199,259,-60
BR1_2727434153,9,True,0,0,0,17300,204,24,6.6,True,3,False,0,0,0,14458,171,44,6.8,False,29.50695,2842,6,0,228,215,13
BR1_2709034218,7,False,0,1,0,15820,136,32,7.0,False,9,True,1,0,0,17215,144,60,7.2,True,28.241016666666667,-1395,-2,-1,168,204,-36
BR1_2722183173,8,True,1,0,0,16836,135,28,6.4,True,7,False,0,0,0,15034,148,48,6.2,False,26.815816666666667,1802,1,1,163,196,-33
BR1_2714385237,5,False,1,0,0,14674,158,64,6.8,True,5,True,0,0,0,13643,119,32,6.4,False,25.17795,1031,0,1,222,151,71
BR1_2710583809,8,False,0,0,0,15956,189,40,7.2,True,7,True,0,0,0,14795,138,48,6.2,False,27.375233333333334,1161,1,0,229,186,43
BR1_2730781532,15,True,1,1,0,21551,196,56,7.4,True,5,False,0,0,0,16175,173,52,6.8,False,27.672516666666667,5376,10,1,252,225,27
BR1_2730220920,8,False,1,0,0,17024,183,44,7.0,False,13,True,0,0,0,17869,130,44,7.0,True,28.662066666666668,-845,-5,1,227,174,53
BR1_2725096438,11,False,1,0,0,17868,148,48,6.8,True,8,True,0,0,0,16232,154,44,6.6,False,29.395416666666666,1636,3,1,196,198,-2
BR1_2724596901,5,False,0,0,0,14117,134,40,6.0,False,9,True,1,1,0,15929,153,56,6.6,True,26.429983333333332,-1812,-4,-1,174,209,-35
BR1_2730304243,4,False,1,0,0,15878,196,39,7.2,False,6,True,0,1,0,17474,212,62,7.2,True,28.560483333333334,-1596,-2,1,235,274,-39
BR1_2729116786,4,False,0,0,0,17609,215,44,7.2,False,13,True,1,1,0,20575,245,72,7.6,True,28.658266666666666,-2966,-9,-1,259,317,-58
BR1_2719920064,8,False,1,0,0,17103,176,52,6.8,True,6,True,0,0,0,15735,198,43,6.8,False,27.565883333333332,1368,2,1,228,241,-13
BR1_2729913765,8,True,1,0,0,17121,187,56,7.0,False,7,False,0,0,0,17314,205,52,7.4,True,28.691716666666668,-193,1,1,243,257,-14
BR1_2729902204,7,False,0,0,0,14819,134,40,6.0,False,16,True,1,0,0,18658,155,52,6.8,True,27.420466666666666,-3839,-9,-1,174,207,-33
BR1_2730254604,5,False,1,0,0,14538,147,52,6.2,False,11,True,0,1,1,18709,167,44,6.4,True,27.1132,-4171,-6,1,199,211,-12
BR1_2731652653,3,False,0,0,0,13927,153,48,6.6,True,8,True,1,0,0,17207,186,44,7.0,False,29.33695,-3280,-5,-1,201,230,-29
BR1_2731369211,14,True,0,0,0,19227,145,48,6.6,True,3,False,0,0,0,13321,150,32,5.8,False,25.887483333333332,5906,11,0,193,182,11
BR1_2730675396,9,True,0,0,0,16592,158,36,7.0,False,6,False,1,0,0,16366,168,56,6.4,True,28.979233333333333,226,3,-1,194,224,-30
BR1_2715212732,3,False,0,0,0,15112,166,60,7.4,False,4,True,1,0,1,17807,229,79,7.2,True,29.62245,-2695,-1,-1,226,308,-82
BR1_2696622821,11,False,1,0,0,18251,163,58,6.8,True,5,True,0,1,0,15561,157,48,6.8,False,27.985383333333335,2690,6,1,221,205,16
BR1_2727531294,6,True,0,0,0,15609,177,52,6.8,True,6,False,1,1,0,14265,146,52,6.8,False,26.553083333333333,1344,0,-1,229,198,31
BR1_2730677920,3,False,1,1,0,14799,179,52,7.0,True,7,True,0,0,0,15974,188,60,6.8,False,25.498516666666667,-1175,-4,1,231,248,-17
BR1_2727998546,2,True,0,1,0,13000,154,36,6.6,False,9,False,1,0,0,16046,159,44,7.2,True,27.037516666666665,-3046,-7,-1,190,203,-13
BR1_2722821076,5,True,1,0,0,16018,200,60,6.8,True,3,False,0,0,0,13912,170,52,6.4,False,26.0756,2106,2,1,260,222,38
BR1_2730294414,12,True,0,1,0,17930,165,52,6.6,True,2,False,1,0,0,12383,131,48,6.2,False,25.179466666666666,5547,10,-1,217,179,38
BR1_2730813182,3,False,0,1,0,14624,171,56,6.6,False,5,True,1,0,0,15984,201,60,7.2,True,26.1208,-1360,-2,-1,227,261,-34
BR1_2730787518,2,False,0,0,0,13382,159,44,6.6,False,7,True,1,1,0,17318,201,60,6.6,True,26.65615,-3936,-5,-1,203,261,-58
BR1_2731039504,10,True,0,1,0,17597,182,44,7.0,False,6,False,1,0,0,17046,189,52,7.2,True,28.254533333333335,551,4,-1,226,241,-15
BR1_2707668338,13,False,0,0,0,18679,160,40,7.0,True,14,True,1,1,0,19495,184,64,7.4,False,28.08825,-816,-1,-1,200,248,-48
BR1_2704593954,9,True,1,0,0,16139,152,40,6.6,False,11,False,0,1,0,17948,153,56,6.6,True,27.467883333333333,-1809,-2,1,192,209,-17
BR1_2729793665,3,True,0,0,0,16568,237,74,7.2,False,6,False,1,1,1,17135,185,68,7.0,True,29.850533333333335,-567,-3,-1,311,253,58
BR1_2729775768,9,False,0,1,0,15297,154,24,6.4,True,9,True,0,0,0,15442,160,36,6.4,False,27.305183333333332,-145,0,0,178,196,-18
BR1_2729757512,7,False,0,1,0,15339,178,48,7.2,False,5,True,1,0,0,16531,199,59,7.0,True,29.3208,-1192,2,-1,226,258,-32
BR1_2731211945,9,True,0,0,0,18612,199,48,7.2,True,2,False,0,0,0,14589,165,56,6.8,False,29.63625,4023,7,0,247,221,26
BR1_2723173322,7,False,0,0,0,16416,160,56,6.6,True,6,True,1,0,0,14015,156,36,6.4,False,27.454666666666668,2401,1,-1,216,192,24
BR1_2731087961,13,True,0,0,0,19376,161,48,7.4,True,7,False,1,0,1,18269,170,56,7.0,False,27.840466666666668,1107,6,-1,209,226,-17
BR1_2719538647,13,True,1,0,0,18581,151,32,6.0,False,12,False,0,0,0,19470,151,44,6.4,True,28.15523333333333,-889,1,1,183,195,-12
BR1_2731617218,13,True,0,0,0,20963,202,44,6.8,True,15,False,1,0,0,19248,166,40,6.8,False,29.652666666666665,1715,-2,-1,246,206,40
BR1_2726060369,6,True,0,1,0,15423,145,48,6.2,False,6,False,1,0,0,14597,148,52,6.2,True,25.405,826,0,-1,193,200,-7
BR1_2731682602,11,True,0,0,0,18226,191,40,7.0,True,10,False,0,1,0,18034,188,47,7.0,False,28.176783333333333,192,1,0,231,235,-4
BR1_2730391538,4,True,0,0,0,14177,161,60,6.6,False,6,False,1,0,0,14659,197,44,6.6,True,27.131566666666668,-482,-2,-1,221,241,-20
BR1_2728491745,6,False,0,0,0,16035,182,40,6.4,False,10,True,1,0,1,17852,195,48,6.6,True,27.113566666666667,-1817,-4,-1,222,243,-21
BR1_2721581148,4,True,1,1,0,13780,138,60,6.6,True,4,False,0,0,0,14467,157,48,6.8,False,26.03625,-687,0,1,198,205,-7
BR1_2731598549,4,False,0,1,0,14478,201,44,7.0,False,6,True,1,0,0,14577,160,44,6.6,True,26.602533333333334,-99,-2,-1,245,204,41
BR1_2731443713,8,True,1,1,0,18167,216,56,7.6,False,6,False,0,0,0,17530,201,68,7.0,True,28.835183333333333,637,2,1,272,269,3
BR1_2708387170,7,True,0,1,0,14951,139,52,5.8,False,7,False,1,0,1,18364,226,53,6.6,True,27.122883333333334,-3413,0,-1,191,279,-88
BR1_2723653854,4,False,0,0,0,14084,172,44,6.6,True,8,True,1,1,0,15663,171,36,6.6,False,25.703116666666666,-1579,-4,-1,216,207,9
BR1_2731673603,12,False,1,0,0,18368,211,40,6.8,True,8,True,0,0,0,16928,155,48,6.4,False,26.565483333333333,1440,4,1,251,203,48
BR1_2731634989,2,False,0,0,0,12890,149,36,6.0,False,5,True,0,0,0,15306,152,56,6.6,True,27.161016666666665,-2416,-3,0,185,208,-23
BR1_2689713429,3,False,0,0,0,13284,140,44,6.6,False,12,True,1,0,0,17978,185,60,7.2,True,26.05375,-4694,-9,-1,184,245,-61
BR1_2728733136,2,False,1,0,0,13367,152,48,6.6,False,11,True,0,1,2,21118,214,56,7.6,True,28.9226,-7751,-9,1,200,270,-70
BR1_2699073332,7,True,0,0,0,14431,147,40,6.6,True,2,False,1,1,0,14194,160,60,6.6,False,26.2595,237,5,-1,187,220,-33
BR1_2730739894,7,True,0,0,0,16384,180,38,6.8,True,5,False,0,0,0,13940,135,30,6.0,False,26.59795,2444,2,0,218,165,53
BR1_2728279189,6,False,1,1,0,16351,164,52,7.0,False,7,True,0,0,1,17282,193,40,7.2,True,28.983233333333335,-931,-1,1,216,233,-17
BR1_2685070676,2,True,1,0,0,13760,154,48,6.8,False,3,False,0,0,0,14789,161,60,7.2,True,28.526933333333332,-1029,-1,1,202,221,-19
BR1_2684792173,6,True,0,0,0,16557,194,44,7.4,True,3,False,0,1,0,15256,190,60,7.2,False,29.144616666666668,1301,3,0,238,250,-12
BR1_2730744520,5,False,0,1,0,15591,153,52,6.4,False,16,True,0,0,0,19291,165,40,7.0,True,25.101016666666666,-3700,-11,0,205,205,0
BR1_2726471109,3,False,0,0,0,14194,179,48,6.6,False,3,True,0,1,1,17783,219,56,7.4,True,27.869516666666666,-3589,0,0,227,275,-48
BR1_2675039891,4,False,0,0,0,13843,162,34,7.0,False,7,True,0,0,0,15794,171,48,7.0,True,26.38415,-1951,-3,0,196,219,-23
BR1_2730717810,4,False,0,0,0,13850,146,52,6.4,False,9,True,1,0,0,16397,186,48,7.0,True,26.64135,-2547,-5,-1,198,234,-36
BR1_2731513337,2,False,1,0,0,13529,189,44,6.6,False,3,True,0,1,0,14959,209,48,6.6,True,26.9855,-1430,-1,1,233,257,-24
BR1_2707670132,3,False,0,0,0,13696,155,40,6.6,False,7,True,1,1,0,16973,180,56,6.8,True,29.89995,-3277,-4,-1,195,236,-41
BR1_2730491666,6,False,0,0,0,14790,171,44,6.8,True,3,True,1,0,0,13161,133,56,6.8,False,26.878683333333335,1629,3,-1,215,189,26
BR1_2730461516,4,True,0,0,0,16592,257,48,7.4,True,4,False,1,0,0,16212,174,68,7.0,False,28.988416666666666,380,0,-1,305,242,63
BR1_2694554381,2,False,0,0,0,13093,148,59,6.6,False,3,True,1,1,0,15198,202,62,6.8,True,25.845683333333334,-2105,-1,-1,207,264,-57
BR1_2729132935,9,False,0,1,0,18216,182,60,7.2,True,6,True,0,0,0,15211,136,44,6.6,False,27.660733333333333,3005,3,0,242,180,62
BR1_2690763604,1,False,0,0,0,12711,189,44,6.6,False,7,True,0,0,0,14545,140,56,6.8,True,27.092366666666667,-1834,-6,0,233,196,37
BR1_2690747238,6,True,0,1,0,15429,153,48,6.6,False,10,False,0,0,0,18110,197,48,7.0,True,25.968783333333334,-2681,-4,0,201,245,-44
BR1_2730233586,15,True,1,0,1,19307,144,44,5.6,True,8,False,0,1,0,19822,187,45,6.6,False,29.615116666666665,-515,7,1,188,232,-44
BR1_2728485455,11,False,1,1,0,17544,167,56,6.8,False,12,True,0,0,0,17959,159,56,7.2,True,29.66205,-415,-1,1,223,215,8
BR1_2728989214,13,True,1,0,0,19358,191,32,7.4,False,9,False,0,1,0,17676,181,56,7.4,True,28.766233333333332,1682,4,1,223,237,-14
BR1_2718906665,9,True,1,0,0,17045,181,52,7.4,True,2,False,0,0,0,13061,160,40,6.6,False,26.915033333333334,3984,7,1,233,200,33
BR1_2731528763,8,True,0,0,0,16121,178,52,6.8,True,7,False,0,0,0,15200,145,40,6.4,False,26.002516666666665,921,1,0,230,185,45
BR1_2731264064,2,False,0,0,0,12712,171,32,6.2,False,5,True,1,0,0,16118,206,64,7.4,True,26.086583333333333,-3406,-3,-1,203,270,-67
BR1_2731235115,6,False,0,0,0,15837,162,40,6.6,False,9,True,1,1,0,17599,167,63,7.2,True,28.55655,-1762,-3,-1,202,230,-28
BR1_2731155903,9,True,1,0,0,16237,157,40,6.6,True,4,False,0,0,0,14553,184,40,6.8,False,27.353483333333333,1684,5,1,197,224,-27
BR1_2717545025,6,True,1,0,0,15457,162,56,6.8,True,5,False,0,0,0,14566,166,40,6.4,False,25.306333333333335,891,1,1,218,206,12
BR1_2716773129,5,True,1,0,0,15233,176,48,6.8,True,5,False,0,0,0,14916,168,40,6.4,False,26.066883333333333,317,0,1,224,208,16
BR1_2715780803,9,False,0,1,0,17865,196,28,7.2,False,8,True,1,0,0,16836,194,56,7.2,True,27.70765,1029,1,-1,224,250,-26
BR1_2727419031,6,False,0,0,0,14991,141,40,6.6,False,8,True,0,0,0,17292,172,60,6.8,True,27.443666666666665,-2301,-2,0,181,232,-51
BR1_2725088968,5,False,0,0,0,15358,174,48,6.2,False,7,True,1,0,0,14453,112,43,6.2,True,26.453533333333333,905,-2,-1,222,155,67
BR1_2730935567,12,True,1,1,0,19448,206,64,7.2,True,4,False,0,0,0,14032,163,40,6.4,False,29.07805,5416,8,1,270,203,67
BR1_2681479533,9,False,0,0,0,17203,207,28,6.8,True,11,True,0,0,0,17410,165,36,6.8,False,29.860033333333334,-207,-2,0,235,201,34
BR1_2698362830,2,False,0,0,0,14356,168,72,6.6,False,4,True,0,0,0,15265,213,51,7.0,True,27.449833333333334,-909,-2,0,240,264,-24
BR1_2730319064,8,False,1,1,0,17818,173,56,6.8,True,12,True,0,0,0,20041,175,49,6.8,False,28.80075,-2223,-4,1,229,224,5
BR1_2718505039,6,True,0,0,0,17724,205,56,7.0,True,5,False,1,1,0,17159,211,56,7.2,False,29.451016666666668,565,1,-1,261,267,-6
BR1_2730018525,7,True,0,0,0,18726,202,52,7.2,False,11,False,0,1,0,18555,180,63,7.2,True,28.002983333333333,171,-4,0,254,243,11
BR1_2728959747,7,False,1,0,0,16630,175,60,7.0,True,7,True,0,1,0,15709,192,44,6.8,False,27.294266666666665,921,0,1,235,236,-1
BR1_2731632517,6,False,0,0,0,15619,197,36,7.0,True,5,True,0,0,0,15752,216,60,6.8,False,26.55153333333333,-133,1,0,233,276,-43
BR1_2679088982,5,True,0,1,0,16742,207,54,6.8,True,2,False,1,0,0,14343,214,46,6.8,False,26.842866666666666,2399,3,-1,261,260,1
BR1_2671356450,8,False,0,0,0,17389,209,42,7.0,False,10,True,0,0,0,17628,209,52,7.2,True,26.008733333333332,-239,-2,0,251,261,-10
BR1_2718602452,8,True,1,1,0,18969,212,72,7.6,True,1,False,0,0,0,14275,207,56,7.2,False,29.074866666666665,4694,7,1,284,263,21
BR1_2717906662,6,True,0,0,0,16227,192,44,6.8,False,7,False,1,0,0,18208,238,64,7.4,True,29.1784,-1981,-1,-1,236,302,-66
BR1_2707490245,9,True,1,0,0,18537,236,63,7.4,True,2,False,0,0,0,13083,144,56,6.6,False,26.853633333333335,5454,7,1,299,200,99
BR1_2730759316,8,False,0,0,0,15852,157,38,6.4,False,15,True,1,0,0,18575,173,44,7.0,True,25.3024,-2723,-7,-1,195,217,-22
BR1_2731004350,13,True,1,0,0,19175,175,72,7.4,True,7,False,0,0,0,17000,152,64,7.0,False,28.8934,2175,6,1,247,216,31
BR1_2707669701,9,False,1,0,0,17332,162,44,7.0,False,6,True,0,0,0,17802,221,60,7.4,True,28.714716666666668,-470,3,1,206,281,-75
BR1_2707600958,6,False,0,1,0,14911,178,48,6.6,True,8,True,1,0,0,16633,186,48,6.4,False,25.18475,-1722,-2,-1,226,234,-8
BR1_2711437451,4,True,0,0,0,14995,191,48,6.4,False,8,False,0,0,0,16345,191,44,6.8,True,26.538016666666667,-1350,-4,0,239,235,4
BR1_2714111374,10,True,1,1,0,19283,229,44,7.2,True,2,False,0,0,0,14222,197,48,6.6,False,28.943983333333332,5061,8,1,273,245,28
BR1_2726225790,6,False,0,1,0,16822,229,44,7.2,False,9,True,1,0,0,17261,198,60,6.8,True,25.835566666666665,-439,-3,-1,273,258,15
BR1_2731264099,5,True,0,0,0,14994,189,44,6.6,False,9,False,1,0,0,16678,175,51,6.4,True,26.324366666666666,-1684,-4,-1,233,226,7
BR1_2730260850,7,True,0,1,1,19017,213,44,7.2,True,2,False,0,0,0,13297,151,48,6.6,False,27.721516666666666,5720,5,0,257,199,58
BR1_2713498685,12,True,0,0,0,19442,236,52,7.4,False,6,False,0,0,0,15975,156,48,7.0,True,29.153466666666667,3467,6,0,288,204,84
BR1_2712366730,9,False,0,0,0,17178,180,52,6.8,False,10,True,1,1,0,18130,188,61,7.4,True,29.921833333333332,-952,-1,-1,232,249,-17
BR1_2700810829,8,False,1,0,0,16340,166,64,6.6,True,3,True,0,0,0,14461,181,40,6.6,False,26.233883333333335,1879,5,1,230,221,9
BR1_2721158373,8,False,0,1,0,17625,153,44,7.0,False,13,True,1,0,0,20313,203,60,7.4,True,29.502383333333334,-2688,-5,-1,197,263,-66
BR1_2687022324,8,False,0,0,0,18561,251,48,7.2,False,9,True,1,1,0,17693,158,72,6.8,True,29.4821,868,-1,-1,299,230,69
BR1_2686022183,6,False,0,1,0,17252,199,72,7.4,False,9,True,1,0,0,17567,165,64,7.4,True,28.490983333333332,-315,-3,-1,271,229,42
BR1_2730417604,11,True,0,0,0,19820,193,64,7.4,False,8,False,1,1,0,18044,189,52,7.0,True,27.701966666666667,1776,3,-1,257,241,16
BR1_2728737095,10,False,0,1,0,19084,225,52,7.2,True,7,True,1,0,0,18574,188,64,7.2,False,29.54455,510,3,-1,277,252,25
BR1_2731382280,10,False,0,0,1,19522,193,68,7.2,False,8,True,0,0,0,17324,178,44,6.8,True,29.260466666666666,2198,2,0,261,222,39
BR1_2716989300,7,False,1,0,0,16673,193,48,7.0,True,8,True,0,0,0,16014,176,44,6.8,False,26.4289,659,-1,1,241,220,21
BR1_2716749868,2,False,0,0,0,15399,202,50,6.6,False,10,True,1,1,0,18893,230,44,7.4,True,29.304916666666667,-3494,-8,-1,252,274,-22
BR1_2728778158,8,True,1,0,0,16089,165,64,6.4,True,8,False,0,0,0,16052,169,36,6.4,False,25.6641,37,0,1,229,205,24
BR1_2704083823,5,False,1,0,0,14909,178,52,6.6,False,5,True,0,0,0,14805,164,60,6.8,True,26.6894,104,0,1,230,224,6
BR1_2729281081,7,False,0,0,0,16311,150,48,6.4,False,12,True,1,0,1,20408,208,55,7.2,True,29.98295,-4097,-5,-1,198,263,-65
BR1_2728419641,15,False,1,1,0,21137,213,54,7.2,True,6,True,0,0,0,16093,147,45,6.4,False,29.74035,5044,9,1,267,192,75
BR1_2675569797,8,True,0,0,0,17550,170,68,7.6,True,10,False,0,0,0,19684,229,60,7.8,False,29.640466666666665,-2134,-2,0,238,289,-51
BR1_2695309054,6,False,0,0,0,16503,172,32,6.4,False,14,True,1,0,0,20467,200,36,7.0,True,29.596466666666668,-3964,-8,-1,204,236,-32
BR1_2690286263,9,False,0,0,0,17907,157,50,7.2,False,10,True,1,1,0,19561,222,72,7.4,True,28.82255,-1654,-1,-1,207,294,-87
BR1_2722249741,6,True,1,1,0,17175,206,52,7.2,True,5,False,0,0,0,15727,157,60,7.0,False,29.725416666666668,1448,1,1,258,217,41
BR1_2721053305,11,False,1,1,1,21050,181,56,7.0,False,11,True,0,0,0,18114,197,40,6.8,True,29.196583333333333,2936,0,1,237,237,0
BR1_2678059063,6,False,0,0,0,16382,194,48,7.2,False,12,True,1,0,0,20921,232,68,7.4,True,27.708766666666666,-4539,-6,-1,242,300,-58
BR1_2678048395,5,True,0,0,0,15965,188,60,6.8,False,5,False,1,0,0,15980,221,52,6.6,True,26.682983333333333,-15,0,-1,248,273,-25
BR1_2731203265,10,True,1,0,0,17593,175,56,7.2,True,4,False,0,0,0,17085,224,43,7.2,False,28.615583333333333,508,6,1,231,267,-36
BR1_2731127102,3,True,0,0,0,14245,182,56,6.6,False,5,False,0,0,0,14863,208,41,6.8,True,27.221866666666667,-618,-2,0,238,249,-11
BR1_2730777116,3,False,0,1,0,15515,178,48,7.0,False,4,True,1,0,0,16960,224,68,7.2,True,29.252083333333335,-1445,-1,-1,226,292,-66
BR1_2690786849,7,False,0,0,0,15854,171,52,7.0,True,6,True,1,0,0,15988,181,52,6.8,False,25.373933333333333,-134,1,-1,223,233,-10
BR1_2727048097,5,True,0,0,0,16394,204,52,7.0,False,7,False,1,0,0,15523,158,60,7.2,True,27.3987,871,-2,-1,256,218,38
BR1_2730737652,3,False,1,0,0,16022,207,62,7.4,False,2,True,0,1,0,16356,227,68,7.4,True,28.06025,-334,1,1,269,295,-26
BR1_2731133069,4,True,0,0,0,15229,151,44,6.4,False,11,False,1,0,0,17907,176,72,7.4,True,28.899216666666668,-2678,-7,-1,195,248,-53
BR1_2731036690,9,False,1,1,0,18335,205,61,7.6,True,7,True,0,0,0,17098,187,54,7.2,False,29.612966666666665,1237,2,1,266,241,25
BR1_2728433223,5,False,0,0,0,13926,125,67,6.4,False,7,True,0,0,0,16574,177,42,6.4,True,26.072016666666666,-2648,-2,0,192,219,-27
BR1_2728408224,7,False,0,0,0,16056,157,64,6.6,True,8,True,0,0,0,16522,188,47,6.8,False,26.026283333333332,-466,-1,0,221,235,-14
BR1_2728383132,9,True,1,0,0,18182,213,68,7.4,True,3,False,0,1,0,14582,184,48,7.0,False,29.0274,3600,6,1,281,232,49
BR1_2710027389,14,True,1,0,0,19133,196,52,7.0,False,12,False,0,0,0,19737,204,36,7.0,True,29.063233333333333,-604,2,1,248,240,8
BR1_2731251431,10,True,1,0,0,17902,217,56,6.8,True,10,False,0,0,0,17485,172,40,6.8,False,26.016233333333332,417,0,1,273,212,61
BR1_2731226632,6,False,0,0,0,15636,196,53,6.8,False,9,True,1,0,0,17527,154,59,7.0,True,25.069883333333333,-1891,-3,-1,249,213,36
BR1_2730701216,7,True,1,1,0,16094,182,44,6.8,True,5,False,0,0,0,14526,162,52,6.6,False,26.1318,1568,2,1,226,214,12
BR1_2731457097,8,True,0,0,0,17035,183,52,6.8,False,8,False,0,0,0,17892,196,64,7.6,True,29.430516666666666,-857,0,0,235,260,-25
BR1_2731140836,3,True,0,0,0,14277,165,48,6.6,False,0,False,0,1,0,13861,202,52,6.8,True,27.436716666666666,416,3,0,213,254,-41
BR1_2731605274,7,False,0,0,0,15721,177,34,6.6,False,7,True,0,0,0,15436,152,46,6.6,True,25.7609,285,0,0,211,198,13
BR1_2731493196,8,True,0,1,0,16732,157,52,6.0,False,9,False,1,0,0,16395,147,54,6.2,True,26.87915,337,-1,-1,209,201,8
BR1_2731705074,6,True,0,1,0,16787,195,54,7.0,False,3,False,1,0,0,15637,217,52,7.0,True,29.513533333333335,1150,3,-1,249,269,-20
BR1_2731678350,8,False,1,0,0,17989,216,52,7.0,False,7,True,0,1,0,17544,196,60,7.0,True,29.619016666666667,445,1,1,268,256,12
BR1_2715369797,3,False,1,0,0,15789,211,52,7.6,False,3,True,0,0,0,16650,225,68,7.4,True,29.81895,-861,0,1,263,293,-30
BR1_2731191414,6,False,0,1,0,14953,174,36,6.4,False,7,True,1,0,0,15762,154,52,6.6,True,25.162233333333333,-809,-1,-1,210,206,4
BR1_2731163448,9,True,0,0,0,18161,178,48,7.2,True,9,False,1,1,0,17885,160,56,7.2,False,28.406933333333335,276,0,-1,226,216,10
BR1_2687392988,8,False,1,0,0,16970,200,60,7.0,True,6,True,0,1,0,15805,174,56,6.8,False,26.852483333333332,1165,2,1,260,230,30
BR1_2731196232,4,False,0,0,0,14235,169,45,6.4,False,4,True,1,0,0,13977,157,50,6.4,True,25.151066666666665,258,0,-1,214,207,7
BR1_2727440979,9,True,1,0,0,18766,235,44,7.2,True,5,False,0,0,0,15817,188,54,6.8,False,29.953116666666666,2949,4,1,279,242,37
BR1_2705150807,9,False,0,0,0,17312,182,52,6.8,False,6,True,0,0,0,17419,198,44,7.0,True,29.496416666666665,-107,3,0,234,242,-8
BR1_2705105321,3,False,0,0,0,15633,210,64,7.4,True,4,True,1,1,0,17660,249,68,7.4,False,28.61465,-2027,-1,-1,274,317,-43
BR1_2691669175,10,True,1,0,0,19057,214,56,7.2,False,10,False,0,1,0,18730,185,44,7.2,True,29.84,327,0,1,270,229,41
BR1_2726147796,4,True,0,0,0,15060,188,40,6.6,False,7,False,1,0,0,16356,204,60,7.2,True,25.3013,-1296,-3,-1,228,264,-36
BR1_2731248915,7,True,0,1,0,18900,225,56,7.6,True,3,False,0,0,0,15556,218,52,7.4,False,28.667016666666665,3344,4,0,281,270,11
BR1_2731167047,9,True,1,0,0,17887,208,64,7.6,True,5,False,0,1,0,17435,207,60,7.4,False,29.219133333333332,452,4,1,272,267,5
BR1_2722061890,18,True,1,0,1,21810,196,65,7.6,True,9,False,0,1,0,18042,159,66,6.8,False,29.70625,3768,9,1,261,225,36
BR1_2731506726,6,False,0,1,1,18639,225,52,7.6,True,4,True,1,0,0,16282,195,60,7.0,False,28.506683333333335,2357,2,-1,277,255,22
BR1_2707837772,3,False,0,0,0,14353,180,64,6.8,False,8,True,1,0,0,16878,182,44,6.8,True,27.062416666666667,-2525,-5,-1,244,226,18
BR1_2731300093,6,False,0,0,0,15159,152,48,6.2,False,12,True,1,0,0,18184,182,60,7.0,True,25.4959,-3025,-6,-1,200,242,-42
BR1_2714029442,9,True,0,0,0,15897,154,36,6.4,True,10,False,1,1,0,17852,160,52,6.8,False,26.854833333333332,-1955,-1,-1,190,212,-22
BR1_2725803978,11,False,1,0,0,19596,205,55,7.4,True,7,True,0,0,0,16832,198,48,7.2,False,28.682583333333334,2764,4,1,260,246,14
BR1_2731653119,8,False,0,0,0,14855,175,44,6.4,False,9,True,1,0,0,16824,208,40,6.8,True,26.528166666666667,-1969,-1,-1,219,248,-29
BR1_2731003458,14,False,1,0,0,19933,195,56,7.2,True,9,True,0,0,0,18534,187,64,7.2,False,28.013083333333334,1399,5,1,251,251,0
BR1_2730079500,11,True,1,0,0,16428,166,48,6.6,True,3,False,0,0,0,14085,185,52,7.0,False,27.05056666666667,2343,8,1,214,237,-23
BR1_2727275543,4,False,0,1,0,16114,232,60,7.2,True,3,True,0,0,0,13256,176,36,6.8,False,26.573283333333332,2858,1,0,292,212,80
BR1_2731706105,7,False,0,0,0,16203,173,60,6.8,False,8,True,1,0,0,17353,210,48,6.8,True,26.5055,-1150,-1,-1,233,258,-25
BR1_2691513379,8,True,0,0,0,17733,214,68,7.0,True,6,False,0,1,0,16604,187,60,7.2,False,28.741416666666666,1129,2,0,282,247,35
BR1_2731319713,7,False,0,0,0,14372,167,24,6.4,False,9,True,1,0,0,17422,195,47,6.6,True,25.57005,-3050,-2,-1,191,242,-51
BR1_2696147896,3,False,0,1,0,15149,198,52,6.8,True,5,True,1,0,0,16139,208,52,6.8,False,26.440033333333332,-990,-2,-1,250,260,-10
BR1_2685461500,2,False,0,0,0,15258,218,44,7.4,True,8,True,0,1,0,19526,254,72,7.8,False,29.065383333333333,-4268,-6,0,262,326,-64
BR1_2727920975,4,False,0,0,0,14291,157,0,5.8,False,8,True,1,1,1,19032,161,50,7.4,True,29.565183333333334,-4741,-4,-1,157,211,-54
BR1_2730532096,12,True,0,0,0,19553,237,52,7.6,True,12,False,1,0,0,17878,157,60,7.6,False,29.1779,1675,0,-1,289,217,72
BR1_2729357384,7,False,1,0,0,15838,170,48,6.8,True,6,True,0,0,0,15166,183,48,6.8,False,25.310566666666666,672,1,1,218,231,-13
BR1_2718996877,8,True,0,0,0,16218,178,68,7.0,False,10,False,1,0,0,17685,186,54,7.0,True,25.110283333333335,-1467,-2,-1,246,240,6
BR1_2728870001,10,True,1,1,0,18548,218,75,7.8,True,3,False,0,0,0,15630,220,48,7.4,False,29.613866666666667,2918,7,1,293,268,25
BR1_2714919013,9,True,0,0,0,19015,208,44,6.6,False,5,False,0,1,0,16754,181,60,7.0,True,27.602083333333333,2261,4,0,252,241,11
BR1_2730469140,5,False,0,0,0,16627,209,64,7.4,False,11,True,1,1,1,21483,240,56,7.2,True,29.982733333333332,-4856,-6,-1,273,296,-23
BR1_2716259675,12,False,1,0,0,19423,201,53,7.2,True,8,True,0,1,0,17689,182,56,6.8,False,27.539533333333335,1734,4,1,254,238,16
BR1_2708430697,7,False,1,0,0,15676,178,44,6.8,False,7,True,0,0,0,16145,205,60,6.8,True,26.434183333333333,-469,0,1,222,265,-43
BR1_2708412703,8,True,1,0,0,16243,179,56,6.8,True,3,False,0,0,0,14484,192,44,6.8,False,27.22235,1759,5,1,235,236,-1
BR1_2730749798,5,False,0,1,0,15698,184,52,7.0,False,6,True,1,0,0,16629,185,36,6.8,True,29.4448,-931,-1,-1,236,221,15
BR1_2730934603,8,True,0,1,1,18266,192,44,7.0,True,9,False,1,0,0,17947,225,64,7.2,False,29.996366666666667,319,-1,-1,236,289,-53
BR1_2725140572,7,True,0,0,0,16216,167,36,6.6,False,8,False,1,0,0,17349,215,48,6.8,True,25.72815,-1133,-1,-1,203,263,-60
BR1_2725684308,11,True,1,0,0,16885,177,40,6.8,True,7,False,0,0,0,14788,151,44,6.4,False,26.69483333333333,2097,4,1,217,195,22
BR1_2723920375,10,True,0,0,0,18172,192,48,6.8,True,6,False,1,1,0,14939,141,60,6.4,False,26.13335,3233,4,-1,240,201,39
BR1_2730212838,3,False,1,0,0,15773,218,72,7.6,True,7,True,0,0,0,17865,228,56,7.4,False,28.265633333333334,-2092,-4,1,290,284,6
BR1_2726506857,7,False,1,0,0,17422,176,60,7.2,False,12,True,0,0,0,20015,197,52,7.6,True,29.5512,-2593,-5,1,236,249,-13
BR1_2731050552,5,False,1,0,0,15885,186,56,6.8,True,1,True,0,0,0,13417,159,60,6.8,False,25.97025,2468,4,1,242,219,23
BR1_2730499108,10,False,1,0,0,17019,159,44,6.6,False,13,True,0,1,0,19086,186,48,7.0,True,25.206333333333333,-2067,-3,1,203,234,-31
BR1_2731508903,2,False,0,0,0,15087,212,56,7.2,False,9,True,1,1,0,18194,203,48,7.4,True,29.247066666666665,-3107,-7,-1,268,251,17
BR1_2730974541,7,False,0,0,0,16886,186,46,7.0,True,4,True,0,0,0,14626,171,57,6.6,False,25.650433333333332,2260,3,0,232,228,4
BR1_2700054671,5,False,0,0,0,15969,224,35,7.0,True,6,True,0,0,0,17084,253,36,7.2,False,28.278066666666668,-1115,-1,0,259,289,-30
BR1_2699595258,10,True,1,0,0,17832,209,44,6.6,True,6,False,0,1,0,15366,186,48,6.8,False,26.68245,2466,4,1,253,234,19
BR1_2724028173,6,True,0,0,0,17454,224,46,7.0,True,5,False,0,0,0,16277,201,38,7.2,False,29.851683333333334,1177,1,0,270,239,31
BR1_2723936580,6,False,0,0,0,16064,208,40,6.8,False,12,True,1,0,0,19491,220,44,7.2,True,28.980983333333334,-3427,-6,-1,248,264,-16
BR1_2723550738,11,False,1,0,0,18711,168,60,7.2,True,7,True,0,1,0,16954,190,50,7.4,False,29.379283333333333,1757,4,1,228,240,-12
BR1_2720309340,8,True,0,0,0,16063,163,40,6.6,False,8,False,0,0,0,18715,244,64,7.6,True,28.18095,-2652,0,0,203,308,-105
BR1_2709430733,8,True,1,0,0,18072,208,56,7.2,True,9,False,0,0,0,17756,182,56,7.4,False,28.23925,316,-1,1,264,238,26
BR1_2702006798,11,True,1,0,0,18264,205,60,7.2,True,5,False,0,1,0,17043,180,62,7.2,False,28.762933333333333,1221,6,1,265,242,23
BR1_2731130940,5,False,0,0,0,15058,214,48,6.8,False,10,True,0,0,0,18131,199,52,7.0,True,28.2643,-3073,-5,0,262,251,11
BR1_2731545996,7,False,1,0,0,16535,174,52,7.2,True,1,True,0,0,0,13666,183,52,6.4,False,25.867716666666666,2869,6,1,226,235,-9
BR1_2730199793,7,True,1,0,0,16604,201,48,7.2,False,9,False,0,0,0,17863,205,40,6.6,True,27.2227,-1259,-2,1,249,245,4
BR1_2731628829,15,False,1,0,0,20968,190,58,7.2,True,13,True,0,0,0,19936,217,52,7.0,False,28.326883333333335,1032,2,1,248,269,-21
BR1_2730807085,9,False,1,0,0,16406,187,56,6.8,True,7,True,0,1,0,16584,193,68,6.8,False,26.63843333333333,-178,2,1,243,261,-18
BR1_2706045223,8,False,1,0,0,16288,188,48,7.0,True,5,True,0,0,0,15177,191,52,6.4,False,27.253033333333335,1111,3,1,236,243,-7
BR1_2701085722,5,False,1,0,0,15759,183,44,6.6,False,10,True,0,1,0,18288,199,40,7.0,True,29.016283333333334,-2529,-5,1,227,239,-12
BR1_2731671912,8,True,1,0,0,18035,186,64,7.2,True,7,False,0,0,0,16699,161,54,7.2,False,28.2344,1336,1,1,250,215,35
BR1_2731652778,5,False,0,0,0,14643,173,44,6.6,False,9,True,1,0,0,17291,199,44,6.8,True,26.675666666666668,-2648,-4,-1,217,243,-26
BR1_2731620164,3,False,0,0,0,14297,175,40,6.2,False,6,True,1,0,0,14870,146,64,6.8,True,27.396383333333333,-573,-3,-1,215,210,5
BR1_2731285097,6,True,0,0,0,16855,221,47,7.4,True,10,False,1,1,0,19218,201,64,7.4,False,29.766766666666665,-2363,-4,-1,268,265,3
BR1_2730309098,8,False,0,0,0,16974,159,48,6.6,False,12,True,0,0,0,17783,177,52,6.6,True,25.5333,-809,-4,0,207,229,-22
BR1_2726172282,7,True,0,0,0,16183,178,44,6.8,False,10,False,1,1,0,18554,198,56,7.2,True,25.121816666666668,-2371,-3,-1,222,254,-32
BR1_2713532734,10,False,1,0,0,17521,195,52,6.6,True,8,True,0,0,0,17246,176,52,6.8,False,25.11485,275,2,1,247,228,19
BR1_2726711975,3,False,0,1,0,16724,186,76,7.0,False,10,True,1,0,0,18950,178,52,7.2,True,27.8595,-2226,-7,-1,262,230,32
BR1_2729088154,13,True,1,1,0,20530,204,68,7.4,True,7,False,0,0,0,16990,162,56,6.8,False,29.609416666666668,3540,6,1,272,218,54
BR1_2730796967,7,False,0,0,0,15703,188,35,6.8,False,4,True,0,0,0,16204,221,61,7.0,True,25.250366666666668,-501,3,0,223,282,-59
BR1_2692033454,6,True,0,0,0,16391,239,52,7.4,False,2,False,1,1,0,16006,247,52,7.4,True,27.769716666666667,385,4,-1,291,299,-8
BR1_2730374275,7,False,1,0,0,15673,160,44,6.6,False,11,True,0,0,0,17833,197,48,6.6,True,27.23506666666667,-2160,-4,1,204,245,-41
BR1_2730356929,7,False,0,0,0,14395,126,48,6.0,False,11,True,0,0,0,17573,168,52,7.0,True,26.705216666666665,-3178,-4,0,174,220,-46
BR1_2731100521,7,False,0,1,0,17196,188,52,7.4,False,8,True,0,0,0,18783,232,68,7.8,True,28.0966,-1587,-1,0,240,300,-60
BR1_2719015518,8,False,1,0,0,16204,152,52,6.4,False,11,True,0,1,0,17189,150,44,6.4,True,25.0998,-985,-3,1,204,194,10
BR1_2725106592,15,True,0,0,0,21377,197,60,7.0,True,5,False,1,0,0,16145,207,48,6.8,False,29.081716666666665,5232,10,-1,257,255,2
BR1_2729107966,8,True,0,0,0,16051,168,48,6.4,False,6,False,1,0,0,15496,193,56,6.8,True,27.499433333333332,555,2,-1,216,249,-33
BR1_2731187076,10,False,0,0,0,17869,154,40,6.2,False,11,True,1,0,0,19089,220,56,6.8,True,27.157983333333334,-1220,-1,-1,194,276,-82
BR1_2726560142,8,False,1,0,0,17004,180,64,7.2,True,7,True,0,0,0,15773,184,36,6.8,False,27.11145,1231,1,1,244,220,24
BR1_2729744834,9,False,0,0,0,17181,207,44,7.0,True,7,True,0,0,0,15571,136,48,6.6,False,25.990283333333334,1610,2,0,251,184,67
BR1_2729422254,8,False,1,0,0,17723,195,60,7.0,True,6,True,0,1,0,16711,205,44,7.4,False,27.901083333333332,1012,2,1,255,249,6
BR1_2690485662,10,True,0,1,0,17980,172,52,6.8,True,3,False,0,0,0,13241,157,48,6.4,False,25.154183333333332,4739,7,0,224,205,19
BR1_2690447408,8,False,1,0,0,15382,186,48,6.2,True,6,True,0,1,0,15889,164,48,6.6,False,25.5098,-507,2,1,234,212,22
BR1_2729618581,8,True,1,1,0,17246,172,64,7.0,True,2,False,0,0,0,13929,177,64,6.8,False,27.3553,3317,6,1,236,241,-5
BR1_2728696690,3,False,0,1,0,14769,163,60,6.8,False,7,True,1,0,0,18291,230,55,7.0,True,29.548216666666665,-3522,-4,-1,223,285,-62
BR1_2731606257,9,True,0,0,0,18874,229,60,7.4,True,5,False,1,0,0,17124,268,48,7.2,False,29.77995,1750,4,-1,289,316,-27
BR1_2731563358,2,False,0,0,0,14405,205,46,6.8,False,11,True,0,1,0,18757,202,56,6.8,True,27.3862,-4352,-9,0,251,258,-7
BR1_2731309596,4,False,0,0,0,15167,185,40,6.8,False,14,True,1,0,0,21312,233,80,7.8,True,27.740666666666666,-6145,-10,-1,225,313,-88
BR1_2672891509,9,False,0,0,0,15359,135,38,6.2,False,12,True,0,1,0,18408,204,40,6.8,True,25.574866666666665,-3049,-3,0,173,244,-71
BR1_2725910015,11,False,0,1,1,20092,170,52,7.2,True,11,True,1,0,0,19872,168,76,7.2,False,28.4019,220,0,-1,222,244,-22
BR1_2725852470,7,False,0,0,0,17042,191,40,7.0,True,6,True,1,1,0,16922,204,76,7.4,False,29.52695,120,1,-1,231,280,-49
BR1_2715565488,2,True,0,0,0,14551,204,40,7.0,False,8,False,0,0,0,17738,190,50,7.0,True,28.959116666666667,-3187,-6,0,244,240,4
BR1_2730688497,5,True,0,0,0,15229,176,59,6.8,True,3,False,0,0,0,14189,184,52,6.8,False,27.10011666666667,1040,2,0,235,236,-1
BR1_2695681406,4,False,0,0,0,15447,178,56,6.4,False,9,True,0,0,0,17613,191,48,7.4,True,28.6841,-2166,-5,0,234,239,-5
BR1_2726071828,3,False,0,0,0,13887,177,47,7.0,False,11,True,1,0,0,19693,188,79,7.4,True,29.09705,-5806,-8,-1,224,267,-43
BR1_2722930945,8,False,0,0,0,15973,157,51,6.6,False,8,True,1,0,0,15983,179,52,6.8,True,26.699916666666667,-10,0,-1,208,231,-23
BR1_2704469638,8,False,1,0,0,17415,190,56,7.4,True,6,True,0,0,0,17982,223,60,7.4,False,29.438466666666667,-567,2,1,246,283,-37
BR1_2729016636,11,True,0,0,0,18159,189,52,7.0,True,4,False,0,1,0,14217,172,68,6.6,False,25.786516666666667,3942,7,0,241,240,1
BR1_2730702231,7,True,0,1,0,16893,196,66,7.4,False,7,False,0,0,0,17668,237,41,7.2,True,29.6609,-775,0,0,262,278,-16
BR1_2731676523,4,False,1,0,0,16083,226,56,7.0,True,4,True,0,1,0,17355,219,60,7.2,False,28.197883333333333,-1272,0,1,282,279,3
BR1_2731654502,10,True,1,0,0,17314,179,44,6.8,True,6,False,0,0,0,15403,169,33,6.8,False,27.173933333333334,1911,4,1,223,202,21
BR1_2731460468,2,True,1,0,0,14936,207,59,6.6,True,1,False,0,0,0,12688,166,60,6.8,False,26.658483333333333,2248,1,1,266,226,40
BR1_2725414352,6,True,0,0,0,15072,158,40,6.2,False,8,False,1,0,0,17109,187,64,6.8,True,26.019333333333332,-2037,-2,-1,198,251,-53
BR1_2725028853,4,False,0,0,0,14954,181,52,6.8,True,4,True,0,0,0,15939,203,48,7.0,False,25.0909,-985,0,0,233,251,-18
BR1_2729999790,7,True,0,0,0,16097,181,39,7.0,False,2,False,1,0,0,13864,199,60,6.6,True,25.645433333333333,2233,5,-1,220,259,-39
BR1_2714026430,10,False,0,0,0,18728,211,46,6.8,False,14,True,1,1,1,21125,184,44,7.2,True,28.061966666666667,-2397,-4,-1,257,228,29
BR1_2675838380,8,True,1,0,0,16090,172,56,7.0,True,2,False,0,0,0,14004,185,56,6.4,False,26.056233333333335,2086,6,1,228,241,-13
BR1_2681776533,8,True,0,1,0,16808,196,44,7.0,False,6,False,1,0,0,16572,193,60,6.8,True,27.0812,236,2,-1,240,253,-13
BR1_2731197094,6,True,0,0,0,14502,126,48,6.2,False,5,False,1,0,0,14813,182,58,6.6,True,26.877483333333334,-311,1,-1,174,240,-66
BR1_2730804733,10,True,1,0,0,17625,143,72,7.4,True,6,False,0,0,0,15722,183,40,6.8,False,28.16208333333333,1903,4,1,215,223,-8
BR1_2675063218,11,True,1,0,0,18438,197,44,6.8,True,5,False,0,0,0,15427,164,64,6.6,False,25.748066666666666,3011,6,1,241,228,13
BR1_2710647017,5,True,1,1,0,16798,214,52,7.2,False,7,False,0,0,0,18033,228,57,7.6,True,28.4368,-1235,-2,1,266,285,-19
BR1_2709101923,2,False,0,0,0,14484,179,60,6.8,False,9,True,1,1,0,18767,196,51,7.0,True,28.796366666666668,-4283,-7,-1,239,247,-8
BR1_2730677852,7,False,0,0,0,16592,184,52,6.8,False,11,True,1,1,0,19666,232,60,7.6,True,29.6832,-3074,-4,-1,236,292,-56
BR1_2731424190,11,True,1,0,0,17962,179,56,6.8,True,3,False,0,0,0,13746,174,42,6.6,False,26.7044,4216,8,1,235,216,19
BR1_2731295314,8,True,0,0,0,18362,222,56,7.4,False,7,False,1,0,0,17760,221,68,7.4,True,29.142766666666667,602,1,-1,278,289,-11
BR1_2730891772,9,True,0,0,0,16125,164,32,6.2,False,10,False,1,0,0,16356,176,46,6.6,True,26.094316666666668,-231,-1,-1,196,222,-26
BR1_2730891371,3,False,0,1,0,15322,191,60,7.2,False,3,True,1,0,0,16980,253,52,7.2,True,28.62155,-1658,0,-1,251,305,-54
BR1_2722048520,9,True,1,0,0,17012,187,56,6.6,True,6,False,0,0,0,15585,195,40,6.6,False,27.41995,1427,3,1,243,235,8
BR1_2726113507,5,False,1,1,0,15452,171,44,6.8,False,11,True,0,0,0,18980,195,59,7.0,True,26.693266666666666,-3528,-6,1,215,254,-39
BR1_2702324309,8,True,1,0,0,15231,159,40,6.4,True,7,False,0,0,0,15849,189,44,6.6,False,26.687716666666667,-618,1,1,199,233,-34
BR1_2698941433,7,False,0,0,0,15369,169,43,6.6,False,9,True,0,0,0,17440,191,44,6.8,True,26.99285,-2071,-2,0,212,235,-23
BR1_2698922043,9,True,1,0,0,16948,199,51,6.8,True,2,False,0,1,0,14217,160,56,6.4,False,26.932616666666668,2731,7,1,250,216,34
BR1_2698900205,8,True,0,1,0,17613,214,43,6.8,True,8,False,0,0,0,15609,172,56,6.6,False,26.7325,2004,0,0,257,228,29
BR1_2698430269,6,True,0,1,0,16486,228,40,6.8,True,5,False,1,0,0,15115,167,47,6.6,False,26.964816666666668,1371,1,-1,268,214,54
BR1_2719629485,4,True,1,0,0,16704,220,47,7.0,True,4,False,0,0,0,15734,230,44,7.0,False,28.356083333333334,970,0,1,267,274,-7
BR1_2730034683,4,False,1,0,0,16523,210,64,7.2,True,3,True,0,0,0,15104,197,40,7.0,False,29.085383333333333,1419,1,1,274,237,37
BR1_2673864450,8,False,1,1,0,17732,215,60,7.8,True,5,True,0,0,0,15647,196,47,7.0,False,27.5501,2085,3,1,275,243,32
BR1_2670057915,8,False,0,0,0,16097,162,48,7.0,False,11,True,1,0,0,18592,212,56,7.4,True,27.6934,-2495,-3,-1,210,268,-58
BR1_2707164266,7,True,0,0,0,18388,230,42,7.2,False,8,False,1,1,0,17957,199,60,7.4,True,29.163866666666667,431,-1,-1,272,259,13
BR1_2707136342,17,True,0,1,0,18860,155,35,6.4,True,4,False,0,0,0,13500,119,40,6.0,False,25.56535,5360,13,0,190,159,31
BR1_2707108282,5,True,0,0,0,16193,200,56,7.0,False,12,False,0,0,0,19905,189,48,7.0,True,27.568716666666667,-3712,-7,0,256,237,19
BR1_2726005510,8,True,0,0,0,17375,188,48,6.8,True,7,False,1,0,0,16369,186,59,7.0,False,26.990666666666666,1006,1,-1,236,245,-9
BR1_2697655313,5,False,1,0,0,14409,164,48,6.4,False,10,True,0,0,0,17547,214,52,6.6,True,25.1965,-3138,-5,1,212,266,-54
BR1_2697648809,9,True,0,0,0,17696,165,48,6.8,True,6,False,1,1,0,16154,149,48,6.6,False,27.688133333333333,1542,3,-1,213,197,16
BR1_2731667618,7,True,1,0,0,16270,202,36,7.2,True,4,False,0,1,0,15746,197,44,6.8,False,29.448416666666667,524,3,1,238,241,-3
BR1_2729415119,6,True,1,1,0,15853,169,60,6.8,True,1,False,0,0,0,13440,180,46,6.4,False,26.5703,2413,5,1,229,226,3
BR1_2690501068,4,True,0,0,0,15064,218,56,6.6,False,6,False,1,1,0,16465,194,68,7.0,True,25.077733333333335,-1401,-2,-1,274,262,12
BR1_2689139276,10,True,1,0,0,17995,176,44,7.0,False,10,False,0,0,0,19102,203,64,6.8,True,28.448716666666666,-1107,0,1,220,267,-47
BR1_2686939806,11,False,0,0,0,19284,202,44,6.8,True,11,True,0,1,0,20214,227,52,7.4,False,29.015983333333335,-930,0,0,246,279,-33
BR1_2731203845,7,True,1,0,0,16400,194,56,6.8,True,2,False,0,1,0,13809,180,56,6.8,False,25.327816666666667,2591,5,1,250,236,14
BR1_2731185088,1,False,0,1,0,15659,207,60,7.0,False,8,True,1,0,0,17956,233,60,7.8,True,28.707916666666666,-2297,-7,-1,267,293,-26
BR1_2731672954,10,True,1,0,0,19194,202,52,7.2,True,6,False,0,0,0,16827,183,44,6.6,False,27.8554,2367,4,1,254,227,27
BR1_2730169405,10,True,1,1,1,21001,202,62,7.4,True,6,False,0,0,0,15557,180,50,6.8,False,27.998033333333332,5444,4,1,264,230,34
BR1_2724815018,5,False,1,0,0,16946,241,52,7.0,False,8,True,0,1,0,19591,253,51,7.4,True,29.222783333333332,-2645,-3,1,293,304,-11
BR1_2724802131,4,True,0,0,0,16689,235,44,7.0,True,3,False,1,0,0,16203,238,60,7.4,False,28.481516666666668,486,1,-1,279,298,-19
BR1_2724790323,5,False,1,0,0,16256,183,63,7.2,True,9,True,0,0,0,17452,180,32,6.8,False,29.562883333333332,-1196,-4,1,246,212,34
BR1_2728486109,10,True,0,0,0,16596,203,44,6.6,True,5,False,0,0,0,15509,186,52,6.6,False,25.68975,1087,5,0,247,238,9
BR1_2731555369,3,True,1,0,0,16283,222,56,6.8,True,5,False,0,0,0,17308,228,56,7.6,False,28.504683333333332,-1025,-2,1,278,284,-6
BR1_2731540471,8,True,0,0,0,15822,169,48,6.8,True,6,False,0,0,0,15313,173,52,6.4,False,27.17595,509,2,0,217,225,-8
BR1_2730974331,10,False,0,1,0,18822,203,48,7.4,True,10,True,1,0,0,19499,208,52,7.2,False,28.665666666666667,-677,0,-1,251,260,-9
BR1_2730951726,6,False,0,1,0,14783,151,60,6.0,False,7,True,1,0,0,17427,233,47,6.8,True,25.9631,-2644,-1,-1,211,280,-69
BR1_2730941679,10,True,1,0,0,20228,219,52,7.2,True,13,False,0,0,0,18606,180,36,7.0,False,29.347933333333334,1622,-3,1,271,216,55
BR1_2731708694,9,True,0,0,0,17059,157,42,6.4,False,9,False,1,0,0,16927,181,40,6.6,True,25.240466666666666,132,0,-1,199,221,-22
BR1_2731679569,8,False,0,0,0,18059,230,60,7.2,False,8,True,0,0,0,17089,191,64,7.2,True,28.868916666666667,970,0,0,290,255,35
BR1_2731276043,11,False,0,0,0,18133,201,60,7.0,False,9,True,1,0,0,18507,195,48,6.8,True,29.635166666666667,-374,2,-1,261,243,18
BR1_2731459501,4,False,0,0,0,14178,165,44,6.8,False,6,True,0,1,0,17488,192,68,6.8,True,27.345283333333334,-3310,-2,0,209,260,-51
BR1_2731443996,6,False,1,1,0,16876,179,68,7.2,True,3,True,0,0,0,15216,211,48,7.0,False,29.6871,1660,3,1,247,259,-12
BR1_2674885770,10,True,0,0,0,17552,171,56,7.0,True,7,False,0,0,0,15969,197,52,6.6,False,27.287216666666666,1583,3,0,227,249,-22
BR1_2714659506,5,False,1,0,0,15658,181,52,6.8,True,7,True,0,0,0,16282,160,68,6.0,False,27.124533333333332,-624,-2,1,233,228,5
BR1_2714147652,8,True,1,0,0,19596,228,72,7.4,True,3,False,0,1,0,15708,169,52,7.0,False,29.249233333333333,3888,5,1,300,221,79
BR1_2712701946,6,False,1,0,0,17540,197,60,7.2,True,4,True,0,1,0,15865,170,48,6.8,False,28.6779,1675,2,1,257,218,39
BR1_2702914748,4,False,0,0,0,14937,175,44,6.6,False,12,True,1,1,1,21157,254,59,7.6,True,27.756516666666666,-6220,-8,-1,219,313,-94
BR1_2718324193,11,True,1,0,0,18683,197,56,7.2,True,5,False,0,0,0,17303,227,56,7.0,False,28.571883333333332,1380,6,1,253,283,-30
BR1_2717090333,12,True,1,0,0,20348,212,70,7.6,True,6,False,0,1,0,16952,185,56,7.0,False,29.753933333333332,3396,6,1,282,241,41
BR1_2730944180,8,True,1,0,0,16570,203,48,6.8,True,6,False,0,0,0,14970,164,52,6.4,False,26.72755,1600,2,1,251,216,35
BR1_2730931178,12,True,0,0,0,19232,194,52,7.0,False,4,False,1,0,0,15353,175,56,6.4,True,26.503516666666666,3879,8,-1,246,231,15
BR1_2731650587,5,True,0,1,0,15395,172,60,6.8,False,4,False,1,0,0,15209,206,56,6.8,True,25.760266666666666,186,1,-1,232,262,-30
BR1_2731519800,4,True,1,0,0,14445,177,48,6.8,True,4,False,0,0,0,14829,180,52,6.6,False,26.09395,-384,0,1,225,232,-7
BR1_2730827168,6,False,0,0,0,15393,190,47,6.4,False,7,True,0,0,0,15953,189,57,6.6,True,25.75975,-560,-1,0,237,246,-9
BR1_2730801901,4,False,1,0,0,15202,196,46,7.0,False,10,True,0,1,1,20783,198,59,7.6,True,29.80415,-5581,-6,1,242,257,-15
BR1_2720938669,6,True,0,1,0,17031,204,56,6.8,True,8,False,1,0,0,16410,155,50,6.4,False,25.676316666666665,621,-2,-1,260,205,55
BR1_2698766999,10,True,0,0,0,18391,218,56,7.4,True,8,False,1,0,0,16062,140,44,6.8,False,27.592083333333335,2329,2,-1,274,184,90
BR1_2673851292,9,False,1,0,0,17603,219,56,7.8,True,7,True,0,1,0,18449,234,68,7.6,False,28.067783333333335,-846,2,1,275,302,-27
BR1_2715894506,6,False,0,0,0,16823,181,52,7.2,False,10,True,1,0,0,19052,205,64,7.4,True,27.681,-2229,-4,-1,233,269,-36
BR1_2692803360,4,True,0,0,0,13594,150,36,6.2,False,8,False,1,1,0,15873,168,56,7.0,True,26.74145,-2279,-4,-1,186,224,-38
BR1_2692526447,8,True,1,0,0,18316,196,56,7.0,False,13,False,0,1,0,19856,213,80,7.4,True,29.2605,-1540,-5,1,252,293,-41
BR1_2731699698,0,False,0,0,0,12922,148,56,6.4,False,6,True,1,0,0,17037,219,76,7.6,True,29.11905,-4115,-6,-1,204,295,-91
BR1_2731610015,9,True,1,0,0,18543,213,56,7.0,True,8,False,0,0,0,18604,249,56,7.6,False,29.353116666666665,-61,1,1,269,305,-36
BR1_2731693727,8,True,1,0,0,18887,233,64,7.6,True,7,False,0,0,0,16772,193,52,7.0,False,27.6257,2115,1,1,297,245,52
BR1_2731554129,11,True,1,1,0,18804,210,52,7.4,True,5,False,0,0,0,15290,175,44,6.8,False,27.505566666666667,3514,6,1,262,219,43
BR1_2730165750,5,True,1,1,1,19058,261,57,7.6,True,5,False,0,0,0,16846,236,72,7.8,False,29.9394,2212,0,1,318,308,10
BR1_2730042791,11,True,1,0,0,17650,192,40,7.0,True,4,False,0,0,0,15327,182,56,6.8,False,26.072033333333334,2323,7,1,232,238,-6
BR1_2731553929,4,False,1,0,0,14130,180,39,6.8,False,8,True,0,1,0,17950,200,67,7.4,True,25.178866666666668,-3820,-4,1,219,267,-48
BR1_2731634538,2,False,1,0,0,13337,159,48,6.2,False,10,True,0,0,0,16746,198,52,6.8,True,26.16755,-3409,-8,1,207,250,-43
BR1_2730770754,6,True,0,0,0,16433,177,43,6.4,True,9,False,0,1,0,16424,162,49,7.0,False,26.725416666666668,9,-3,0,220,211,9
BR1_2707243672,7,True,0,1,0,18250,223,42,7.4,True,5,False,1,0,0,15907,194,48,7.0,False,28.65886666666667,2343,2,-1,265,242,23
BR1_2707202167,9,True,1,0,0,16703,165,44,6.6,False,7,False,0,1,0,16848,211,36,7.0,True,27.10675,-145,2,1,209,247,-38
BR1_2728064570,9,False,0,1,0,18541,226,56,7.6,True,9,True,0,0,0,17420,220,47,7.0,False,28.5136,1121,0,0,282,267,15
BR1_2714881102,6,True,1,0,1,19397,247,48,7.4,True,5,False,0,0,0,17107,211,66,7.2,False,27.5149,2290,1,1,295,277,18
BR1_2714365632,8,True,1,1,1,19877,217,84,7.8,True,0,False,0,0,0,13204,201,20,6.6,False,29.4763,6673,8,1,301,221,80
BR1_2661651044,3,False,0,1,0,15092,199,56,7.4,False,8,True,0,0,0,17807,254,48,7.8,True,27.512716666666666,-2715,-5,0,255,302,-47
BR1_2724209405,6,True,1,1,0,16632,209,60,7.0,True,3,False,0,0,0,13313,177,40,6.6,False,25.567383333333332,3319,3,1,269,217,52
BR1_2694278157,8,False,0,0,0,18110,193,48,7.2,True,9,True,0,0,0,17879,190,52,7.2,False,28.213383333333333,231,-1,0,241,242,-1
BR1_2688802858,9,True,0,0,0,17735,197,48,6.8,True,6,False,0,0,0,15375,163,36,6.6,False,26.182966666666665,2360,3,0,245,199,46
BR1_2724514086,9,False,0,0,0,18081,209,56,7.4,True,6,True,1,0,0,16803,195,56,7.0,False,29.326533333333334,1278,3,-1,265,251,14
BR1_2731631659,3,False,0,0,0,13393,155,46,6.2,False,8,True,1,0,0,16979,224,58,7.0,True,26.353466666666666,-3586,-5,-1,201,282,-81
BR1_2731297992,11,False,0,0,0,19027,228,54,7.2,False,8,True,1,0,0,19056,212,68,7.2,True,29.5329,-29,3,-1,282,280,2
BR1_2729994199,4,False,0,0,0,15033,172,52,6.8,False,4,True,1,0,0,18218,232,68,7.6,True,27.53465,-3185,0,-1,224,300,-76
BR1_2723725314,4,False,0,0,0,14262,157,36,6.4,False,5,True,1,0,0,15065,168,44,6.6,True,25.693433333333335,-803,-1,-1,193,212,-19
BR1_2731601167,14,False,1,0,0,19297,156,48,6.6,True,11,True,0,0,0,17238,124,44,6.2,False,25.526783333333334,2059,3,1,204,168,36
BR1_2731662921,10,True,1,1,0,18327,207,56,7.4,True,3,False,0,0,0,15057,225,44,7.0,False,29.500933333333332,3270,7,1,263,269,-6
BR1_2730354868,3,False,0,0,0,15928,211,64,7.0,False,4,True,1,0,0,14994,204,48,6.8,True,29.7958,934,-1,-1,275,252,23
BR1_2729772857,5,True,0,1,0,16402,207,60,7.2,True,8,False,0,0,0,15798,164,40,6.8,False,26.685816666666668,604,-3,0,267,204,63
BR1_2728770656,8,True,0,0,0,15800,175,48,6.4,False,12,False,0,1,0,19862,210,28,6.8,True,25.12761666666667,-4062,-4,0,223,238,-15
BR1_2730700621,8,True,0,0,0,17920,208,36,7.0,True,5,False,1,0,0,16318,203,60,7.2,False,28.0912,1602,3,-1,244,263,-19
BR1_2730674869,7,True,0,1,0,16383,184,54,6.8,True,6,False,1,0,0,15909,189,57,6.6,False,25.88395,474,1,-1,238,246,-8
BR1_2710283648,14,True,1,0,0,18347,185,52,7.0,True,3,False,0,0,0,13709,180,48,6.6,False,26.585983333333335,4638,11,1,237,228,9
BR1_2710262797,3,False,0,1,0,14926,196,56,7.2,True,6,True,1,0,0,17279,187,68,7.4,False,28.322866666666666,-2353,-3,-1,252,255,-3
BR1_2706422666,7,False,0,0,0,16423,189,36,6.8,False,8,True,1,1,0,18338,190,63,6.8,True,29.6692,-1915,-1,-1,225,253,-28
BR1_2706392861,7,False,0,1,0,16081,177,46,7.4,True,10,True,0,0,0,18443,215,53,7.2,False,29.1104,-2362,-3,0,223,268,-45
BR1_2714001179,13,True,0,0,0,19294,162,64,7.0,False,11,False,0,0,0,19789,161,68,7.4,True,27.8481,-495,2,0,226,229,-3
BR1_2676371299,13,True,1,0,0,18610,175,40,7.2,True,2,False,0,0,0,14178,181,50,6.4,False,25.4202,4432,11,1,215,231,-16
BR1_2676363799,14,True,1,1,1,21951,191,59,7.0,False,13,False,0,0,0,21784,216,56,7.4,True,28.181266666666666,167,1,1,250,272,-22
BR1_2676361338,5,True,1,0,0,14989,175,63,7.0,True,8,False,0,1,0,16236,188,48,6.6,False,27.003533333333333,-1247,-3,1,238,236,2
BR1_2676349733,6,False,0,1,0,18556,193,56,7.0,False,14,True,1,0,0,20573,233,60,7.4,True,29.430766666666667,-2017,-8,-1,249,293,-44
BR1_2731613586,5,True,0,0,0,15683,202,44,6.6,True,6,False,0,1,0,16020,182,53,7.0,False,26.08635,-337,-1,0,246,235,11
BR1_2729999808,12,True,0,0,0,20186,255,60,7.4,True,2,False,1,0,0,12963,129,52,6.4,False,25.2354,7223,10,-1,315,181,134
BR1_2722487986,6,True,0,0,0,17796,225,68,7.6,False,7,False,1,1,0,19549,215,76,7.6,True,28.730316666666667,-1753,-1,-1,293,291,2
BR1_2666534864,7,False,0,0,0,15366,148,52,6.8,False,16,True,1,1,0,19477,159,44,7.2,True,25.879466666666666,-4111,-9,-1,200,203,-3
BR1_2730064113,11,True,1,1,1,19964,184,38,6.8,False,6,False,0,0,0,17515,216,56,7.4,True,28.914366666666666,2449,5,1,222,272,-50
BR1_2730770081,7,False,0,1,0,17469,197,56,7.2,True,2,True,0,0,0,16243,237,56,7.0,False,27.589666666666666,1226,5,0,253,293,-40
BR1_2731369788,6,False,1,1,0,15513,158,60,6.8,True,6,True,0,0,0,15345,164,52,6.6,False,25.476466666666667,168,0,1,218,216,2
BR1_2731359997,10,True,1,1,0,19343,208,48,7.0,True,6,False,0,0,0,16057,202,27,6.8,False,28.68625,3286,4,1,256,229,27
BR1_2731352925,7,False,1,0,0,17692,207,64,7.4,True,5,True,0,0,0,16647,202,56,7.2,False,27.666683333333335,1045,2,1,271,258,13
BR1_2731540882,3,False,1,0,0,15948,194,60,7.4,True,3,True,0,1,0,15504,182,64,7.2,False,28.73645,444,0,1,254,246,8
BR1_2731013096,9,False,0,1,0,17871,205,56,6.8,False,12,True,1,0,0,20227,247,68,7.4,True,29.80855,-2356,-3,-1,261,315,-54
BR1_2730996441,7,False,0,1,0,16244,136,47,6.6,False,11,True,0,0,0,18226,190,44,6.8,True,26.64431666666667,-1982,-4,0,183,234,-51
BR1_2704029427,5,False,1,0,0,15531,177,72,7.0,False,8,True,0,0,0,18447,231,43,7.2,True,28.279033333333334,-2916,-3,1,249,274,-25
BR1_2703979712,9,False,1,0,0,18529,218,56,7.2,False,6,True,0,0,0,17349,207,51,6.8,True,27.9891,1180,3,1,274,258,16
BR1_2731689681,5,False,0,0,0,16490,222,64,7.4,False,7,True,0,0,0,18677,237,52,7.2,True,27.633783333333334,-2187,-2,0,286,289,-3
BR1_2729123170,4,True,0,1,0,16822,228,70,7.4,False,8,False,1,0,0,18329,205,72,7.4,True,29.19173333333333,-1507,-4,-1,298,277,21
BR1_2686900398,8,True,0,1,0,18326,205,56,7.4,False,6,False,1,0,0,16909,234,52,7.6,True,28.96805,1417,2,-1,261,286,-25
BR1_2727621352,5,False,0,1,0,15405,177,55,6.8,True,9,True,0,0,0,16582,198,48,7.0,False,25.66225,-1177,-4,0,232,246,-14
BR1_2730538968,6,True,0,1,0,17826,195,64,7.6,True,6,False,1,0,0,17013,197,64,7.2,False,27.984183333333334,813,0,-1,259,261,-2
BR1_2727907201,11,True,1,1,0,18861,175,52,6.6,False,11,False,0,0,0,20062,221,64,7.0,True,29.8495,-1201,0,1,227,285,-58
BR1_2727881633,6,False,0,0,0,16203,184,56,7.2,False,4,True,1,0,0,14492,205,44,6.8,True,26.6674,1711,2,-1,240,249,-9
BR1_2706286340,11,True,0,0,0,18282,206,55,7.2,True,6,False,1,0,0,17977,248,56,7.2,False,27.687683333333332,305,5,-1,261,304,-43
BR1_2731368791,6,False,0,0,0,15829,184,36,6.8,False,9,True,1,0,0,17225,174,60,7.0,True,29.9524,-1396,-3,-1,220,234,-14
BR1_2731101038,4,False,0,0,0,16561,224,52,7.0,False,8,True,0,1,0,18686,247,68,7.6,True,29.0413,-2125,-4,0,276,315,-39
BR1_2731661869,7,True,0,0,0,14867,150,44,6.4,False,6,False,0,1,0,16379,194,44,6.6,True,26.390133333333335,-1512,1,0,194,238,-44
BR1_2721760303,7,True,0,0,0,18299,256,56,7.0,False,7,False,1,0,0,17991,237,68,7.6,True,29.811833333333333,308,0,-1,312,305,7
BR1_2730843266,8,True,1,0,0,18094,181,56,7.0,False,5,False,0,1,0,16513,197,60,7.2,True,28.97683333333333,1581,3,1,237,257,-20
BR1_2725999448,5,True,0,0,0,14042,170,40,6.8,False,6,False,1,0,0,15075,143,68,6.4,True,27.463533333333334,-1033,-1,-1,210,211,-1
BR1_2725553167,6,False,0,0,0,16861,191,72,7.0,False,8,True,1,0,0,18515,229,64,7.2,True,28.67181666666667,-1654,-2,-1,263,293,-30
BR1_2731287206,7,False,0,1,0,16549,202,67,6.8,False,9,True,1,0,0,16996,192,36,6.6,True,25.9571,-447,-2,-1,269,228,41
BR1_2728023570,5,True,0,1,0,18512,237,68,7.2,False,13,False,1,0,0,20551,264,44,7.6,True,28.95355,-2039,-8,-1,305,308,-3
BR1_2731691409,13,True,0,1,1,21207,212,52,7.4,True,5,False,0,0,0,14862,152,56,7.0,False,29.301683333333333,6345,8,0,264,208,56
BR1_2731681543,12,True,1,1,0,18409,161,48,6.8,True,3,False,0,0,0,14570,191,44,6.4,False,25.319433333333333,3839,9,1,209,235,-26
BR1_2722570085,9,False,0,1,0,18816,210,56,7.4,False,10,True,0,0,0,19555,218,48,7.6,True,28.15325,-739,-1,0,266,266,0
BR1_2730366296,4,False,0,0,0,15647,187,48,6.6,True,5,True,1,0,0,15705,189,60,7.2,False,26.4459,-58,-1,-1,235,249,-14
BR1_2663406771,10,True,0,0,0,17781,181,44,7.2,True,2,False,0,1,0,13323,137,48,6.0,False,27.017033333333334,4458,8,0,225,185,40
BR1_2728552058,6,True,0,0,0,16649,222,48,6.8,True,6,False,0,0,0,15050,188,43,6.6,False,26.506516666666666,1599,0,0,270,231,39
BR1_2728050266,10,True,1,0,0,16763,220,44,7.0,True,2,False,0,0,0,14291,192,48,6.4,False,25.4339,2472,8,1,264,240,24
BR1_2728025841,4,True,1,0,0,15444,184,64,6.8,True,4,False,0,1,0,15458,224,56,6.8,False,25.5615,-14,0,1,248,280,-32
BR1_2731567353,8,True,0,1,0,17411,159,50,7.2,False,7,False,0,0,0,17431,188,52,7.2,True,29.62398333333333,-20,1,0,209,240,-31
BR1_2731539715,5,True,1,0,0,14995,172,44,6.6,True,2,False,0,0,0,13399,160,40,6.0,False,25.551233333333332,1596,3,1,216,200,16
BR1_2731481651,8,True,1,0,0,17273,177,56,7.0,True,5,False,0,1,0,14585,185,48,6.8,False,25.537933333333335,2688,3,1,233,233,0
BR1_2721410927,2,True,0,0,1,16615,210,56,7.2,False,2,False,1,1,0,15041,176,72,6.8,True,29.93655,1574,0,-1,266,248,18
BR1_2694594860,9,False,1,0,0,17639,188,48,6.6,False,19,True,0,1,1,25210,227,52,7.6,True,29.76735,-7571,-10,1,236,279,-43
BR1_2678950947,15,True,1,1,0,21152,202,60,7.8,True,2,False,0,0,0,14737,164,64,6.6,False,27.520333333333333,6415,13,1,262,228,34
BR1_2678834599,7,False,0,0,0,18960,272,36,7.6,False,9,True,1,0,0,18726,206,60,7.4,True,29.500283333333332,234,-2,-1,308,266,42
BR1_2729217539,14,True,1,0,0,21367,206,44,7.6,True,8,False,0,1,0,17371,178,64,7.2,False,28.414083333333334,3996,6,1,250,242,8
BR1_2731167927,4,False,0,1,0,14873,165,64,6.8,False,5,True,0,0,0,15919,210,52,6.8,True,27.350216666666668,-1046,-1,0,229,262,-33
BR1_2722950766,8,True,0,0,0,18108,208,56,7.4,True,6,False,1,1,0,16096,162,68,7.0,False,27.851916666666668,2012,2,-1,264,230,34
BR1_2730769011,3,False,0,0,0,13808,160,44,6.4,False,4,True,1,1,0,16185,192,58,7.0,True,27.283966666666668,-2377,-1,-1,204,250,-46
BR1_2730800816,8,True,0,0,0,15956,183,56,6.6,True,3,False,1,0,0,14607,166,39,6.0,False,26.0914,1349,5,-1,239,205,34
BR1_2730712569,10,True,0,1,0,19526,243,44,7.2,True,6,False,0,0,0,16747,186,52,7.0,False,29.3912,2779,4,0,287,238,49
BR1_2730378242,7,False,0,0,0,15463,183,40,6.8,True,8,True,0,0,0,15897,180,44,6.6,False,26.76931666666667,-434,-1,0,223,224,-1
BR1_2695598731,6,False,0,0,0,15458,185,52,6.8,False,7,True,1,0,0,15403,191,40,6.8,True,25.849016666666667,55,-1,-1,237,231,6
BR1_2688346482,2,False,1,1,0,15589,218,60,7.2,True,5,True,0,0,0,16622,201,48,7.6,False,29.71405,-1033,-3,1,278,249,29
BR1_2695532835,5,False,1,0,0,16584,199,60,6.8,True,3,True,0,0,0,13580,173,43,6.8,False,26.34685,3004,2,1,259,216,43
BR1_2695484290,3,False,1,0,0,16129,211,60,7.8,True,3,True,0,0,0,16103,220,44,7.4,False,28.4919,26,0,1,271,264,7
BR1_2695448553,10,False,0,0,0,18045,209,59,7.4,True,7,True,0,0,0,17598,189,42,7.0,False,28.189433333333334,447,3,0,268,231,37
BR1_2724074023,8,False,0,1,0,18447,205,60,7.2,False,8,True,1,0,0,18377,228,64,7.4,True,28.902616666666667,70,0,-1,265,292,-27
BR1_2719360799,16,True,1,1,0,23540,255,69,7.8,True,4,False,0,0,0,16389,214,54,7.0,False,29.221533333333333,7151,12,1,324,268,56
BR1_2719341676,6,False,1,0,0,15039,181,54,6.8,False,3,True,0,0,0,15383,199,50,6.8,True,25.148983333333334,-344,3,1,235,249,-14
BR1_2708816233,4,False,0,0,0,15027,187,40,6.8,True,3,True,0,0,0,14216,174,64,6.8,False,25.98125,811,1,0,227,238,-11
BR1_2708807863,2,True,1,0,0,13658,186,60,7.0,True,1,False,0,0,0,14159,197,72,7.0,False,26.7826,-501,1,1,246,269,-23
BR1_2722875150,9,False,0,0,0,18398,194,48,7.0,True,10,True,1,0,0,18713,220,52,7.2,False,29.763466666666666,-315,-1,-1,242,272,-30
BR1_2731549170,5,False,0,0,0,15411,221,34,7.0,True,7,True,0,1,0,16429,183,56,7.2,False,28.9047,-1018,-2,0,255,239,16
BR1_2726213178,4,True,0,0,0,14132,182,48,6.6,False,9,False,0,0,0,16813,196,52,6.8,True,27.194483333333334,-2681,-5,0,230,248,-18
BR1_2731610957,10,True,0,0,0,18619,206,44,7.0,True,6,False,1,0,0,16256,180,52,7.2,False,28.744933333333332,2363,4,-1,250,232,18
BR1_2702587560,6,False,0,1,0,14762,157,52,6.4,False,11,True,0,0,0,18440,212,36,7.0,True,26.782983333333334,-3678,-5,0,209,248,-39
BR1_2692206271,4,False,0,1,0,15648,183,52,7.2,False,7,True,1,0,0,17560,195,60,7.2,True,29.83255,-1912,-3,-1,235,255,-20
BR1_2666199077,6,False,0,0,0,14857,159,48,6.6,False,10,True,1,0,0,16310,184,60,7.0,True,25.628933333333332,-1453,-4,-1,207,244,-37
BR1_2731267821,12,True,1,0,0,18070,218,56,6.8,True,4,False,0,0,0,14280,182,56,6.6,False,26.313316666666665,3790,8,1,274,238,36
BR1_2731216600,10,True,1,0,0,19733,219,56,7.6,False,8,False,0,1,0,18288,204,60,7.2,True,29.73046666666667,1445,2,1,275,264,11
BR1_2727093423,6,False,0,0,0,15604,188,48,7.0,False,9,True,0,0,0,17119,167,52,6.8,True,26.7137,-1515,-3,0,236,219,17
BR1_2707837953,6,True,0,0,0,17420,235,48,7.2,True,8,False,1,1,0,17918,187,44,7.2,False,29.656966666666666,-498,-2,-1,283,231,52
BR1_2722958794,5,False,0,1,1,18028,201,64,7.4,False,8,True,0,0,0,19398,236,59,7.6,True,29.413183333333333,-1370,-3,0,265,295,-30
BR1_2722916334,6,False,1,0,0,16459,187,64,6.8,True,8,True,0,0,0,17374,220,24,6.8,False,28.647183333333334,-915,-2,1,251,244,7
BR1_2722862148,4,False,0,0,0,14685,187,52,6.4,False,11,True,0,0,0,18931,216,44,7.0,True,26.56535,-4246,-7,0,239,260,-21
BR1_2731047969,8,True,0,0,0,16468,177,48,7.2,False,8,False,1,0,0,17813,203,56,7.0,True,28.187416666666667,-1345,0,-1,225,259,-34
BR1_2730939001,4,False,0,0,0,14771,166,52,6.6,True,5,True,0,0,0,15343,193,52,6.8,False,26.809783333333332,-572,-1,0,218,245,-27
BR1_2727119944,4,False,0,0,0,15891,168,52,7.0,True,7,True,0,0,0,17054,204,40,7.0,False,28.85655,-1163,-3,0,220,244,-24
BR1_2666073049,7,True,1,1,0,19404,223,75,7.4,True,5,False,0,0,0,16913,208,72,7.6,False,29.842616666666668,2491,2,1,298,280,18
BR1_2731587283,12,True,1,1,0,19985,204,72,7.6,True,6,False,0,0,0,16086,160,56,7.0,False,28.70665,3899,6,1,276,216,60
BR1_2731520537,6,True,0,1,1,19505,218,64,7.6,True,9,False,1,0,0,17048,139,64,6.8,False,28.670683333333333,2457,-3,-1,282,203,79
BR1_2710959115,5,False,0,0,0,17280,219,52,7.2,False,8,True,1,1,0,17848,206,48,7.4,True,28.984166666666667,-568,-3,-1,271,254,17
BR1_2683441365,4,False,1,0,0,14366,194,46,7.0,False,5,True,0,1,0,16609,233,44,6.8,True,27.223666666666666,-2243,-1,1,240,277,-37
BR1_2731525940,8,False,0,0,0,16378,182,48,7.0,True,6,True,0,0,0,16343,222,60,7.0,False,25.898233333333334,35,2,0,230,282,-52
BR1_2731668286,9,False,0,0,0,15809,168,40,6.6,True,3,True,1,0,0,13506,152,60,6.6,False,27.45243333333333,2303,6,-1,208,212,-4
BR1_2708161495,8,False,0,0,0,16017,155,44,6.4,False,7,True,0,0,0,14923,164,48,6.4,True,27.48325,1094,1,0,199,212,-13
BR1_2728503828,5,True,0,1,0,15681,195,40,7.0,False,6,False,0,0,0,16158,210,64,7.4,True,29.04205,-477,-1,0,235,274,-39
BR1_2710928284,11,True,1,0,0,17371,131,55,6.6,False,9,False,0,0,0,18252,183,48,6.8,True,26.503916666666665,-881,2,1,186,231,-45
BR1_2716277822,8,False,0,0,0,16853,193,57,7.0,True,4,True,1,0,0,14490,188,42,7.0,False,25.48175,2363,4,-1,250,230,20
BR1_2731521252,7,False,1,1,0,17642,201,48,7.0,True,5,True,0,0,0,15672,184,56,6.8,False,28.069433333333333,1970,2,1,249,240,9
BR1_2730744041,11,True,0,0,0,19236,191,56,7.0,True,7,False,0,0,0,17168,149,72,6.6,False,29.222583333333333,2068,4,0,247,221,26
BR1_2730611415,6,False,1,0,0,16850,182,76,7.0,False,9,True,0,1,0,18709,230,58,7.2,True,29.104216666666666,-1859,-3,1,258,288,-30
BR1_2728332538,7,False,0,0,0,16026,181,52,7.0,True,8,True,0,0,0,19227,236,48,7.2,False,29.494133333333334,-3201,-1,0,233,284,-51
BR1_2730502415,4,True,0,1,0,17304,225,56,7.2,False,8,False,1,0,0,18063,212,64,7.4,True,27.961433333333332,-759,-4,-1,281,276,5
BR1_2730110332,6,False,0,0,0,15022,176,44,6.6,False,10,True,1,0,0,18396,237,60,7.2,True,26.76675,-3374,-4,-1,220,297,-77
BR1_2729218235,6,False,0,0,0,16532,197,44,7.2,False,12,True,0,0,0,19435,208,56,7.2,True,27.63415,-2903,-6,0,241,264,-23
BR1_2695692346,7,True,0,1,0,19093,208,52,7.4,False,7,False,1,0,0,16956,172,56,6.8,True,29.86925,2137,0,-1,260,228,32
BR1_2731213802,3,False,0,1,0,13577,165,66,6.8,False,6,True,1,0,0,15545,181,36,7.0,True,26.302483333333335,-1968,-3,-1,231,217,14
BR1_2728992992,7,False,0,1,0,16066,164,68,6.8,False,13,True,1,0,0,18658,187,64,7.2,True,25.164833333333334,-2592,-6,-1,232,251,-19
BR1_2730326347,3,False,0,0,0,14253,225,40,7.0,False,4,True,1,0,0,15173,219,56,6.8,True,25.822883333333333,-920,-1,-1,265,275,-10
BR1_2730267324,5,False,0,1,0,18911,257,64,7.6,True,7,True,1,0,0,17726,252,46,7.4,False,29.677483333333335,1185,-2,-1,321,298,23
BR1_2729504800,13,True,0,0,0,20260,212,32,6.8,True,15,False,0,0,0,21388,205,54,7.0,False,29.97455,-1128,-2,0,244,259,-15
BR1_2731152621,2,False,0,0,0,13347,180,48,6.6,False,9,True,1,0,0,17671,212,64,7.2,True,27.037766666666666,-4324,-7,-1,228,276,-48
BR1_2731106160,7,True,0,0,0,17475,206,55,7.0,False,12,False,1,0,0,20701,245,64,7.4,True,27.93445,-3226,-5,-1,261,309,-48
BR1_2731034122,4,True,0,1,0,14470,158,40,6.6,False,10,False,1,0,0,17327,164,42,6.2,True,25.251916666666666,-2857,-6,-1,198,206,-8
BR1_2711016590,15,False,0,0,0,21511,231,36,7.2,True,12,True,0,0,0,18636,167,56,6.4,False,29.456883333333334,2875,3,0,267,223,44
BR1_2731427445,4,False,0,0,0,14319,213,32,6.6,False,9,True,1,0,0,17907,201,68,7.4,True,26.701983333333335,-3588,-5,-1,245,269,-24
BR1_2724407172,6,True,1,0,0,17455,196,62,7.0,True,4,False,0,0,0,15683,197,60,7.0,False,28.027483333333333,1772,2,1,258,257,1
BR1_2727471356,4,False,1,0,0,14632,166,48,6.6,True,5,True,0,0,0,15755,196,52,6.8,False,26.076133333333335,-1123,-1,1,214,248,-34
BR1_2727735237,10,False,0,0,0,17770,146,52,6.6,False,14,True,1,1,1,20934,183,52,7.0,True,29.44315,-3164,-4,-1,198,235,-37
BR1_2727564676,8,True,0,1,0,18612,200,36,7.2,False,13,False,0,0,0,18706,194,48,7.2,True,28.369633333333333,-94,-5,0,236,242,-6
BR1_2668676032,9,True,1,0,0,18970,199,44,7.4,True,5,False,0,0,0,16090,230,48,6.8,False,27.58545,2880,4,1,243,278,-35
BR1_2668630916,17,True,0,1,0,21644,192,56,7.6,True,10,False,0,0,0,18516,162,48,6.8,False,29.667,3128,7,0,248,210,38
BR1_2727892975,15,True,0,0,0,20936,225,44,7.8,True,5,False,1,0,0,16316,194,60,7.0,False,27.686883333333334,4620,10,-1,269,254,15
BR1_2729069597,7,True,0,0,0,15956,190,44,6.6,True,6,False,0,0,0,14456,162,40,6.4,False,26.022366666666667,1500,1,0,234,202,32
BR1_2729038634,10,True,0,0,0,19340,178,64,7.4,True,3,False,1,1,0,15918,195,60,7.2,False,28.486933333333333,3422,7,-1,242,255,-13
BR1_2728510496,8,False,1,0,0,17085,177,56,7.0,True,9,True,0,0,0,16214,130,36,6.6,False,26.129383333333333,871,-1,1,233,166,67
BR1_2727032017,9,False,0,1,0,16433,155,40,6.4,False,8,True,1,0,0,16271,167,40,6.6,True,26.03475,162,1,-1,195,207,-12
BR1_2723822525,7,False,1,0,0,16395,191,52,6.8,True,6,True,0,1,0,14913,148,32,6.6,False,25.1441,1482,1,1,243,180,63
BR1_2722974823,9,False,0,0,0,19705,241,44,7.2,True,10,True,1,0,0,18284,162,52,6.8,False,29.635283333333334,1421,-1,-1,285,214,71
BR1_2722878874,3,False,0,0,0,14398,176,48,6.6,False,9,True,1,1,0,17893,177,56,7.0,True,27.281683333333334,-3495,-6,-1,224,233,-9
BR1_2720286199,2,False,0,0,0,16121,243,60,7.4,False,7,True,0,0,0,17943,249,52,7.8,True,29.653983333333333,-1822,-5,0,303,301,2
BR1_2730190584,2,False,0,0,0,13696,189,48,6.6,False,7,True,1,0,0,16280,195,48,6.8,True,25.99255,-2584,-5,-1,237,243,-6
BR1_2730105016,5,False,1,0,1,15032,147,51,6.4,False,4,True,0,0,1,18161,221,32,7.2,True,28.0326,-3129,1,1,198,253,-55
BR1_2731602617,11,False,0,1,0,18746,193,48,7.0,True,5,True,1,0,0,16084,166,56,7.0,False,25.0791,2662,6,-1,241,222,19
BR1_2731523371,8,True,0,0,0,17024,214,44,7.4,False,6,False,1,0,0,16240,205,44,7.2,True,29.728016666666665,784,2,-1,258,249,9
BR1_2731084818,5,True,0,1,0,15603,163,44,7.2,False,2,False,1,0,0,14440,168,64,7.0,True,28.6398,1163,3,-1,207,232,-25
BR1_2730906927,3,False,0,0,0,16032,260,40,7.4,True,4,True,1,1,0,17346,223,64,7.4,False,29.143633333333334,-1314,-1,-1,300,287,13
BR1_2730426675,6,False,1,0,0,18314,235,66,7.2,True,8,True,0,0,0,18993,246,48,7.4,False,29.5387,-679,-2,1,301,294,7
BR1_2715641117,6,False,1,1,0,17182,192,60,7.2,True,6,True,0,0,0,16968,206,52,7.2,False,28.9757,214,0,1,252,258,-6
BR1_2714996460,7,False,1,1,0,17553,190,80,7.2,True,7,True,0,0,0,17442,199,40,7.0,False,29.144183333333334,111,0,1,270,239,31
BR1_2730763876,15,True,1,0,0,21154,210,56,7.0,True,7,False,0,0,0,16688,195,56,6.8,False,28.76895,4466,8,1,266,251,15
BR1_2701743793,5,True,1,0,0,15207,195,60,6.8,False,0,False,0,0,0,13844,195,56,6.8,True,26.207133333333335,1363,5,1,255,251,4
BR1_2708497065,8,True,0,0,0,16139,159,56,6.6,False,7,False,1,0,0,16393,205,48,6.8,True,27.4038,-254,1,-1,215,253,-38
BR1_2693821094,10,True,0,0,0,18412,220,55,7.2,True,4,False,0,0,0,15459,202,36,7.0,False,29.578583333333334,2953,6,0,275,238,37
BR1_2731069273,7,True,1,0,0,16542,165,52,6.8,True,4,False,0,0,0,14677,134,64,6.6,False,25.968616666666666,1865,3,1,217,198,19
BR1_2730450835,10,False,0,0,0,18915,186,56,6.8,True,10,True,1,0,0,18666,161,48,6.2,False,28.884833333333333,249,0,-1,242,209,33
BR1_2730444684,6,True,1,1,0,15882,181,56,7.0,True,5,False,0,0,0,15025,175,68,7.0,False,25.31276666666667,857,1,1,237,243,-6
BR1_2730515649,6,False,0,0,0,18278,263,52,7.4,False,4,True,1,1,0,17003,232,66,7.4,True,28.273566666666667,1275,2,-1,315,298,17
BR1_2719850837,3,False,0,0,0,14685,169,48,6.2,False,10,True,1,1,1,19688,193,56,7.4,True,28.7374,-5003,-7,-1,217,249,-32
BR1_2723071749,9,True,0,1,0,19709,216,61,7.4,True,5,False,1,0,0,15375,162,48,6.8,False,29.238916666666668,4334,4,-1,277,210,67
BR1_2731320747,5,False,0,0,0,15814,150,40,6.2,False,11,True,1,0,0,19804,232,56,7.2,True,29.876266666666666,-3990,-6,-1,190,288,-98
BR1_2723447247,7,False,0,0,0,14890,176,39,6.6,False,11,True,0,0,0,18746,233,64,7.0,True,27.2161,-3856,-4,0,215,297,-82
BR1_2723412923,11,False,0,0,0,18510,182,44,7.0,False,15,True,1,1,0,20286,151,60,6.8,True,28.09205,-1776,-4,-1,226,211,15
BR1_2731578356,4,False,0,0,0,14538,164,56,6.4,True,7,True,1,0,0,15893,169,40,6.2,False,26.237783333333333,-1355,-3,-1,220,209,11
BR1_2709494733,6,True,0,0,0,15458,162,56,6.8,True,7,False,1,0,0,15645,157,40,6.8,False,25.003916666666665,-187,-1,-1,218,197,21
BR1_2707460621,8,True,1,0,0,16770,186,52,6.6,True,3,False,0,0,0,12773,125,48,6.4,False,25.528433333333332,3997,5,1,238,173,65
BR1_2707433440,7,False,0,0,0,15446,141,56,6.8,False,8,True,1,0,0,16702,189,49,6.6,True,26.6442,-1256,-1,-1,197,238,-41
BR1_2714676480,8,True,1,0,0,18264,244,55,7.4,True,7,False,0,1,0,18739,190,64,7.4,False,27.7872,-475,1,1,299,254,45
BR1_2731620558,7,False,0,0,0,16596,174,52,7.2,True,5,True,0,0,0,14615,179,44,6.6,False,27.259266666666665,1981,2,0,226,223,3
BR1_2731591818,6,False,0,1,0,16399,140,63,6.8,False,21,True,1,0,0,21310,195,40,7.2,True,28.7004,-4911,-15,-1,203,235,-32
BR1_2730877587,14,True,0,0,0,19915,173,50,7.0,True,10,False,0,0,0,17072,155,40,7.0,False,29.52805,2843,4,0,223,195,28
BR1_2730858774,12,True,0,0,0,18875,186,72,7.2,True,6,False,0,1,0,16061,154,52,6.6,False,26.212233333333334,2814,6,0,258,206,52
BR1_2731064380,10,False,0,1,0,18269,188,48,7.0,False,14,True,1,0,0,21098,251,60,7.4,True,29.4364,-2829,-4,-1,236,311,-75
BR1_2731042633,8,True,0,1,0,17676,213,42,6.8,True,10,False,1,0,0,20166,240,64,7.4,False,29.039733333333334,-2490,-2,-1,255,304,-49
BR1_2730084109,7,False,1,0,0,18560,226,54,7.6,False,5,True,0,0,0,17271,215,65,7.4,True,28.949083333333334,1289,2,1,280,280,0
BR1_2722219342,2,False,0,0,0,13846,181,51,6.2,False,16,True,1,0,0,19105,190,60,6.8,True,26.738183333333332,-5259,-14,-1,232,250,-18
BR1_2729666714,10,True,0,0,0,16681,153,40,6.2,False,15,False,1,0,0,20423,196,68,7.2,True,25.883183333333335,-3742,-5,-1,193,264,-71
BR1_2728208227,10,False,1,1,0,18931,206,60,7.4,True,7,True,0,0,0,18612,227,60,7.2,False,27.900433333333332,319,3,1,266,287,-21
BR1_2731089093,7,False,1,0,0,18030,206,64,7.4,True,3,True,0,0,0,15487,205,52,7.0,False,27.54515,2543,4,1,270,257,13
BR1_2730443990,4,False,0,0,0,15328,212,52,7.2,False,7,True,1,0,0,16987,190,48,7.2,True,29.007666666666665,-1659,-3,-1,264,238,26
BR1_2721321092,9,True,1,0,0,18292,211,48,6.8,True,5,False,0,0,0,15621,185,48,6.8,False,26.775716666666668,2671,4,1,259,233,26
BR1_2728385775,4,False,0,0,0,15074,194,36,6.8,False,10,True,1,1,1,19599,181,60,7.6,True,29.982516666666665,-4525,-6,-1,230,241,-11
BR1_2731548353,8,False,1,0,0,16834,190,60,6.4,False,8,True,0,0,0,15617,153,56,6.4,True,26.70965,1217,0,1,250,209,41
BR1_2724901015,7,True,0,0,0,17686,171,64,6.6,False,7,False,1,0,0,17846,192,64,7.0,True,27.679366666666667,-160,0,-1,235,256,-21
BR1_2696904564,3,False,1,0,0,14686,169,56,6.4,False,12,True,0,0,0,19047,191,46,7.0,True,25.0977,-4361,-9,1,225,237,-12
BR1_2696885070,7,False,1,0,0,16307,170,60,6.8,True,9,True,0,0,0,16822,206,56,7.0,False,26.546683333333334,-515,-2,1,230,262,-32
BR1_2725256847,12,False,0,0,0,20063,204,88,7.4,True,11,True,0,0,0,19062,197,36,6.8,False,28.423016666666665,1001,1,0,292,233,59
BR1_2730461333,3,False,0,1,0,16001,179,48,7.0,False,12,True,1,0,0,18928,198,56,7.4,True,29.419933333333333,-2927,-9,-1,227,254,-27
BR1_2731013413,5,True,0,0,0,17908,196,60,7.4,False,13,False,0,1,0,20184,199,48,7.4,True,28.592466666666667,-2276,-8,0,256,247,9
BR1_2730981643,4,True,0,0,0,13725,156,40,6.6,False,9,False,1,0,0,17040,185,56,7.0,True,26.710716666666666,-3315,-5,-1,196,241,-45
BR1_2730919079,3,False,0,0,0,14086,174,52,6.8,False,6,True,1,1,0,15034,158,56,6.8,True,25.7191,-948,-3,-1,226,214,12
BR1_2729794610,11,False,0,1,1,21431,214,50,7.0,True,7,True,1,0,0,17040,189,60,7.2,False,28.256016666666667,4391,4,-1,264,249,15
BR1_2726974022,2,False,1,0,0,14154,184,52,6.6,False,4,True,0,0,0,14831,171,68,7.0,True,26.689933333333332,-677,-2,1,236,239,-3
BR1_2726765394,10,False,0,1,0,18152,198,43,7.2,True,9,True,1,0,0,18568,204,56,7.4,False,27.921983333333333,-416,1,-1,241,260,-19
BR1_2724423898,6,False,0,0,0,17446,199,52,7.6,False,6,True,1,0,0,16509,197,48,7.2,True,29.007783333333332,937,0,-1,251,245,6
BR1_2730793644,8,False,1,0,0,16515,189,48,6.6,True,7,True,0,0,0,15834,174,47,6.6,False,26.1339,681,1,1,237,221,16
BR1_2730052257,6,True,0,0,0,15943,188,52,6.6,True,5,False,1,0,0,14456,157,48,6.6,False,25.975883333333332,1487,1,-1,240,205,35
BR1_2731560335,6,False,0,0,0,17162,198,44,7.0,False,13,True,1,1,0,19846,204,64,7.4,True,29.97965,-2684,-7,-1,242,268,-26
BR1_2731546707,4,False,0,1,0,16231,213,51,6.8,True,7,True,1,0,0,15982,183,52,7.0,False,25.341066666666666,249,-3,-1,264,235,29
BR1_2725048985,4,False,1,0,0,15203,171,49,6.8,False,2,True,0,1,0,16311,229,66,7.2,True,28.1423,-1108,2,1,220,295,-75
BR1_2724901098,11,True,1,0,0,18701,225,52,7.0,True,2,False,0,0,0,13496,165,48,6.6,False,25.247566666666668,5205,9,1,277,213,64
BR1_2729925199,9,True,1,0,0,18115,195,48,6.8,True,6,False,0,0,0,15227,160,60,6.8,False,25.63235,2888,3,1,243,220,23
BR1_2731368750,12,True,0,0,0,18549,186,56,7.4,False,8,False,0,0,0,18649,195,68,7.4,True,28.6463,-100,4,0,242,263,-21
BR1_2730034177,8,True,1,1,0,17754,190,64,7.2,False,9,False,0,0,0,18299,223,48,7.2,True,28.220716666666668,-545,-1,1,254,271,-17
BR1_2723896212,7,False,0,1,1,19104,227,64,7.2,True,8,True,0,0,0,17927,194,52,6.8,False,27.66445,1177,-1,0,291,246,45
BR1_2731432042,8,True,1,1,0,18676,208,56,7.0,True,6,False,0,0,0,16731,174,40,7.0,False,29.745083333333334,1945,2,1,264,214,50
BR1_2731394826,11,False,1,1,1,20062,196,60,7.2,True,7,True,0,0,0,16195,171,34,6.2,False,29.37685,3867,4,1,256,205,51
BR1_2698772580,6,True,0,0,0,16240,214,44,7.0,False,5,False,0,1,0,15135,199,52,7.0,True,25.673566666666666,1105,1,0,258,251,7
BR1_2698763240,7,False,0,0,1,18062,202,60,7.4,False,9,True,1,1,0,18559,218,40,7.2,True,28.13596666666667,-497,-2,-1,262,258,4
BR1_2731621387,8,True,1,0,0,18428,226,52,7.2,True,4,False,0,0,0,17574,268,72,7.2,False,29.002666666666666,854,4,1,278,340,-62
BR1_2731580108,13,True,1,0,0,19712,188,52,6.8,True,6,False,0,0,0,16091,192,48,6.6,False,26.455333333333332,3621,7,1,240,240,0
BR1_2731564321,3,False,0,0,0,14914,223,64,7.0,False,4,True,1,0,0,15202,218,62,6.8,True,25.1891,-288,-1,-1,287,280,7
BR1_2710236591,10,False,0,1,0,18635,193,60,7.6,True,9,True,0,0,0,17881,231,48,7.4,False,27.713816666666666,754,1,0,253,279,-26
BR1_2710193564,8,False,0,1,0,18087,199,60,7.4,True,5,True,0,0,0,17359,242,52,7.2,False,29.684933333333333,728,3,0,259,294,-35
BR1_2704663069,15,False,1,0,0,20910,174,44,7.0,True,15,True,0,0,0,19818,163,44,6.8,False,29.5046,1092,0,1,218,207,11
BR1_2730335061,9,True,0,1,0,18150,198,52,7.0,False,6,False,1,0,0,19212,268,64,7.4,True,29.864466666666665,-1062,3,-1,250,332,-82
BR1_2731213183,12,True,1,1,0,20278,190,56,7.4,True,6,False,0,0,0,16379,180,52,7.0,False,29.559233333333335,3899,6,1,246,232,14
BR1_2721320045,8,False,0,0,0,17138,194,43,7.0,True,19,True,1,1,0,24993,196,52,7.2,False,27.629766666666665,-7855,-11,-1,237,248,-11
BR1_2721286447,8,False,1,0,0,16764,169,61,6.6,False,13,True,0,1,0,18782,187,42,6.8,True,26.86105,-2018,-5,1,230,229,1
BR1_2730811915,9,True,1,0,0,19164,239,59,7.0,True,5,False,0,0,0,15977,184,44,6.6,False,28.223683333333334,3187,4,1,298,228,70
BR1_2727224628,8,True,1,1,0,17244,184,52,6.8,True,11,False,0,0,0,17888,152,40,6.8,False,28.19515,-644,-3,1,236,192,44
BR1_2729878411,4,True,0,0,0,14189,165,32,6.0,False,12,False,1,0,0,18635,223,56,7.0,True,26.422266666666665,-4446,-8,-1,197,279,-82
BR1_2731028634,8,True,1,0,0,18563,222,56,7.2,False,4,False,0,0,0,16930,210,67,7.6,True,29.299716666666665,1633,4,1,278,277,1
BR1_2697047598,5,False,0,0,0,15984,182,60,7.0,False,12,True,1,1,1,21584,233,56,7.2,True,28.43165,-5600,-7,-1,242,289,-47
BR1_2723335245,5,False,0,0,0,15954,214,44,7.0,True,7,True,1,0,0,16815,165,62,7.0,False,29.74135,-861,-2,-1,258,227,31
BR1_2722718588,6,True,0,0,0,16086,210,47,6.8,True,4,False,1,0,0,14052,141,64,6.8,False,27.13475,2034,2,-1,257,205,52
BR1_2680541049,6,True,1,1,0,17706,209,60,7.2,True,9,False,0,0,0,17903,204,48,7.2,False,28.788116666666667,-197,-3,1,269,252,17
BR1_2680482123,5,False,0,0,0,16573,188,52,7.2,False,9,True,1,0,0,18834,209,80,7.6,True,29.35525,-2261,-4,-1,240,289,-49
BR1_2687683612,16,True,1,0,0,18052,147,44,6.6,True,6,False,0,0,0,15696,162,43,6.6,False,27.401983333333334,2356,10,1,191,205,-14
BR1_2685458736,14,True,1,1,0,20787,137,58,7.2,False,8,False,0,0,0,18708,239,44,7.0,True,28.147,2079,6,1,195,283,-88
BR1_2729117523,7,True,1,1,0,17493,202,66,7.4,True,8,False,0,0,0,17793,237,44,7.2,False,28.31436666666667,-300,-1,1,268,281,-13
BR1_2725681515,10,True,0,0,0,16406,145,68,6.8,True,11,False,1,1,0,19138,189,59,7.0,False,25.0613,-2732,-1,-1,213,248,-35
BR1_2731209468,11,True,0,0,0,19793,200,52,7.2,False,10,False,1,1,0,18908,200,64,7.2,True,28.48315,885,1,-1,252,264,-12
BR1_2730730826,6,True,1,1,0,17549,215,60,7.2,True,6,False,0,0,0,14824,145,40,6.6,False,28.1023,2725,0,1,275,185,90
BR1_2730332265,5,False,0,1,0,16325,178,56,7.0,False,14,True,0,0,0,19243,155,48,6.8,True,28.152983333333335,-2918,-9,0,234,203,31
BR1_2731646739,4,False,0,1,0,14839,130,64,6.2,True,8,True,1,0,0,16572,172,44,6.6,False,25.69075,-1733,-4,-1,194,216,-22
BR1_2716116319,14,True,0,0,0,20520,205,40,7.2,True,10,False,0,0,0,18169,200,50,7.4,False,28.345433333333332,2351,4,0,245,250,-5
BR1_2717241180,5,False,0,1,0,15722,165,60,7.2,False,10,True,1,0,0,18261,197,44,7.4,True,28.47555,-2539,-5,-1,225,241,-16
BR1_2719052030,8,True,1,0,0,15500,137,51,6.4,True,1,False,0,0,0,13882,199,53,6.8,False,26.554766666666666,1618,7,1,188,252,-64
BR1_2729192697,6,True,1,1,0,17412,193,52,7.6,True,6,False,0,0,0,17004,200,64,7.2,False,29.09675,408,0,1,245,264,-19
BR1_2731624010,4,False,0,0,0,15296,218,24,6.6,False,8,True,0,0,0,18030,217,56,7.4,True,28.72355,-2734,-4,0,242,273,-31
BR1_2731517838,12,True,1,0,0,18603,219,48,7.0,True,5,False,0,0,0,14591,167,44,6.2,False,26.9985,4012,7,1,267,211,56
BR1_2730189344,8,False,0,0,0,17876,232,44,7.6,False,7,True,1,1,0,18673,226,58,7.4,True,28.743516666666668,-797,1,-1,276,284,-8
BR1_2730122482,5,False,0,0,0,15255,177,49,6.4,False,10,True,1,1,0,17501,146,63,6.4,True,25.4565,-2246,-5,-1,226,209,17
BR1_2726480171,3,True,0,0,0,14574,189,55,6.6,True,5,False,0,0,0,13594,167,32,6.0,False,25.7664,980,-2,0,244,199,45
BR1_2730882822,7,False,0,0,0,16497,217,40,7.0,True,7,True,1,1,0,15048,165,52,6.8,False,25.208116666666665,1449,0,-1,257,217,40
BR1_2728581334,7,True,0,0,0,18398,243,66,7.6,False,5,False,0,0,0,17804,245,60,7.6,True,28.02375,594,2,0,309,305,4
BR1_2717456079,7,True,0,0,0,17003,185,64,7.4,False,5,False,1,0,0,16306,186,56,7.2,True,29.661083333333334,697,2,-1,249,242,7
BR1_2717101757,5,False,0,1,0,15162,178,44,6.2,False,13,True,1,0,0,18883,192,44,6.8,True,27.205983333333332,-3721,-8,-1,222,236,-14
BR1_2716215640,9,True,0,0,0,19974,225,54,7.4,True,8,False,1,0,0,17565,186,49,7.0,False,29.715233333333334,2409,1,-1,279,235,44
BR1_2722260976,13,True,1,0,0,18699,206,48,7.0,True,1,False,0,0,0,12878,166,44,6.6,False,25.567433333333334,5821,12,1,254,210,44
BR1_2680923191,12,False,1,0,0,19395,177,48,7.2,False,12,True,0,0,0,19151,169,56,7.2,True,29.871766666666666,244,0,1,225,225,0
BR1_2728463753,14,False,1,1,0,21899,199,72,7.6,True,7,True,0,0,0,16273,149,51,6.2,False,28.100816666666667,5626,7,1,271,200,71
BR1_2730126892,18,True,1,0,1,24518,217,64,7.8,True,7,False,0,0,0,16957,158,52,6.4,False,28.626416666666668,7561,11,1,281,210,71
BR1_2714023918,13,True,1,0,0,19928,211,72,7.6,True,5,False,0,0,0,17180,212,68,7.0,False,28.443366666666666,2748,8,1,283,280,3
BR1_2729690338,3,True,0,0,0,13332,171,33,6.0,False,9,False,0,0,0,17662,179,72,6.8,True,25.1781,-4330,-6,0,204,251,-47
BR1_2729440833,5,False,0,0,0,15698,178,68,7.0,False,8,True,1,1,1,18674,190,40,7.0,True,28.07785,-2976,-3,-1,246,230,16
BR1_2731667248,3,True,1,0,0,14701,203,52,6.6,True,0,False,0,1,0,13220,206,48,7.0,False,27.283366666666666,1481,3,1,255,254,1
BR1_2730150220,8,True,1,1,0,18717,221,60,7.2,True,8,False,0,0,0,17754,233,50,7.4,False,27.8872,963,0,1,281,283,-2
BR1_2729325562,5,True,0,0,0,15604,155,56,6.8,True,4,False,1,0,0,15534,204,56,7.0,False,29.627783333333333,70,1,-1,211,260,-49
BR1_2731465939,7,True,1,0,0,15964,172,52,6.4,True,6,False,0,0,0,15751,173,52,6.2,False,25.649283333333333,213,1,1,224,225,-1
BR1_2727337854,8,True,1,0,0,17615,191,56,7.2,True,4,False,0,0,0,15911,192,52,7.2,False,28.047183333333333,1704,4,1,247,244,3
BR1_2725888185,7,True,0,0,0,15534,193,42,6.6,False,7,False,1,0,0,15373,183,40,6.8,True,26.844116666666668,161,0,-1,235,223,12
BR1_2722055232,6,False,1,0,0,17188,213,32,7.0,True,5,True,0,1,0,16630,223,60,7.0,False,29.42615,558,1,1,245,283,-38
BR1_2710250188,5,False,0,0,0,14944,169,32,6.2,False,9,True,1,0,0,17463,181,60,7.0,True,26.946033333333332,-2519,-4,-1,201,241,-40
BR1_2729553608,2,False,0,1,0,14615,207,50,7.2,False,6,True,1,0,0,17046,236,68,7.6,True,28.152866666666668,-2431,-4,-1,257,304,-47
BR1_2729528611,1,False,0,0,0,13773,205,52,6.6,True,2,True,0,0,0,14586,200,48,6.6,False,26.169866666666667,-813,-1,0,257,248,9
BR1_2729470118,5,True,1,0,0,17222,232,52,7.2,True,3,False,0,1,0,15583,188,60,7.2,False,29.6352,1639,2,1,284,248,36
BR1_2728837247,8,True,0,1,0,18558,207,56,7.0,True,5,False,0,0,0,15527,193,56,7.2,False,26.624833333333335,3031,3,0,263,249,14
BR1_2731442042,5,False,0,1,0,14873,155,40,6.4,False,7,True,1,0,0,16339,202,56,6.8,True,26.516366666666666,-1466,-2,-1,195,258,-63
BR1_2711767387,2,False,0,0,0,15183,190,53,7.0,False,7,True,1,1,0,17507,208,63,7.4,True,28.05795,-2324,-5,-1,243,271,-28
BR1_2731150816,4,True,0,1,0,15263,191,52,7.0,True,2,False,1,0,0,13598,196,48,6.6,False,26.26775,1665,2,-1,243,244,-1
BR1_2706047903,5,True,1,0,0,15798,190,48,6.8,False,4,False,0,1,0,15023,199,60,6.8,True,27.32185,775,1,1,238,259,-21
BR1_2716647556,6,False,0,0,0,15184,174,44,6.2,False,13,True,1,0,0,18714,197,44,6.8,True,25.590283333333332,-3530,-7,-1,218,241,-23
BR1_2711671272,6,False,0,1,0,15212,158,44,6.6,False,10,True,1,0,0,18221,207,44,7.0,True,26.9004,-3009,-4,-1,202,251,-49
BR1_2729677107,8,False,0,0,0,17176,195,40,6.4,True,8,True,1,0,0,16468,150,44,6.4,False,25.135116666666665,708,0,-1,235,194,41
BR1_2726427606,2,True,0,0,0,13642,154,44,6.4,False,4,False,0,0,0,15490,200,61,7.0,True,25.7784,-1848,-2,0,198,261,-63
BR1_2731510110,9,True,1,0,0,18223,176,48,6.6,False,13,False,0,1,0,18965,174,40,7.0,True,29.724416666666666,-742,-4,1,224,214,10
BR1_2708394418,6,False,0,0,0,17330,148,60,6.6,False,15,True,1,1,1,22163,246,56,7.6,True,28.522483333333334,-4833,-9,-1,208,302,-94
BR1_2700253613,5,True,0,1,0,15688,214,48,6.6,True,6,False,0,0,0,15504,161,56,6.8,False,25.041,184,-1,0,262,217,45
BR1_2727547745,7,False,0,1,0,17544,192,52,7.0,True,9,True,0,0,0,16687,177,64,6.6,False,26.013233333333332,857,-2,0,244,241,3
BR1_2727108559,5,False,0,0,0,14830,191,44,6.8,True,4,True,0,0,0,13911,174,28,6.4,False,27.207816666666666,919,1,0,235,202,33
BR1_2731678078,14,True,0,1,0,21038,194,48,7.2,True,5,False,0,0,0,17469,171,58,6.8,False,28.621116666666666,3569,9,0,242,229,13
BR1_2731653061,10,False,0,1,0,19521,211,59,7.4,True,11,True,0,0,0,18698,189,44,7.4,False,29.9077,823,-1,0,270,233,37
BR1_2726914357,4,False,0,0,0,15203,187,44,6.8,False,9,True,0,0,0,17377,196,60,7.2,True,26.201016666666668,-2174,-5,0,231,256,-25
BR1_2725707531,3,False,0,0,0,12312,104,48,6.2,False,13,True,1,0,0,19508,196,64,7.6,True,26.0453,-7196,-10,-1,152,260,-108
BR1_2704442909,6,True,0,0,0,16248,195,52,6.6,True,3,False,0,0,0,14278,206,52,6.6,False,26.896966666666668,1970,3,0,247,258,-11
BR1_2723101432,5,False,1,0,0,17179,223,52,7.6,True,4,True,0,0,0,16300,217,64,7.4,False,27.549033333333334,879,1,1,275,281,-6
BR1_2727048587,7,True,1,1,0,17721,192,56,7.0,False,9,False,0,0,0,18622,211,52,7.4,True,28.552983333333334,-901,-2,1,248,263,-15
BR1_2726967438,4,False,0,0,0,14436,191,48,6.8,True,4,True,0,0,0,15165,191,48,6.6,False,26.12895,-729,0,0,239,239,0
BR1_2698530559,7,True,1,0,0,16547,184,64,6.8,True,5,False,0,0,0,15008,197,52,6.6,False,26.409183333333335,1539,2,1,248,249,-1
BR1_2665262262,10,True,0,0,0,18699,228,56,7.8,True,6,False,1,0,0,15696,176,60,7.0,False,25.652383333333333,3003,4,-1,284,236,48
BR1_2665171053,13,True,1,1,1,21300,223,50,7.6,True,9,False,0,0,0,18297,200,43,7.4,False,27.504383333333333,3003,4,1,273,243,30
BR1_2724497292,5,False,0,1,0,15902,191,64,7.4,True,6,True,1,0,0,15847,185,48,7.2,False,27.88945,55,-1,-1,255,233,22
BR1_2728569645,9,True,1,0,0,18348,143,64,6.8,False,7,False,0,0,0,17133,208,48,7.2,True,29.1447,1215,2,1,207,256,-49
BR1_2728546254,9,False,1,0,0,17684,187,56,7.4,False,7,True,0,0,0,17871,201,64,7.4,True,28.958966666666665,-187,2,1,243,265,-22
BR1_2724660708,13,False,1,0,0,19140,163,40,6.6,True,10,True,0,1,0,16539,134,52,6.2,False,26.50855,2601,3,1,203,186,17
BR1_2724191098,4,False,0,0,0,15312,201,48,7.0,False,8,True,0,0,0,17677,197,68,7.2,True,28.932916666666667,-2365,-4,0,249,265,-16
BR1_2730761426,11,True,1,0,0,20456,200,56,7.4,True,7,False,0,1,0,16991,170,60,7.0,False,29.616,3465,4,1,256,230,26
BR1_2727818091,8,True,0,0,0,18548,243,48,7.6,True,0,False,0,0,0,13618,198,23,7.0,False,27.540816666666668,4930,8,0,291,221,70
BR1_2707513124,9,True,1,0,0,16452,172,48,6.8,True,3,False,0,0,0,14076,202,48,6.6,False,27.057433333333332,2376,6,1,220,250,-30
BR1_2692238180,4,True,0,1,0,14879,157,52,6.0,False,11,False,1,0,0,17625,172,52,6.8,True,26.8928,-2746,-7,-1,209,224,-15
BR1_2692227513,6,True,0,0,0,16615,190,52,7.2,False,9,False,1,0,0,19532,236,64,7.2,True,27.663,-2917,-3,-1,242,300,-58
BR1_2713768395,5,False,0,0,0,16336,239,50,7.4,False,6,True,0,0,0,17741,233,69,7.2,True,29.571716666666667,-1405,-1,0,289,302,-13
BR1_2713739987,4,True,0,1,0,15548,212,52,6.8,True,4,False,1,0,0,14646,198,56,6.6,False,25.034566666666667,902,0,-1,264,254,10
BR1_2730915742,5,True,0,1,0,16918,214,64,7.4,False,6,False,1,0,0,18066,242,60,7.6,True,28.300133333333335,-1148,-1,-1,278,302,-24
BR1_2696949561,5,False,0,0,0,16623,207,56,7.2,True,8,True,1,1,0,18440,180,64,7.2,False,29.139833333333332,-1817,-3,-1,263,244,19
BR1_2690879877,4,True,0,0,0,16139,213,56,7.4,False,1,False,1,0,0,15520,235,64,7.6,True,29.299516666666666,619,3,-1,269,299,-30
BR1_2712761215,11,True,0,1,0,17978,159,57,6.8,True,5,False,1,0,0,15085,190,46,6.6,False,25.318233333333332,2893,6,-1,216,236,-20
BR1_2698844229,7,True,0,1,0,17110,152,56,7.4,True,6,False,1,0,0,15624,171,57,7.2,False,28.352216666666667,1486,1,-1,208,228,-20
BR1_2722216246,15,True,0,0,0,21237,211,44,7.4,True,10,False,1,1,0,17301,186,48,7.2,False,28.114683333333332,3936,5,-1,255,234,21
BR1_2699087670,5,True,0,0,0,15773,201,56,7.0,True,7,False,0,0,0,16313,213,40,6.8,False,26.64385,-540,-2,0,257,253,4
BR1_2727352930,11,False,1,1,1,22012,243,56,7.6,True,5,True,0,0,0,16301,185,56,7.0,False,29.993883333333333,5711,6,1,299,241,58
BR1_2683138509,8,False,0,1,1,19022,197,44,7.4,False,7,True,0,0,0,18109,238,48,7.2,True,29.999283333333334,913,1,0,241,286,-45
BR1_2678921760,8,False,0,1,0,16767,201,57,6.8,False,8,True,1,0,0,16098,156,49,6.6,True,27.200633333333332,669,0,-1,258,205,53
BR1_2678799391,4,True,1,0,0,14377,180,52,6.4,False,5,False,0,0,0,15037,167,56,6.8,True,26.694716666666668,-660,-1,1,232,223,9
BR1_2731457185,5,False,0,0,0,15905,204,60,7.2,False,8,True,1,1,0,18264,231,72,7.2,True,28.1118,-2359,-3,-1,264,303,-39
BR1_2730340759,15,True,1,0,0,19153,192,44,6.8,True,4,False,0,0,0,14745,170,48,6.2,False,27.104483333333334,4408,11,1,236,218,18
BR1_2724660254,4,True,0,1,0,16241,181,48,7.0,False,5,False,1,0,0,17737,211,64,7.4,True,29.467616666666668,-1496,-1,-1,229,275,-46
BR1_2728608313,8,False,0,1,0,17692,208,64,7.4,True,3,True,1,0,0,14446,188,40,6.4,False,25.118266666666667,3246,5,-1,272,228,44
BR1_2726234538,11,True,1,0,0,18137,179,48,7.0,True,12,False,0,0,0,19083,199,44,7.4,False,28.035216666666667,-946,-1,1,227,243,-16
BR1_2724988868,8,True,1,0,0,15595,140,64,6.6,True,4,False,0,0,0,14898,203,43,6.8,False,27.046333333333333,697,4,1,204,246,-42
BR1_2724755729,10,False,0,0,0,16442,157,52,6.2,False,11,True,1,0,0,17707,195,36,6.6,True,27.204666666666668,-1265,-1,-1,209,231,-22
BR1_2700018304,13,True,1,0,0,21325,220,79,7.6,True,3,False,0,0,0,16359,203,54,7.0,False,28.632233333333332,4966,10,1,299,257,42
BR1_2699998118,8,True,1,0,0,18729,195,52,7.2,True,9,False,0,0,0,18432,229,59,7.0,False,27.717,297,-1,1,247,288,-41
BR1_2731531628,11,False,1,0,0,19505,212,60,7.4,True,4,True,0,0,0,14049,167,44,6.2,False,26.949283333333334,5456,7,1,272,211,61
BR1_2695371143,14,True,1,0,0,19830,180,60,7.0,True,14,False,0,0,0,20200,209,40,7.0,False,28.531116666666666,-370,0,1,240,249,-9
BR1_2676402687,11,False,1,1,0,17858,182,34,7.2,True,3,True,0,0,0,14790,203,44,7.0,False,27.952583333333333,3068,8,1,216,247,-31
BR1_2731527704,7,True,0,0,0,18449,226,60,7.4,True,5,False,0,0,0,16373,202,40,6.6,False,29.131816666666666,2076,2,0,286,242,44
BR1_2705827389,6,False,0,0,0,19130,272,72,7.4,True,3,True,1,0,0,14634,177,66,6.4,False,27.608016666666668,4496,3,-1,344,243,101
BR1_2731611394,4,True,0,0,0,16691,226,54,7.4,True,2,False,0,0,0,14460,200,54,7.4,False,29.031333333333333,2231,2,0,280,254,26
BR1_2729823290,3,False,0,0,0,14611,166,44,7.0,True,7,True,1,1,0,18190,235,68,7.8,False,28.98265,-3579,-4,-1,210,303,-93
BR1_2729814643,7,True,1,0,0,16242,198,56,6.8,True,4,False,0,1,0,13705,172,52,6.4,False,26.34765,2537,3,1,254,224,30
BR1_2698578270,8,False,0,0,0,18795,224,60,7.2,True,9,True,1,0,0,18535,217,40,7.0,False,28.8029,260,-1,-1,284,257,27
BR1_2669659359,6,False,1,0,0,17318,197,44,7.2,False,6,True,0,1,0,18129,253,64,7.6,True,28.669983333333334,-811,0,1,241,317,-76
BR1_2680409842,10,True,1,0,0,18147,202,48,7.4,False,5,False,0,0,0,16250,226,64,7.4,True,27.6341,1897,5,1,250,290,-40
BR1_2731398741,6,False,0,0,0,14062,143,40,6.2,False,8,True,0,0,0,16607,172,48,7.0,True,26.627116666666666,-2545,-2,0,183,220,-37
BR1_2730344351,6,True,1,0,0,16501,199,48,6.8,False,8,False,0,1,0,18459,212,72,7.4,True,29.9933,-1958,-2,1,247,284,-37
BR1_2731547955,5,True,0,1,0,16468,209,52,6.8,True,0,False,0,0,0,12410,182,40,6.2,False,26.715566666666668,4058,5,0,261,222,39
BR1_2707344579,9,False,1,0,0,16507,160,32,6.6,False,13,True,0,0,1,20811,192,64,7.4,True,29.136783333333334,-4304,-4,1,192,256,-64
BR1_2730559348,4,True,0,1,0,15906,224,56,6.8,True,3,False,0,0,0,13661,187,52,6.6,False,25.65075,2245,1,0,280,239,41
BR1_2728284049,10,False,0,0,0,17714,227,56,7.2,False,6,True,0,0,0,18386,244,40,7.2,True,28.337783333333334,-672,4,0,283,284,-1
BR1_2715674398,5,False,0,1,0,14050,132,56,6.4,False,7,True,1,0,0,17223,212,52,6.6,True,25.613033333333334,-3173,-2,-1,188,264,-76
BR1_2722494880,11,False,0,1,0,18760,169,44,7.0,True,5,True,1,0,0,15695,171,48,6.8,False,28.54618333333333,3065,6,-1,213,219,-6
BR1_2720359361,11,False,0,1,0,18302,202,36,7.0,False,13,True,1,0,0,19881,179,56,7.0,True,28.24835,-1579,-2,-1,238,235,3
BR1_2722038948,8,True,1,0,0,16937,202,51,6.6,True,5,False,0,0,0,14253,145,43,6.2,False,25.616783333333334,2684,3,1,253,188,65
BR1_2731218948,8,True,1,0,0,16460,173,60,7.2,True,3,False,0,0,0,14108,187,52,6.8,False,25.26105,2352,5,1,233,239,-6
BR1_2731199144,9,False,0,0,0,18435,153,56,7.0,False,17,True,1,0,0,22421,233,64,7.6,True,29.117716666666666,-3986,-8,-1,209,297,-88
BR1_2729841230,5,False,0,0,0,16012,193,56,6.8,False,11,True,1,1,0,19655,229,60,7.2,True,27.7193,-3643,-6,-1,249,289,-40
BR1_2694355982,9,False,1,0,0,17643,154,40,6.6,False,6,True,0,1,0,17483,222,68,7.2,True,27.8917,160,3,1,194,290,-96
BR1_2677094152,3,True,0,0,0,14672,150,48,6.8,False,3,False,1,0,0,16808,230,52,6.8,True,27.699483333333333,-2136,0,-1,198,282,-84
BR1_2729216483,4,True,0,1,0,15840,208,60,7.2,False,6,False,1,0,0,16626,235,60,7.8,True,29.617533333333334,-786,-2,-1,268,295,-27
BR1_2730326625,4,True,0,0,0,13987,196,28,6.2,False,3,False,0,0,0,14247,187,44,6.6,True,25.596916666666665,-260,1,0,224,231,-7
BR1_2710641785,3,True,0,0,0,13677,176,32,6.4,False,9,False,0,0,0,17212,196,48,6.8,True,27.431866666666668,-3535,-6,0,208,244,-36
BR1_2730063761,9,True,0,1,1,18922,219,43,6.8,True,2,False,1,0,0,13444,147,56,6.4,False,26.541033333333335,5478,7,-1,262,203,59
BR1_2719907589,10,False,0,0,0,18964,220,46,7.2,True,6,True,1,0,0,16132,195,38,7.0,False,28.668516666666665,2832,4,-1,266,233,33
BR1_2719712544,8,False,1,1,0,18174,188,64,7.2,True,9,True,0,0,0,17230,168,52,7.0,False,29.902633333333334,944,-1,1,252,220,32
BR1_2731132900,8,False,1,0,0,16840,182,56,6.8,True,4,True,0,1,0,15528,210,44,6.8,False,27.452566666666666,1312,4,1,238,254,-16
BR1_2731053145,4,True,0,0,0,14994,224,44,6.6,False,5,False,1,0,0,15040,177,56,7.0,True,25.644016666666666,-46,-1,-1,268,233,35
BR1_2704930008,7,True,1,0,0,17722,201,64,7.0,True,5,False,0,0,0,14869,201,44,6.6,False,25.20705,2853,2,1,265,245,20
BR1_2712645452,2,False,1,0,0,14794,186,52,7.2,False,6,True,0,0,0,17944,232,60,7.6,True,27.796266666666668,-3150,-4,1,238,292,-54
BR1_2702268275,4,True,0,0,0,13943,163,50,6.6,False,7,False,0,0,0,16130,181,48,6.8,True,26.823316666666667,-2187,-3,0,213,229,-16
BR1_2679031905,4,True,1,0,0,14893,175,54,7.4,False,5,False,0,1,0,16767,194,56,7.4,True,29.162183333333335,-1874,-1,1,229,250,-21
BR1_2728794247,4,False,0,0,0,14411,193,44,6.8,True,6,True,0,0,0,15163,178,44,6.8,False,25.5266,-752,-2,0,237,222,15
BR1_2728775726,2,True,0,0,0,15421,231,52,7.0,True,3,False,1,0,0,16733,263,64,7.6,False,29.487116666666665,-1312,-1,-1,283,327,-44
BR1_2730297530,4,False,0,0,0,14142,173,44,6.2,False,8,True,0,1,0,17205,215,39,6.8,True,26.059166666666666,-3063,-4,0,217,254,-37
BR1_2730025138,10,True,1,1,0,19664,227,60,7.4,True,9,False,0,0,0,18848,232,56,7.6,False,28.954816666666666,816,1,1,287,288,-1
BR1_2729984258,7,True,0,0,0,15837,203,43,6.8,True,3,False,1,0,0,13454,147,57,6.6,False,25.32115,2383,4,-1,246,204,42
BR1_2693463294,9,False,1,0,0,16011,148,56,6.8,True,4,True,0,0,0,14159,195,44,6.8,False,27.406633333333332,1852,5,1,204,239,-35
BR1_2731540830,4,True,0,0,0,14685,163,45,6.6,False,10,False,1,0,0,17104,181,62,7.0,True,25.548466666666666,-2419,-6,-1,208,243,-35
BR1_2731523707,13,False,0,0,0,20607,184,52,6.8,True,10,True,1,0,0,18587,169,47,6.8,False,29.426316666666665,2020,3,-1,236,216,20
BR1_2705205816,4,True,0,0,0,15272,189,37,6.6,False,7,False,1,0,0,16329,208,32,6.6,True,27.518466666666665,-1057,-3,-1,226,240,-14
BR1_2707241733,5,False,0,0,0,16282,210,52,7.0,False,5,True,0,0,0,17017,249,48,7.6,True,29.202783333333333,-735,0,0,262,297,-35
BR1_2726078369,9,True,1,1,0,16813,151,52,6.8,True,15,False,0,0,0,19204,170,48,7.0,False,26.749383333333334,-2391,-6,1,203,218,-15
BR1_2726051595,6,False,1,0,0,15972,203,48,6.6,True,3,True,0,0,0,13120,143,36,6.0,False,26.91825,2852,3,1,251,179,72
BR1_2729271332,7,True,1,0,0,15584,175,60,7.0,True,0,False,0,0,0,11928,147,48,6.2,False,26.489616666666667,3656,7,1,235,195,40
BR1_2724565188,11,True,1,1,0,18851,180,60,6.8,True,8,False,0,0,0,18556,191,56,7.0,False,28.743566666666666,295,3,1,240,247,-7
BR1_2722423036,5,False,0,1,0,16643,217,52,6.8,True,6,True,1,0,0,14913,171,52,6.6,False,25.550066666666666,1730,-1,-1,269,223,46
BR1_2729836983,17,True,1,0,0,20632,173,48,6.6,True,6,False,0,0,0,15513,134,39,6.0,False,26.6298,5119,11,1,221,173,48
BR1_2728426745,9,False,0,0,0,19268,211,48,7.2,False,13,True,1,1,1,21680,197,76,7.6,True,28.662966666666666,-2412,-4,-1,259,273,-14
BR1_2728350287,11,True,1,0,0,17845,202,44,6.8,True,8,False,0,1,0,16804,176,56,6.6,False,26.35195,1041,3,1,246,232,14
BR1_2667500459,7,True,0,1,0,16887,166,56,6.8,False,7,False,1,0,0,16529,156,40,6.4,True,27.3202,358,0,-1,222,196,26
BR1_2667474375,1,True,0,0,0,13251,186,48,6.6,False,6,False,0,1,0,16422,215,60,7.0,True,25.516666666666666,-3171,-5,0,234,275,-41
BR1_2711633482,3,False,0,0,0,13888,161,48,6.2,False,15,True,1,0,0,19053,190,40,6.6,True,26.30913333333333,-5165,-12,-1,209,230,-21
BR1_2711612041,7,False,0,1,0,17615,194,48,7.0,True,6,True,0,0,0,15647,189,44,6.6,False,26.176333333333332,1968,1,0,242,233,9
BR1_2730676432,6,True,0,1,0,16106,177,56,6.6,False,6,False,0,0,0,17073,200,60,7.0,True,27.003,-967,0,0,233,260,-27
BR1_2730314944,11,True,0,0,0,18113,175,56,7.0,True,6,False,1,0,0,16830,162,56,6.4,False,26.100066666666667,1283,5,-1,231,218,13
BR1_2729487469,3,False,1,0,0,15055,201,48,7.2,False,6,True,0,1,1,18920,239,52,7.6,True,29.055516666666666,-3865,-3,1,249,291,-42
BR1_2717155113,4,False,0,0,0,15182,219,36,7.0,True,6,True,0,0,0,14591,161,40,5.8,False,25.495083333333334,591,-2,0,255,201,54
BR1_2697458691,5,True,1,1,0,16758,210,64,6.8,True,6,False,0,0,0,16900,230,47,7.2,False,29.865,-142,-1,1,274,277,-3
BR1_2721993184,8,True,1,0,0,18319,220,40,7.2,True,6,False,0,1,0,15592,173,44,7.0,False,27.519133333333333,2727,2,1,260,217,43
BR1_2729683575,10,False,1,0,0,16291,167,51,6.4,True,4,True,0,1,0,14307,173,48,6.6,False,27.110583333333334,1984,6,1,218,221,-3
BR1_2731598358,5,True,1,1,0,16400,201,60,7.0,True,2,False,0,0,0,13460,171,48,6.6,False,27.41525,2940,3,1,261,219,42
BR1_2731253606,11,True,1,0,0,19700,218,56,7.4,True,6,False,0,0,0,15660,145,60,6.8,False,28.6618,4040,5,1,274,205,69
BR1_2717511799,14,True,0,0,0,18385,176,50,6.6,True,5,False,0,0,0,15138,150,48,6.6,False,25.761966666666666,3247,9,0,226,198,28
BR1_2697213879,9,False,0,0,0,16838,168,46,7.0,True,7,True,1,0,0,17053,193,52,6.6,False,25.34195,-215,2,-1,214,245,-31
BR1_2697209621,11,True,0,0,0,20974,238,60,7.4,True,6,False,0,0,0,16035,171,44,6.6,False,27.6657,4939,5,0,298,215,83
BR1_2729622449,15,False,1,1,0,20953,186,52,7.2,True,9,True,0,0,0,19093,206,60,7.2,False,28.756383333333332,1860,6,1,238,266,-28
BR1_2726203365,7,True,1,0,0,15105,161,47,6.6,True,6,False,0,0,0,13981,159,0,5.6,False,26.1961,1124,1,1,208,159,49
BR1_2730703010,2,True,0,0,0,14896,203,60,7.2,False,6,False,0,0,0,16602,195,76,7.2,True,29.324533333333335,-1706,-4,0,263,271,-8
BR1_2726794288,4,True,0,0,0,14442,175,46,6.6,True,3,False,0,1,0,14665,191,50,6.8,False,26.190216666666668,-223,1,0,221,241,-20
BR1_2730375621,5,True,0,0,0,17233,236,52,7.4,True,6,False,1,1,0,17267,212,68,7.2,False,29.62035,-34,-1,-1,288,280,8
BR1_2727729439,12,True,0,1,1,19920,199,60,7.2,False,7,False,1,0,0,16253,181,48,7.0,True,27.085083333333333,3667,5,-1,259,229,30
BR1_2727029638,13,True,0,0,0,19430,184,52,7.2,True,5,False,1,0,0,14932,193,40,6.4,False,26.371016666666666,4498,8,-1,236,233,3
BR1_2729390093,5,False,1,0,0,15596,197,56,7.4,True,7,True,0,1,0,17317,186,52,7.0,False,29.553866666666668,-1721,-2,1,253,238,15
BR1_2731251449,7,False,0,0,0,15300,156,60,6.8,False,10,True,1,0,0,16949,189,48,6.8,True,25.94621666666667,-1649,-3,-1,216,237,-21
BR1_2704523105,10,False,0,1,0,19993,226,48,7.4,False,13,True,1,0,0,20216,235,67,7.6,True,29.525833333333335,-223,-3,-1,274,302,-28
BR1_2729706011,7,True,1,0,0,16798,181,52,6.8,True,8,False,0,1,0,17592,188,48,7.4,False,28.291533333333334,-794,-1,1,233,236,-3
BR1_2729678017,7,False,1,1,0,17893,202,60,7.4,False,7,True,0,0,0,17955,218,59,7.4,True,28.18915,-62,0,1,262,277,-15
BR1_2718588339,11,True,1,1,0,19106,200,72,7.2,True,7,False,0,0,0,16305,172,56,7.2,False,29.286166666666666,2801,4,1,272,228,44
BR1_2692456109,1,False,0,0,0,14215,220,40,6.4,False,9,True,0,0,0,18574,255,68,7.6,True,28.86335,-4359,-8,0,260,323,-63
BR1_2690644784,11,True,0,0,0,17686,202,36,6.6,True,2,False,0,0,0,13833,211,60,6.6,False,26.374316666666665,3853,9,0,238,271,-33
BR1_2699464581,9,False,0,1,0,17641,203,40,7.0,False,8,True,0,0,0,19224,253,64,7.4,True,29.371916666666667,-1583,1,0,243,317,-74
BR1_2718208654,6,False,0,0,0,17015,219,64,7.2,True,3,True,0,0,0,15195,206,16,6.8,False,29.54315,1820,3,0,283,222,61
BR1_2696044220,5,False,0,0,0,14591,163,52,6.6,False,15,True,1,0,0,19832,212,51,7.2,True,26.598383333333334,-5241,-10,-1,215,263,-48
BR1_2730031033,8,True,0,1,0,17408,201,40,7.2,True,12,False,1,0,0,20154,204,66,7.4,False,29.878766666666667,-2746,-4,-1,241,270,-29
BR1_2731638537,5,True,1,0,0,16077,189,60,7.2,True,5,False,0,0,0,15779,193,64,7.4,False,28.698766666666668,298,0,1,249,257,-8
BR1_2707070402,7,True,0,1,0,18025,196,52,7.2,False,13,False,1,0,0,20111,212,64,7.6,True,29.17065,-2086,-6,-1,248,276,-28
BR1_2706033918,7,True,0,0,0,16080,179,48,6.4,False,7,False,1,0,0,15793,175,44,6.6,True,25.31855,287,0,-1,227,219,8
BR1_2730467850,9,True,1,0,0,17530,176,51,6.8,True,5,False,0,0,0,13849,161,44,6.4,False,27.136516666666665,3681,4,1,227,205,22
BR1_2730109142,5,True,0,1,0,15787,171,52,6.4,False,5,False,1,0,0,15676,194,52,7.0,True,25.545616666666668,111,0,-1,223,246,-23
BR1_2686540018,6,False,1,0,0,16950,206,60,7.2,False,10,True,0,1,0,18813,223,56,7.6,True,28.591683333333332,-1863,-4,1,266,279,-13
BR1_2684272770,4,True,1,1,0,14933,199,48,6.6,False,6,False,0,0,0,16587,176,60,7.0,True,26.9545,-1654,-2,1,247,236,11
BR1_2731332717,2,True,1,0,0,15142,207,56,7.0,False,9,False,0,0,0,20041,229,68,7.4,True,29.237033333333333,-4899,-7,1,263,297,-34
BR1_2731196918,7,False,1,1,0,16811,158,64,7.0,False,8,True,0,0,0,18108,203,60,7.0,True,27.653283333333334,-1297,-1,1,222,263,-41
BR1_2731170336,4,False,0,0,0,14286,166,48,6.4,False,6,True,1,1,0,15293,181,56,6.8,True,27.023416666666666,-1007,-2,-1,214,237,-23
BR1_2731327560,5,False,0,0,0,14585,147,68,6.8,False,7,True,1,0,0,16095,186,48,6.8,True,26.45415,-1510,-2,-1,215,234,-19
BR1_2730924572,9,True,0,1,0,16885,191,60,7.0,True,1,False,1,0,0,12645,164,48,6.4,False,25.696366666666666,4240,8,-1,251,212,39
BR1_2731350434,4,True,1,0,0,16349,206,60,7.2,False,5,False,0,1,0,18031,238,64,7.4,True,28.652733333333334,-1682,-1,1,266,302,-36
BR1_2731118598,6,False,0,0,0,13497,115,36,5.6,False,11,True,1,0,0,18431,183,60,7.0,True,26.445033333333335,-4934,-5,-1,151,243,-92
BR1_2695135114,12,True,1,0,0,18311,147,44,6.8,True,5,False,0,1,0,17002,178,56,7.0,False,27.881783333333335,1309,7,1,191,234,-43
BR1_2731015459,5,False,0,0,0,13708,139,32,5.8,False,7,True,1,1,1,17071,187,60,7.0,True,26.65755,-3363,-2,-1,171,247,-76
BR1_2719507711,9,True,1,0,0,16601,173,43,6.6,True,7,False,0,1,0,16379,178,56,6.4,False,26.553066666666666,222,2,1,216,234,-18
BR1_2704417473,7,True,1,0,0,16291,158,44,6.4,True,8,False,0,1,0,16139,172,44,6.4,False,27.121033333333333,152,-1,1,202,216,-14
BR1_2695050493,8,True,1,1,0,17049,209,56,6.8,True,2,False,0,0,0,12534,135,56,6.2,False,25.36755,4515,6,1,265,191,74
BR1_2730546048,1,False,1,1,0,15417,232,72,7.2,False,8,True,0,0,0,17830,230,44,7.4,True,29.071,-2413,-7,1,304,274,30
BR1_2700528094,10,True,0,1,0,19354,203,72,7.4,True,7,False,1,0,0,17632,191,68,7.0,False,27.560266666666667,1722,3,-1,275,259,16
BR1_2717251873,7,True,0,0,0,18282,224,55,7.2,True,5,False,1,1,0,15780,194,56,7.2,False,29.681583333333332,2502,2,-1,279,250,29
BR1_2723158115,5,False,0,0,0,16023,186,52,7.2,False,12,True,1,1,0,18885,187,72,7.6,True,29.597266666666666,-2862,-7,-1,238,259,-21
BR1_2714822715,5,True,0,0,0,15577,174,52,7.0,True,4,False,1,0,0,15317,182,56,6.8,False,25.7687,260,1,-1,226,238,-12
BR1_2729174216,6,False,1,1,0,16220,195,60,6.8,False,9,True,0,0,0,17738,187,56,6.6,True,26.819716666666668,-1518,-3,1,255,243,12
BR1_2731673005,5,True,0,0,0,15622,207,44,6.4,False,9,False,1,1,0,17628,172,44,6.6,True,25.172916666666666,-2006,-4,-1,251,216,35
BR1_2731164609,11,True,0,1,0,18924,207,52,7.0,True,7,False,0,0,0,17159,199,44,7.0,False,28.88375,1765,4,0,259,243,16
BR1_2680664919,10,False,0,0,0,16990,166,56,7.0,True,6,True,1,0,0,14819,153,44,6.4,False,26.180333333333333,2171,4,-1,222,197,25
BR1_2680005956,7,True,1,0,0,17601,174,48,7.2,False,7,False,0,1,0,17108,177,56,7.0,True,29.012083333333333,493,0,1,222,233,-11
BR1_2731558631,5,False,0,0,0,14277,149,48,6.8,False,11,True,0,1,0,17867,196,52,7.0,True,27.205033333333333,-3590,-6,0,197,248,-51
BR1_2730842107,6,False,0,0,0,16124,176,42,6.6,False,9,True,1,1,0,18321,177,64,7.4,True,28.88981666666667,-2197,-3,-1,218,241,-23
BR1_2728555420,14,True,1,0,1,19487,181,32,6.6,True,5,False,0,0,0,14240,138,56,6.2,False,25.3076,5247,9,1,213,194,19
BR1_2727355587,7,False,0,0,0,18248,225,56,7.2,True,7,True,0,1,0,17141,183,46,7.0,False,29.7697,1107,0,0,281,229,52
BR1_2663839363,4,True,0,0,0,13201,136,33,6.2,False,7,False,1,0,0,16519,162,49,6.6,True,27.20093333333333,-3318,-3,-1,169,211,-42
BR1_2663820683,10,False,1,0,0,18761,193,44,7.2,False,11,True,0,1,0,18649,163,64,7.0,True,29.896933333333333,112,-1,1,237,227,10
BR1_2699317909,9,True,0,0,0,17689,165,56,7.2,False,12,False,1,1,0,20501,212,64,7.2,True,28.804316666666665,-2812,-3,-1,221,276,-55
BR1_2730115560,11,True,0,0,0,16940,167,54,6.6,True,11,False,0,0,0,17305,167,43,6.8,False,25.50275,-365,0,0,221,210,11
BR1_2730087621,4,True,0,1,0,15976,181,56,7.0,False,15,False,0,0,0,20397,211,52,7.6,True,28.08128333333333,-4421,-11,0,237,263,-26
BR1_2731168158,4,False,0,0,0,14412,174,52,6.4,False,14,True,1,0,0,18615,179,48,6.8,True,25.44725,-4203,-10,-1,226,227,-1
BR1_2731001252,4,True,0,0,0,13677,160,40,6.2,False,5,False,0,0,0,15024,189,43,6.8,True,25.710866666666668,-1347,-1,0,200,232,-32
BR1_2729927242,7,True,1,0,0,17863,218,55,7.4,True,6,False,0,0,0,16481,183,37,6.8,False,29.715333333333334,1382,1,1,273,220,53
BR1_2700596077,5,True,0,0,0,15817,172,42,6.4,False,8,False,1,1,0,16275,178,44,6.4,True,26.55015,-458,-3,-1,214,222,-8
BR1_2700559854,8,True,0,0,0,17557,202,56,7.2,True,9,False,0,0,0,18415,208,64,7.2,False,29.731483333333333,-858,-1,0,258,272,-14
BR1_2730197273,12,True,0,0,0,18865,166,48,7.0,True,9,False,1,1,0,18998,185,59,7.2,False,29.81961666666667,-133,3,-1,214,244,-30
BR1_2730708270,7,True,1,1,0,17881,184,60,7.2,True,9,False,0,0,0,18007,193,68,7.4,False,29.358933333333333,-126,-2,1,244,261,-17
BR1_2722764318,9,False,0,0,0,17451,209,44,6.8,True,6,True,0,0,0,16003,206,40,6.6,False,27.358166666666666,1448,3,0,253,246,7
BR1_2695778494,4,False,0,0,0,15654,199,44,6.8,False,11,True,1,0,0,19286,248,64,7.6,True,29.970266666666667,-3632,-7,-1,243,312,-69
BR1_2695751823,7,False,0,0,0,15539,159,44,6.6,False,10,True,0,0,0,17324,203,52,7.0,True,26.536816666666667,-1785,-3,0,203,255,-52
BR1_2712977383,5,False,1,0,0,13629,149,39,6.4,False,5,True,0,0,0,14846,186,44,6.4,True,26.444366666666667,-1217,0,1,188,230,-42
BR1_2712962211,13,False,0,0,0,17443,165,37,6.6,True,12,True,0,0,0,17042,167,29,6.6,False,26.27466666666667,401,1,0,202,196,6
BR1_2719501581,11,False,0,0,0,18882,191,28,7.2,False,12,True,0,0,0,20551,201,66,7.6,True,29.581883333333334,-1669,-1,0,219,267,-48
BR1_2696690002,9,False,0,0,0,16433,167,31,6.8,True,4,True,1,0,0,13412,132,48,6.2,False,26.924866666666667,3021,5,-1,198,180,18
BR1_2731035576,2,False,0,0,0,12758,160,54,6.6,False,8,True,1,0,0,16418,179,46,6.8,True,26.147766666666666,-3660,-6,-1,214,225,-11
BR1_2692995754,2,False,0,0,0,12935,169,49,6.8,True,4,True,0,0,0,15188,185,53,6.8,False,26.774716666666666,-2253,-2,0,218,238,-20
BR1_2713132239,5,False,1,0,0,13944,118,48,6.2,False,10,True,0,1,1,18868,193,44,6.6,True,25.0256,-4924,-5,1,166,237,-71
BR1_2713101848,4,False,0,0,0,16080,248,40,7.0,True,8,True,1,0,0,17077,207,64,7.2,False,27.562216666666668,-997,-4,-1,288,271,17
BR1_2676407679,8,False,0,0,0,16392,186,42,7.0,True,7,True,1,1,0,15519,152,40,6.4,False,25.405533333333334,873,1,-1,228,192,36
BR1_2731636010,6,False,1,1,0,17157,175,55,7.6,False,10,True,0,0,0,19665,244,68,7.8,True,27.99128333333333,-2508,-4,1,230,312,-82
BR1_2696768669,17,True,0,0,1,22349,188,61,7.2,True,5,False,0,1,1,18039,193,54,7.2,False,29.665133333333333,4310,12,0,249,247,2
BR1_2728974609,8,False,0,0,0,16552,179,56,6.6,True,7,True,1,0,0,16081,179,64,7.0,False,26.210083333333333,471,1,-1,235,243,-8
BR1_2704518249,7,True,0,0,0,16770,190,52,7.0,False,8,False,1,0,0,17807,229,52,7.4,True,29.2254,-1037,-1,-1,242,281,-39
BR1_2731603163,3,False,1,1,0,16957,215,52,7.4,True,2,True,0,0,0,15274,219,67,7.4,False,28.40465,1683,1,1,267,286,-19
BR1_2731133046,5,True,0,1,0,17337,203,64,7.2,True,5,False,1,0,0,16223,188,56,7.0,False,29.969816666666667,1114,0,-1,267,244,23
BR1_2725615939,6,False,0,0,0,16536,192,48,7.2,False,13,True,1,0,0,19987,243,64,7.6,True,28.978866666666665,-3451,-7,-1,240,307,-67
BR1_2723254004,2,False,0,0,0,13469,178,31,7.0,False,11,True,0,0,0,18590,207,48,7.2,True,29.851983333333333,-5121,-9,0,209,255,-46
BR1_2714475765,1,False,0,0,0,14550,198,52,7.0,False,8,True,1,0,0,16459,193,56,7.2,True,27.569,-1909,-7,-1,250,249,1
BR1_2731052733,14,True,1,0,0,18971,171,34,6.8,True,9,False,0,0,0,16513,185,56,6.4,False,26.848416666666665,2458,5,1,205,241,-36
BR1_2731007154,8,True,0,1,0,15795,171,40,6.6,True,13,False,1,0,0,17867,157,52,6.8,False,26.921116666666666,-2072,-5,-1,211,209,2
BR1_2731665091,7,True,1,0,0,16888,183,41,6.6,True,6,False,0,0,0,16281,204,45,7.2,False,25.3949,607,1,1,224,249,-25
BR1_2731562923,4,True,1,0,0,15285,230,52,6.8,True,2,False,0,0,0,15017,220,68,7.0,False,25.9181,268,2,1,282,288,-6
BR1_2731553326,9,False,0,0,0,17999,193,52,7.0,True,9,True,1,1,0,16567,164,44,6.4,False,25.477933333333333,1432,0,-1,245,208,37
BR1_2731487608,10,False,0,0,0,18101,221,56,7.2,True,8,True,0,0,0,16659,191,44,6.4,False,26.041666666666668,1442,2,0,277,235,42
BR1_2728016010,7,False,0,0,0,18071,213,59,7.0,True,9,True,0,0,0,16748,184,60,6.6,False,25.87705,1323,-2,0,272,244,28
BR1_2726408437,4,False,0,0,0,14850,170,47,6.6,False,8,True,1,0,0,18275,218,63,6.8,True,26.062183333333333,-3425,-4,-1,217,281,-64
BR1_2718617478,7,False,1,1,1,17338,174,48,7.0,True,5,True,0,0,0,14956,159,48,6.4,False,27.07955,2382,2,1,222,207,15
BR1_2718572023,9,True,0,0,0,16453,171,56,7.0,False,10,False,0,0,0,17770,189,50,7.0,True,26.653166666666667,-1317,-1,0,227,239,-12
BR1_2718281422,7,True,0,0,0,15317,130,40,6.2,False,8,False,1,0,0,16641,179,60,6.6,True,27.44495,-1324,-1,-1,170,239,-69
BR1_2673490205,9,False,1,0,0,18604,217,48,7.0,True,4,True,0,0,0,14285,167,45,6.6,False,27.4254,4319,5,1,265,212,53
BR1_2731343390,8,True,0,0,0,16707,193,46,6.8,False,9,False,1,1,0,18378,200,64,7.2,True,28.960733333333334,-1671,-1,-1,239,264,-25
BR1_2731653436,14,False,1,1,0,17901,191,56,7.2,True,4,True,0,0,0,16396,201,48,7.0,False,29.91845,1505,10,1,247,249,-2
BR1_2688157516,12,True,0,1,0,20275,198,68,7.6,True,7,False,0,0,0,17590,226,56,7.0,False,27.59805,2685,5,0,266,282,-16
BR1_2688118278,6,True,1,0,0,16607,228,60,7.6,True,3,False,0,0,0,14604,184,56,7.2,False,27.993316666666665,2003,3,1,288,240,48
BR1_2688098015,5,False,0,0,0,15963,192,44,6.8,True,6,True,1,0,0,15144,158,44,6.6,False,25.41065,819,-1,-1,236,202,34
BR1_2731490107,10,False,1,1,0,19412,211,56,7.4,True,8,True,0,0,0,17909,187,48,7.2,False,28.986666666666668,1503,2,1,267,235,32
BR1_2731471634,7,True,0,0,0,15582,148,52,6.4,False,12,False,1,0,0,18648,189,56,6.6,True,25.0095,-3066,-5,-1,200,245,-45
BR1_2731443809,8,False,1,0,0,16608,172,52,6.8,True,4,True,0,0,0,14503,183,52,6.4,False,27.042583333333333,2105,4,1,224,235,-11
BR1_2731557359,9,True,0,0,0,17876,158,36,7.0,False,10,False,0,0,0,17782,215,69,7.2,True,29.1736,94,-1,0,194,284,-90
BR1_2728621495,6,False,0,0,0,15176,181,45,6.8,False,15,True,1,0,0,20182,217,66,6.8,True,26.503633333333333,-5006,-9,-1,226,283,-57
BR1_2721499050,10,True,1,1,0,16992,154,60,6.6,True,3,False,0,0,0,14240,164,60,6.8,False,25.720783333333333,2752,7,1,214,224,-10
BR1_2727491823,4,True,0,0,0,15391,193,48,6.6,True,3,False,1,1,0,14694,196,48,6.4,False,26.590483333333335,697,1,-1,241,244,-3
BR1_2727440227,8,True,1,0,0,16686,183,48,6.8,True,1,False,0,0,0,13173,192,52,6.6,False,25.813566666666667,3513,7,1,231,244,-13
BR1_2725924391,11,True,0,1,0,18988,173,56,7.0,True,5,False,1,0,0,16400,190,64,7.0,False,29.531783333333333,2588,6,-1,229,254,-25
BR1_2676571480,6,False,1,0,0,16127,181,72,7.6,False,7,True,0,0,0,17222,199,60,7.2,True,28.138116666666665,-1095,-1,1,253,259,-6
BR1_2722541950,15,True,1,0,0,21868,233,52,7.8,True,5,False,0,0,0,15894,195,60,6.8,False,29.077066666666667,5974,10,1,285,255,30
BR1_2711266043,15,True,1,0,0,20945,227,52,7.2,False,9,False,0,1,0,18769,212,36,7.4,True,28.237433333333332,2176,6,1,279,248,31
BR1_2728427476,9,False,1,0,0,16435,165,48,6.8,False,12,True,0,0,0,18421,169,52,7.0,True,26.838633333333334,-1986,-3,1,213,221,-8
BR1_2727983483,7,True,0,0,0,16558,203,44,6.6,True,8,False,1,0,0,17670,183,64,7.0,False,26.40865,-1112,-1,-1,247,247,0
BR1_2731238354,10,True,0,1,0,19208,199,64,7.0,True,3,False,0,0,0,13092,151,48,6.4,False,25.904066666666665,6116,7,0,263,199,64
BR1_2696426654,10,True,1,1,0,17967,203,56,6.8,True,3,False,0,0,0,13746,161,56,6.6,False,26.266716666666667,4221,7,1,259,217,42
BR1_2721380725,6,False,1,1,0,17164,207,72,7.2,True,3,True,0,0,0,14766,186,44,7.0,False,29.965833333333332,2398,3,1,279,230,49
BR1_2731358263,6,True,0,0,0,15861,176,44,6.6,False,5,False,0,0,0,15091,194,44,6.6,True,26.842183333333335,770,1,0,220,238,-18
BR1_2731514881,11,False,1,0,0,20006,233,48,7.2,False,11,True,0,0,0,19459,193,56,7.0,True,28.98678333333333,547,0,1,281,249,32
BR1_2720943362,11,True,1,0,0,17305,176,44,6.2,True,8,False,0,0,0,16780,190,50,6.6,False,25.29075,525,3,1,220,240,-20
BR1_2720927049,15,True,1,1,0,20749,220,48,7.6,True,4,False,0,0,0,15363,168,60,7.0,False,28.962133333333334,5386,11,1,268,228,40
BR1_2720883870,4,False,0,1,0,16293,219,60,7.4,False,7,True,1,0,0,17786,189,68,7.4,True,29.661966666666668,-1493,-3,-1,279,257,22
BR1_2727563373,4,True,1,0,0,15701,196,48,6.4,True,5,False,0,1,0,15027,179,52,6.8,False,27.26,674,-1,1,244,231,13
BR1_2729977861,12,True,0,0,0,18853,175,44,6.6,True,12,False,1,0,0,18137,173,36,6.6,False,27.046966666666666,716,0,-1,219,209,10
BR1_2670018424,7,True,0,0,0,18122,204,44,7.2,True,8,False,0,0,0,17698,191,48,7.2,False,28.301433333333332,424,-1,0,248,239,9
BR1_2669634011,13,True,0,1,0,17019,130,48,6.4,True,9,False,1,0,0,17313,155,52,6.6,False,26.58128333333333,-294,4,-1,178,207,-29
BR1_2669488598,2,False,0,0,0,13979,155,56,7.2,False,9,True,1,0,0,18263,233,64,7.6,True,29.514566666666667,-4284,-7,-1,211,297,-86
BR1_2710806506,8,False,1,1,0,18132,215,52,7.2,True,3,True,0,0,0,15291,174,72,6.8,False,29.334583333333335,2841,5,1,267,246,21
BR1_2706048285,10,False,0,0,0,18634,217,58,7.4,False,5,True,1,1,0,17067,216,72,7.6,True,28.493816666666667,1567,5,-1,275,288,-13
BR1_2706025701,11,False,1,0,0,19853,199,56,7.2,False,9,True,0,1,0,18366,198,64,7.2,True,29.572433333333333,1487,2,1,255,262,-7
BR1_2731659663,6,False,0,0,0,17695,171,60,7.0,False,11,True,0,1,0,19758,237,56,7.4,True,29.112383333333334,-2063,-5,0,231,293,-62
BR1_2731608449,7,True,0,0,0,15732,178,44,6.8,False,5,False,1,0,0,15170,171,64,7.0,True,26.171966666666666,562,2,-1,222,235,-13
BR1_2731144099,4,False,1,0,0,15734,213,44,7.2,False,8,True,0,1,1,19862,226,72,7.4,True,28.7164,-4128,-4,1,257,298,-41
BR1_2727149487,8,False,1,0,0,16735,181,43,6.6,True,5,True,0,0,0,15347,179,44,6.6,False,26.7052,1388,3,1,224,223,1
BR1_2718660628,7,True,0,0,0,16102,172,44,6.8,True,4,False,0,0,0,13937,148,36,6.0,False,26.601433333333333,2165,3,0,216,184,32
BR1_2729783159,6,False,0,1,0,15505,156,56,7.0,False,6,True,1,0,0,16587,217,56,7.0,True,26.31895,-1082,0,-1,212,273,-61
BR1_2710781375,14,True,0,1,0,20939,193,76,7.6,True,6,False,1,0,0,16847,192,52,7.0,False,27.530316666666668,4092,8,-1,269,244,25
BR1_2695850943,2,False,0,1,0,16219,225,60,7.2,False,3,True,1,0,0,15662,249,48,7.2,True,27.638933333333334,557,-1,-1,285,297,-12
BR1_2689505960,6,False,0,0,0,16923,231,49,7.2,True,5,True,0,0,0,16597,210,62,7.4,False,28.167716666666667,326,1,0,280,272,8
BR1_2689334964,12,True,1,0,0,16728,164,52,6.2,True,5,False,0,0,0,14375,164,28,6.0,False,26.9751,2353,7,1,216,192,24
BR1_2701369191,4,False,0,0,0,14420,141,56,6.2,False,9,True,1,0,0,17692,182,49,6.6,True,26.559533333333334,-3272,-5,-1,197,231,-34
BR1_2700794672,11,True,0,0,0,15776,126,32,6.4,False,10,False,0,0,0,18634,212,64,7.0,True,25.98978333333333,-2858,1,0,158,276,-118
BR1_2700781729,5,True,0,0,0,14837,194,44,6.8,False,3,False,0,1,0,14766,184,60,6.8,True,25.6394,71,2,0,238,244,-6
BR1_2730122468,8,True,0,0,0,16684,195,52,6.8,True,4,False,1,0,0,15177,195,52,6.8,False,26.802016666666667,1507,4,-1,247,247,0
BR1_2730090742,13,True,1,0,0,19538,201,35,6.8,True,9,False,0,1,0,17791,162,44,7.0,False,29.701383333333332,1747,4,1,236,206,30
BR1_2729622309,7,True,1,1,0,18303,220,64,7.6,True,3,False,0,0,0,15425,211,60,7.2,False,29.515,2878,4,1,284,271,13
BR1_2730236904,3,False,0,0,0,13578,165,37,6.0,False,11,True,1,0,0,18091,192,50,6.2,True,26.947133333333333,-4513,-8,-1,202,242,-40
BR1_2727581194,6,False,0,1,0,15532,198,40,6.8,True,5,True,1,0,0,15298,189,46,6.6,False,25.22683333333333,234,1,-1,238,235,3
BR1_2729771572,10,False,0,0,0,16463,164,32,6.4,True,9,True,1,0,0,15958,155,40,6.4,False,25.70815,505,1,-1,196,195,1
BR1_2679377664,3,False,1,0,0,13172,160,42,6.6,False,10,True,0,0,0,17906,209,56,7.2,True,26.7252,-4734,-7,1,202,265,-63
BR1_2702606785,8,True,1,0,0,16486,187,48,7.0,True,4,False,0,0,0,14794,166,60,6.6,False,25.729283333333335,1692,4,1,235,226,9
BR1_2728931283,10,True,1,0,0,17878,183,52,6.8,True,6,False,0,0,0,15473,165,52,6.6,False,25.53295,2405,4,1,235,217,18
BR1_2695746578,4,False,1,1,0,15076,158,52,6.2,True,10,True,0,0,0,17365,185,36,6.6,False,27.205566666666666,-2289,-6,1,210,221,-11
BR1_2729882556,6,True,0,1,0,16906,182,32,7.0,False,7,False,1,0,0,17015,198,56,7.2,True,29.441683333333334,-109,-1,-1,214,254,-40
BR1_2729860898,6,False,1,0,0,15627,142,68,7.0,False,8,True,0,0,0,18912,248,72,7.6,True,27.742116666666668,-3285,-2,1,210,320,-110
BR1_2669786825,9,True,1,0,0,17619,183,60,7.0,True,5,False,0,0,0,14710,153,52,6.4,False,26.75695,2909,4,1,243,205,38
BR1_2730061229,4,False,0,1,0,15331,171,44,6.6,False,16,True,1,0,0,20478,185,56,7.0,True,25.5669,-5147,-12,-1,215,241,-26
BR1_2731365606,8,False,0,0,0,17431,172,52,6.8,True,12,True,1,1,0,18551,158,48,6.8,False,27.88865,-1120,-4,-1,224,206,18
BR1_2731346286,10,True,0,1,0,18309,163,48,7.0,True,8,False,0,0,0,16717,154,52,6.6,False,29.426583333333333,1592,2,0,211,206,5
BR1_2728629144,6,False,1,0,0,15070,179,54,6.6,True,4,True,0,0,0,14247,169,42,6.8,False,27.4552,823,2,1,233,211,22
BR1_2717520727,4,False,1,0,0,14222,164,48,6.8,False,6,True,0,1,0,15698,173,64,6.8,True,26.20505,-1476,-2,1,212,237,-25
BR1_2717496489,14,False,1,0,0,20633,225,52,7.4,True,7,True,0,0,0,17843,199,56,7.0,False,28.747833333333332,2790,7,1,277,255,22
BR1_2729956805,6,False,1,0,0,17302,191,56,6.8,True,7,True,0,0,0,16260,176,48,6.8,False,27.978616666666667,1042,-1,1,247,224,23
BR1_2682256206,3,True,0,0,0,14856,185,60,6.8,False,6,False,1,0,0,17446,231,47,7.4,True,27.649466666666665,-2590,-3,-1,245,278,-33
BR1_2714521698,5,False,1,1,0,14767,165,56,6.4,False,9,True,0,0,0,17971,228,44,6.8,True,26.605483333333332,-3204,-4,1,221,272,-51
BR1_2731155513,7,True,0,0,0,17863,244,64,7.0,True,3,False,0,0,0,15648,217,56,7.2,False,29.561166666666665,2215,4,0,308,273,35
BR1_2703817144,6,False,0,0,0,15867,211,44,6.8,False,6,True,0,0,0,18791,229,52,7.4,True,28.7407,-2924,0,0,255,281,-26
BR1_2729194449,20,True,1,0,0,21614,181,32,7.0,True,12,False,0,1,0,18849,173,44,7.2,False,29.689983333333334,2765,8,1,213,217,-4
BR1_2707183022,6,True,0,0,0,17807,192,58,7.0,False,8,False,1,0,0,19237,265,58,7.2,True,28.1335,-1430,-2,-1,250,323,-73
BR1_2730013019,4,False,1,0,0,14973,196,52,6.8,True,7,True,0,1,0,16864,186,56,7.2,False,27.415866666666666,-1891,-3,1,248,242,6
BR1_2730001815,7,True,0,0,0,16972,185,52,7.0,True,6,False,0,1,0,17340,232,56,7.4,False,28.900066666666667,-368,1,0,237,288,-51
BR1_2699422618,12,False,0,0,0,19680,223,48,7.2,True,10,True,1,0,0,17738,181,44,6.6,False,28.5643,1942,2,-1,271,225,46
BR1_2699405736,10,False,1,0,0,18839,198,68,7.4,True,5,True,0,0,0,16220,183,44,6.6,False,28.534416666666665,2619,5,1,266,227,39
BR1_2669957373,4,False,0,0,0,16165,219,56,7.4,False,7,True,1,1,0,18969,259,72,7.4,True,29.39775,-2804,-3,-1,275,331,-56
BR1_2710504821,8,True,1,1,0,17934,209,60,6.8,True,4,False,0,0,0,15378,201,40,6.4,False,27.486816666666666,2556,4,1,269,241,28
BR1_2716641779,5,False,0,1,0,14216,145,59,6.2,False,8,True,1,0,0,15648,179,40,6.4,True,26.148833333333332,-1432,-3,-1,204,219,-15
BR1_2729473373,6,False,0,0,0,16691,188,44,6.8,True,14,True,1,1,0,21008,199,56,7.4,False,29.548716666666667,-4317,-8,-1,232,255,-23
BR1_2729452352,9,False,0,0,0,17021,167,52,7.0,False,9,True,1,0,0,17590,160,72,7.2,True,28.343983333333334,-569,0,-1,219,232,-13
BR1_2726345458,5,True,1,0,0,17503,251,56,7.2,True,3,False,0,0,0,14517,201,19,6.4,False,28.179233333333332,2986,2,1,307,220,87
BR1_2730134841,4,True,1,1,0,17677,229,64,7.4,True,1,False,0,0,0,14352,199,60,7.4,False,28.1999,3325,3,1,293,259,34
BR1_2699767395,5,False,0,0,0,15869,201,44,7.0,False,7,True,1,0,0,18749,252,67,7.4,True,29.855383333333332,-2880,-2,-1,245,319,-74
BR1_2731152757,8,True,0,1,0,18690,212,44,6.8,True,8,False,1,0,0,18278,207,56,6.6,False,28.55763333333333,412,0,-1,256,263,-7
BR1_2730320128,5,False,0,1,0,16067,183,56,6.8,False,9,True,1,0,0,19224,205,60,7.4,True,28.97511666666667,-3157,-4,-1,239,265,-26
BR1_2717940405,8,False,1,0,0,17691,194,52,6.8,True,7,True,0,0,0,16596,175,60,7.0,False,29.85545,1095,1,1,246,235,11
BR1_2729958237,10,True,0,1,0,17767,159,58,7.0,True,9,False,1,0,0,15614,138,44,6.2,False,26.77545,2153,1,-1,217,182,35
BR1_2729426269,4,True,0,0,0,16138,191,72,6.8,False,12,False,1,0,0,21252,273,40,7.6,True,28.7598,-5114,-8,-1,263,313,-50
BR1_2731466987,9,False,1,1,1,19778,199,60,7.6,True,9,True,0,0,0,16639,169,32,7.0,False,28.897883333333333,3139,0,1,259,201,58
BR1_2729313858,10,True,1,1,0,19157,204,72,7.4,True,3,False,0,0,0,15508,207,56,7.0,False,27.856666666666666,3649,7,1,276,263,13
BR1_2731191650,7,True,1,0,0,17336,181,56,7.2,True,1,False,0,0,0,14301,206,52,7.0,False,28.635833333333334,3035,6,1,237,258,-21
BR1_2730836106,5,False,0,1,0,16156,209,60,7.0,True,4,True,1,0,0,14635,157,50,6.8,False,26.775683333333333,1521,1,-1,269,207,62
BR1_2730781921,6,True,1,0,0,19170,224,56,7.4,True,6,False,0,0,0,16795,197,68,7.4,False,28.122516666666666,2375,0,1,280,265,15
BR1_2730381228,10,True,0,0,0,19632,197,52,7.4,False,8,False,1,1,0,18471,201,48,7.0,True,28.239566666666665,1161,2,-1,249,249,0
BR1_2730375189,8,False,0,0,0,15146,183,24,6.2,False,8,True,1,0,0,16419,155,60,6.6,True,25.282166666666665,-1273,0,-1,207,215,-8
BR1_2730277911,6,False,1,1,0,18199,238,60,7.6,True,7,True,0,0,0,17313,238,56,7.4,False,27.64385,886,-1,1,298,294,4
BR1_2687598819,4,True,1,0,0,17238,223,53,7.4,True,3,False,0,1,0,16001,214,53,7.4,False,29.47135,1237,1,1,276,267,9
BR1_2697746914,5,True,0,1,0,18488,223,60,7.4,True,3,False,1,0,0,15604,204,64,7.2,False,29.610333333333333,2884,2,-1,283,268,15
BR1_2711687326,8,True,0,0,0,17713,233,56,7.0,False,12,False,1,0,0,18963,225,40,7.2,True,29.786766666666665,-1250,-4,-1,289,265,24
BR1_2711664121,7,False,1,1,0,18921,259,48,7.2,True,4,True,0,0,0,15578,186,63,6.6,False,28.670166666666667,3343,3,1,307,249,58
BR1_2731403239,7,False,1,0,0,17761,203,52,7.2,False,6,True,0,1,0,17662,234,56,7.4,True,28.000283333333332,99,1,1,255,290,-35
BR1_2731398629,4,True,0,0,0,13970,167,36,6.0,False,5,False,0,0,0,16040,194,44,6.8,True,26.0639,-2070,-1,0,203,238,-35
BR1_2731321545,7,False,1,0,0,17700,230,52,7.2,True,3,True,0,0,0,15604,182,64,7.0,False,28.158566666666665,2096,4,1,282,246,36
BR1_2730665719,6,True,1,0,0,16930,208,60,6.8,False,5,False,0,0,0,16429,194,52,7.2,True,28.184666666666665,501,1,1,268,246,22
BR1_2697951630,7,True,0,0,0,15736,141,44,6.2,False,15,False,1,0,0,21206,205,40,6.6,True,26.708033333333333,-5470,-8,-1,185,245,-60
BR1_2730218619,6,False,0,0,0,14821,152,52,6.6,False,7,True,1,1,0,15476,144,43,6.6,True,25.228833333333334,-655,-1,-1,204,187,17
BR1_2719606088,10,False,0,0,0,19353,180,52,7.4,True,10,True,1,1,0,17783,149,56,7.0,False,29.316133333333333,1570,0,-1,232,205,27
BR1_2728079669,4,True,0,0,0,16320,201,44,7.4,False,6,False,1,0,0,16399,198,48,7.0,True,28.05265,-79,-2,-1,245,246,-1
BR1_2727255090,5,True,1,0,0,15838,177,64,6.8,False,5,False,0,1,0,16717,216,52,7.2,True,27.5133,-879,0,1,241,268,-27
BR1_2731062986,13,True,1,1,0,20713,201,72,7.4,True,8,False,0,0,0,17956,209,48,6.8,False,29.56705,2757,5,1,273,257,16
BR1_2729541634,15,True,0,1,0,19712,173,44,7.0,False,7,False,1,0,0,17676,201,40,7.0,True,29.946266666666666,2036,8,-1,217,241,-24
BR1_2729511930,7,False,1,0,0,15034,189,36,6.8,True,11,True,0,0,0,17632,160,48,6.6,False,25.78705,-2598,-4,1,225,208,17
BR1_2722772034,8,True,0,0,0,17292,191,36,7.2,True,11,False,1,0,0,19431,197,60,7.0,False,29.846216666666667,-2139,-3,-1,227,257,-30
BR1_2722722662,8,False,1,1,0,17458,162,64,6.8,True,14,True,0,0,0,18730,211,32,7.4,False,29.378783333333335,-1272,-6,1,226,243,-17
BR1_2683005742,5,False,0,1,0,16206,184,56,7.4,False,10,True,1,0,0,20268,232,68,7.8,True,29.82345,-4062,-5,-1,240,300,-60
BR1_2718409454,15,True,0,0,0,21170,186,67,7.2,True,8,False,1,0,0,16445,147,40,6.4,False,27.8433,4725,7,-1,253,187,66
BR1_2723616095,14,False,1,0,0,19559,192,44,7.0,True,8,True,0,1,0,16625,140,64,6.6,False,29.586433333333332,2934,6,1,236,204,32
BR1_2731235328,5,True,0,0,0,16505,188,48,6.8,False,5,False,1,0,0,15251,147,48,6.8,True,27.698583333333332,1254,0,-1,236,195,41
BR1_2728641140,4,False,0,0,0,13393,124,52,6.6,False,8,True,1,0,0,17427,194,56,6.8,True,26.468433333333333,-4034,-4,-1,176,250,-74
BR1_2728630578,9,True,0,0,0,16897,184,56,7.4,False,6,False,0,0,0,17679,218,60,7.4,True,29.136233333333333,-782,3,0,240,278,-38
BR1_2724067569,12,False,1,1,0,19035,187,60,7.4,True,6,True,0,0,0,17301,188,60,7.2,False,28.190583333333333,1734,6,1,247,248,-1
BR1_2712688834,8,False,0,1,0,17329,167,61,7.0,False,12,True,1,0,0,20384,225,51,7.0,True,28.093366666666668,-3055,-4,-1,228,276,-48
BR1_2700680965,3,False,0,0,0,14444,179,33,6.8,False,6,True,1,0,0,18213,250,60,7.4,True,29.479866666666666,-3769,-3,-1,212,310,-98
BR1_2722982278,6,False,0,0,0,15208,155,40,6.6,False,8,True,1,0,0,16339,194,32,6.4,True,27.260033333333332,-1131,-2,-1,195,226,-31
BR1_2725865541,8,False,1,0,0,16389,198,48,6.6,False,10,True,0,0,0,17281,170,44,6.6,True,26.4238,-892,-2,1,246,214,32
BR1_2720656859,8,False,1,0,0,18653,209,56,7.4,True,7,True,0,1,0,17262,191,60,7.0,False,28.241416666666666,1391,1,1,265,251,14
BR1_2729714212,7,True,1,0,0,16616,188,44,6.6,True,5,False,0,0,0,14861,197,56,6.8,False,26.086716666666668,1755,2,1,232,253,-21
BR1_2729232519,2,False,1,0,0,16588,273,60,7.4,True,6,True,0,1,0,16430,176,56,7.2,False,29.83655,158,-4,1,333,232,101
BR1_2729221431,5,True,0,1,0,16768,207,48,6.6,False,11,False,1,0,0,19103,194,68,7.2,True,28.653833333333335,-2335,-6,-1,255,262,-7
BR1_2710088615,4,True,0,0,0,16079,207,44,7.2,False,4,False,1,1,0,17151,246,64,7.4,True,29.080383333333334,-1072,0,-1,251,310,-59
BR1_2710053718,5,False,1,1,0,17158,241,60,7.2,False,10,True,0,0,0,20275,258,72,8.2,True,29.104533333333332,-3117,-5,1,301,330,-29
BR1_2679787110,2,False,1,0,0,14098,158,56,6.8,False,5,True,0,0,0,15724,156,60,7.2,True,27.648,-1626,-3,1,214,216,-2
BR1_2679772689,5,False,0,0,0,14579,155,44,6.8,False,9,True,0,0,0,16257,164,52,6.8,True,26.332833333333333,-1678,-4,0,199,216,-17
BR1_2730278961,6,True,0,0,0,17635,201,50,7.2,False,6,False,0,1,0,16968,206,60,7.2,True,28.543633333333332,667,0,0,251,266,-15
BR1_2730546350,7,True,1,1,0,17471,216,44,6.8,True,6,False,0,0,0,15695,191,52,7.0,False,27.445383333333332,1776,1,1,260,243,17
BR1_2723254464,5,False,0,0,0,15083,183,63,6.6,False,8,True,1,0,0,17166,194,80,7.0,True,27.302,-2083,-3,-1,246,274,-28
BR1_2702344760,4,False,0,0,0,14329,178,44,6.8,True,3,True,0,0,0,13870,160,48,6.6,False,26.55335,459,1,0,222,208,14
BR1_2667849993,10,False,0,0,0,19883,225,44,7.6,True,8,True,0,0,0,17227,195,52,7.2,False,28.166966666666667,2656,2,0,269,247,22
BR1_2697909536,5,True,1,0,0,14987,165,53,6.4,True,8,False,0,0,0,14538,127,24,6.4,False,25.03165,449,-3,1,218,151,67
BR1_2731494573,4,True,0,0,0,14653,176,60,6.4,True,1,False,1,0,0,12336,149,52,6.6,False,25.68305,2317,3,-1,236,201,35
BR1_2730959381,13,True,0,0,0,20044,210,68,7.4,True,10,False,1,1,0,19617,215,52,7.4,False,29.847266666666666,427,3,-1,278,267,11
BR1_2728894355,2,False,1,0,0,14869,218,48,6.8,False,5,True,0,1,1,18635,205,52,7.4,True,28.581866666666667,-3766,-3,1,266,257,9
BR1_2727168511,10,True,0,0,0,18502,218,56,7.4,True,8,False,0,0,0,16523,154,48,7.0,False,29.63,1979,2,0,274,202,72
BR1_2726164892,3,True,0,0,0,16111,204,60,7.0,False,6,False,1,1,0,17554,215,44,7.2,True,29.44015,-1443,-3,-1,264,259,5
BR1_2719366788,6,True,0,0,0,15671,155,64,7.2,True,7,False,1,0,0,15761,184,52,6.8,False,27.475933333333334,-90,-1,-1,219,236,-17
BR1_2722648812,7,True,1,0,0,15331,145,36,6.6,False,6,False,0,0,0,16419,206,52,6.8,True,27.207383333333333,-1088,1,1,181,258,-77
BR1_2716989075,2,False,1,0,0,14957,206,64,7.4,False,2,True,0,1,0,15864,226,48,7.6,True,29.109416666666668,-907,0,1,270,274,-4
BR1_2729606568,9,True,0,0,0,17414,207,63,6.8,True,4,False,1,1,0,14469,168,48,7.0,False,26.7559,2945,5,-1,270,216,54
BR1_2726084240,7,True,1,0,0,16407,190,52,6.4,False,9,False,0,0,0,17496,178,56,6.8,True,25.310083333333335,-1089,-2,1,242,234,8
BR1_2730357199,9,False,1,0,0,17852,203,56,7.2,False,12,True,0,0,0,19595,185,56,7.0,True,29.639133333333334,-1743,-3,1,259,241,18
BR1_2718729372,6,True,0,0,0,16172,159,52,6.8,False,13,False,1,0,0,21017,204,52,7.2,True,28.837733333333333,-4845,-7,-1,211,256,-45
BR1_2721489171,3,False,1,0,0,13699,152,64,6.8,False,3,True,0,0,0,14845,202,60,6.8,True,26.79435,-1146,0,1,216,262,-46
BR1_2729596453,12,True,0,1,0,19245,219,68,7.8,True,3,False,0,0,0,15122,196,28,7.0,False,28.600233333333332,4123,9,0,287,224,63
BR1_2729555332,7,False,0,0,0,15247,189,32,6.6,False,8,True,1,1,0,17140,182,64,6.8,True,26.38485,-1893,-1,-1,221,246,-25
BR1_2731580075,5,True,0,0,0,14652,139,52,6.6,True,2,False,1,0,0,13843,198,48,6.6,False,26.7067,809,3,-1,191,246,-55
BR1_2730566960,6,False,1,0,0,14994,160,40,7.0,False,12,True,0,1,1,22127,240,52,7.4,True,27.95155,-7133,-6,1,200,292,-92
BR1_2730533980,3,True,1,1,0,14704,192,60,6.8,True,2,False,0,0,0,13257,175,32,6.4,False,25.890933333333333,1447,1,1,252,207,45
BR1_2730126215,11,False,0,0,0,17584,169,60,7.0,True,8,True,0,0,0,16368,166,36,6.2,False,25.333016666666666,1216,3,0,229,202,27
BR1_2729531487,9,True,0,0,0,16795,183,60,6.8,True,5,False,0,0,0,13730,120,56,6.4,False,26.2843,3065,4,0,243,176,67
BR1_2711877495,7,False,0,1,1,19173,199,64,7.2,False,6,True,0,0,0,16949,197,52,7.0,True,29.969916666666666,2224,1,0,263,249,14
BR1_2707757428,14,True,1,0,0,18729,167,56,6.6,False,9,False,0,0,0,16456,177,36,6.2,True,26.5548,2273,5,1,223,213,10
BR1_2730858597,7,True,0,0,0,16280,194,50,6.8,True,5,False,1,0,0,14135,146,54,6.4,False,27.1477,2145,2,-1,244,200,44
BR1_2696491849,10,False,0,0,0,18837,232,48,7.8,True,4,True,0,1,0,16484,212,67,7.4,False,28.0024,2353,6,0,280,279,1
BR1_2692754486,8,False,1,0,0,18203,186,70,7.2,True,5,True,0,0,0,15642,155,53,6.8,False,29.4472,2561,3,1,256,208,48
BR1_2731712867,10,True,1,1,0,17770,157,56,7.0,True,9,False,0,0,0,16942,171,56,7.0,False,29.716333333333335,828,1,1,213,227,-14
BR1_2706964316,7,True,0,0,0,15015,169,8,5.8,False,5,False,0,0,0,14915,190,52,6.4,True,26.864566666666665,100,2,0,177,242,-65
BR1_2731308244,7,False,0,0,0,16674,207,40,6.6,False,8,True,0,0,0,16637,180,56,6.6,True,25.193566666666666,37,-1,0,247,236,11
BR1_2687755480,6,False,1,0,0,15537,178,44,6.6,False,9,True,0,0,0,17344,196,52,6.8,True,28.3416,-1807,-3,1,222,248,-26
BR1_2731512679,8,False,0,0,0,16340,168,48,6.6,False,8,True,0,0,0,16118,152,64,6.8,True,25.761016666666666,222,0,0,216,216,0
BR1_2721710703,5,False,1,1,0,15901,184,64,6.8,True,7,True,0,0,0,15671,165,56,6.6,False,25.324566666666666,230,-2,1,248,221,27
BR1_2721694049,6,False,1,1,0,16519,175,63,7.0,True,10,True,0,0,0,16613,143,40,6.2,False,27.414533333333335,-94,-4,1,238,183,55
BR1_2727008149,6,True,0,0,0,15048,133,47,6.2,False,12,False,1,1,0,19619,191,52,7.0,True,26.971916666666665,-4571,-6,-1,180,243,-63
BR1_2730177293,6,False,0,0,0,15782,197,52,7.0,False,7,True,0,1,0,15947,184,52,6.4,True,26.994033333333334,-165,-1,0,249,236,13
BR1_2728884715,4,False,0,0,0,15563,185,40,6.8,False,12,True,0,1,0,19908,213,52,7.4,True,28.959416666666666,-4345,-8,0,225,265,-40
BR1_2731231291,6,True,0,0,0,16917,190,58,7.4,False,7,False,1,1,0,17177,190,52,7.4,True,29.3947,-260,-1,-1,248,242,6
BR1_2672317879,7,False,1,1,0,18017,194,60,7.4,True,6,True,0,0,0,16435,206,60,7.2,False,28.4174,1582,1,1,254,266,-12
BR1_2713300963,5,False,0,0,0,13900,143,42,6.6,False,4,True,0,0,0,14829,201,50,6.8,True,27.2872,-929,1,0,185,251,-66
BR1_2730880295,11,True,0,0,0,18827,187,48,6.8,False,7,False,1,1,0,16280,173,44,6.6,True,29.7356,2547,4,-1,235,217,18
BR1_2730046914,5,True,0,1,0,17374,207,60,7.6,True,6,False,1,0,0,15360,177,56,7.0,False,28.258666666666667,2014,-1,-1,267,233,34
BR1_2730022467,8,False,1,0,0,16550,185,36,7.4,False,8,True,0,1,0,18329,240,42,7.2,True,29.811566666666668,-1779,0,1,221,282,-61
BR1_2729999785,8,True,1,1,0,15652,137,40,6.4,True,9,False,0,0,0,16612,195,40,7.0,False,27.2873,-960,-1,1,177,235,-58
BR1_2725519873,12,False,1,1,1,20805,192,52,7.6,True,6,True,0,0,0,16484,154,48,6.6,False,28.769583333333333,4321,6,1,244,202,42
BR1_2722929399,7,False,1,0,0,15124,167,44,6.6,False,11,True,0,0,0,17864,161,48,6.4,True,25.172983333333335,-2740,-4,1,211,209,2
BR1_2708095860,8,False,0,0,0,16303,196,40,6.8,False,11,True,1,0,0,19068,184,56,7.0,True,25.6823,-2765,-3,-1,236,240,-4
BR1_2722796606,8,True,1,0,0,16219,158,56,6.8,True,6,False,0,0,0,15512,194,48,6.6,False,26.440533333333335,707,2,1,214,242,-28
BR1_2730123550,7,False,0,1,1,17595,205,56,7.0,True,4,True,1,0,0,14384,183,44,6.8,False,27.1997,3211,3,-1,261,227,34
BR1_2717133577,5,True,1,0,0,16916,228,48,7.6,False,0,False,0,0,0,14198,211,60,7.2,True,28.479516666666665,2718,5,1,276,271,5
BR1_2681989710,1,False,0,0,0,13896,180,56,7.4,False,7,True,1,1,0,18930,250,72,7.8,True,29.585866666666668,-5034,-6,-1,236,322,-86
BR1_2680831710,5,False,0,0,0,16485,176,62,7.6,False,11,True,1,0,0,19527,227,49,7.4,True,27.9249,-3042,-6,-1,238,276,-38
BR1_2730150419,11,True,0,0,0,16943,157,47,6.4,False,8,False,1,0,0,16689,150,52,6.4,True,26.727783333333335,254,3,-1,204,202,2
BR1_2730121270,9,False,1,0,0,16961,161,40,6.6,True,7,True,0,1,0,15477,163,40,6.0,False,25.232683333333334,1484,2,1,201,203,-2
BR1_2695624153,7,False,1,0,0,16849,191,64,7.2,False,6,True,0,0,0,17305,223,64,7.0,True,29.128383333333332,-456,1,1,255,287,-32
BR1_2695196610,7,False,0,1,0,17821,194,60,7.4,False,11,True,1,0,0,18931,221,48,7.4,True,29.298816666666667,-1110,-4,-1,254,269,-15
BR1_2729986789,11,True,1,0,0,17495,181,55,6.6,True,5,False,0,0,0,14033,145,40,6.2,False,26.574,3462,6,1,236,185,51
BR1_2730690304,4,False,0,0,0,13795,169,44,6.6,False,3,True,1,0,0,14547,204,48,6.8,True,26.033766666666665,-752,1,-1,213,252,-39
BR1_2730661915,6,False,1,0,0,16195,175,55,7.0,False,16,True,0,0,0,19553,194,44,7.0,True,28.194433333333333,-3358,-10,1,230,238,-8
BR1_2694051761,2,True,1,0,1,17557,220,56,7.2,True,1,False,0,0,0,14859,199,48,6.8,False,29.145183333333332,2698,1,1,276,247,29
BR1_2692648870,6,True,0,0,0,14810,179,39,6.8,True,5,False,1,0,0,15223,231,61,7.0,False,26.414516666666668,-413,1,-1,218,292,-74
BR1_2729351676,13,True,0,0,0,20535,203,56,7.0,True,12,False,0,1,0,20239,217,56,7.4,False,28.0425,296,1,0,259,273,-14
BR1_2730746638,7,True,1,1,0,17057,200,52,7.0,True,3,False,0,0,0,15033,195,28,6.8,False,28.5582,2024,4,1,252,223,29
BR1_2698683673,2,True,0,0,0,13697,188,49,6.8,False,6,False,1,1,0,16328,211,66,7.0,True,26.81735,-2631,-4,-1,237,277,-40
BR1_2698668413,12,True,1,0,0,18212,214,56,7.2,True,5,False,0,0,0,16140,190,68,6.8,False,25.693766666666665,2072,7,1,270,258,12
BR1_2698641659,6,False,0,0,0,17792,254,48,7.4,True,5,True,0,0,0,17103,239,52,7.0,False,28.81225,689,1,0,302,291,11
BR1_2731499104,10,False,1,0,0,19190,196,60,7.0,False,10,True,0,1,0,20597,196,64,7.2,True,29.9895,-1407,0,1,256,260,-4
BR1_2678219034,7,False,0,1,0,18292,209,49,7.4,False,11,True,1,0,0,18458,203,49,7.2,True,29.408283333333333,-166,-4,-1,258,252,6
BR1_2719704153,15,True,0,0,0,20052,202,44,7.2,True,6,False,1,0,0,16164,166,48,6.8,False,29.756266666666665,3888,9,-1,246,214,32
BR1_2719619443,15,True,0,0,0,20487,216,60,7.2,True,9,False,1,0,0,18430,212,40,6.8,False,28.878383333333332,2057,6,-1,276,252,24
BR1_2730709239,6,True,1,1,0,17272,195,60,7.0,True,4,False,0,0,0,16584,207,60,7.4,False,27.535866666666667,688,2,1,255,267,-12
BR1_2726477708,5,False,0,0,0,14824,181,48,6.4,False,8,True,0,0,0,18092,204,52,7.0,True,25.662966666666666,-3268,-3,0,229,256,-27
BR1_2730325432,6,True,1,0,0,16752,183,60,7.2,True,4,False,0,0,0,15778,218,48,7.0,False,28.393583333333332,974,2,1,243,266,-23
BR1_2728108384,2,False,0,0,0,13652,152,52,6.4,False,5,True,1,0,0,15328,204,52,6.8,True,25.52535,-1676,-3,-1,204,256,-52
BR1_2685448638,4,False,0,0,0,16630,244,50,7.2,True,8,True,1,0,0,17742,193,68,7.2,False,28.67825,-1112,-4,-1,294,261,33
BR1_2731555934,7,True,1,0,0,15362,151,64,6.8,False,8,False,0,0,0,15619,160,48,6.6,True,25.616616666666665,-257,-1,1,215,208,7
BR1_2731724661,2,True,1,0,0,13832,162,56,6.2,True,5,False,0,0,0,14758,176,40,6.4,False,26.086,-926,-3,1,218,216,2
BR1_2724336557,8,True,1,1,0,15742,150,56,6.4,False,6,False,0,0,0,16262,190,48,6.8,True,26.553583333333332,-520,2,1,206,238,-32
BR1_2724323556,11,True,0,0,0,16835,158,52,7.2,False,8,False,1,0,0,15863,163,48,6.4,True,26.1377,972,3,-1,210,211,-1
BR1_2731570818,4,True,0,0,0,13590,153,36,6.4,False,8,False,0,0,0,16035,169,42,6.8,True,26.460933333333333,-2445,-4,0,189,211,-22
BR1_2731558618,17,True,0,0,0,19758,128,44,6.6,False,11,False,0,1,0,17805,152,48,6.4,True,26.631566666666668,1953,6,0,172,200,-28
BR1_2730019042,7,True,0,0,0,16509,167,48,7.4,False,5,False,0,0,0,16279,188,56,7.4,True,28.1444,230,2,0,215,244,-29
BR1_2731285558,7,False,0,0,0,17800,234,68,7.4,True,5,True,1,0,0,16577,199,56,7.2,False,27.93016666666667,1223,2,-1,302,255,47
BR1_2731145944,11,False,0,0,0,19099,209,47,7.4,False,9,True,0,1,0,18270,157,52,6.8,True,28.594516666666667,829,2,0,256,209,47
BR1_2721612121,9,False,0,0,0,18273,170,48,7.2,True,9,True,1,0,0,18267,153,74,6.8,False,28.194116666666666,6,0,-1,218,227,-9
BR1_2722328122,2,False,1,0,0,15031,231,48,7.4,True,6,True,0,1,0,16809,213,48,7.2,False,27.67953333333333,-1778,-4,1,279,261,18
BR1_2730611049,7,True,1,0,0,16773,191,52,6.6,True,2,False,0,1,0,12796,124,43,6.2,False,25.493216666666665,3977,5,1,243,167,76
BR1_2699430690,9,True,1,0,0,19121,212,60,7.2,True,4,False,0,0,0,16070,201,64,7.2,False,27.5351,3051,5,1,272,265,7
BR1_2685359208,6,True,0,1,1,18564,220,56,7.8,True,5,False,0,0,0,15703,192,40,7.2,False,27.7922,2861,1,0,276,232,44
BR1_2729150063,10,True,1,0,0,17489,181,59,7.2,True,4,False,0,0,0,14925,191,52,6.6,False,25.40288333333333,2564,6,1,240,243,-3
BR1_2731162391,9,True,0,0,0,17284,201,36,6.8,True,9,False,0,0,0,16208,154,57,6.8,False,27.46625,1076,0,0,237,211,26
BR1_2681178699,3,False,0,0,0,16121,238,46,7.6,True,4,True,1,1,0,16010,200,70,7.2,False,28.961966666666665,111,-1,-1,284,270,14
BR1_2681075209,11,False,0,0,0,17382,161,36,7.0,True,4,True,1,0,0,14380,148,39,6.0,False,26.634116666666667,3002,7,-1,197,187,10
BR1_2730758275,9,True,1,0,0,17170,201,60,6.8,True,7,False,0,1,0,18198,214,52,7.2,False,29.69546666666667,-1028,2,1,261,266,-5
BR1_2723142529,16,False,1,1,0,21470,180,48,6.8,True,5,True,0,0,0,16068,179,52,6.8,False,29.867383333333333,5402,11,1,228,231,-3
BR1_2722099030,13,True,1,1,0,20337,194,40,7.6,True,6,False,0,0,0,16962,207,56,6.8,False,27.624566666666666,3375,7,1,234,263,-29
BR1_2717617980,4,False,1,0,0,14538,156,60,6.6,True,6,True,0,0,0,14762,176,44,6.6,False,25.834583333333335,-224,-2,1,216,220,-4
BR1_2729740298,3,False,1,0,1,14806,154,48,6.4,False,12,True,0,1,0,20301,208,56,7.4,True,26.1629,-5495,-9,1,202,264,-62
BR1_2729851005,6,False,0,0,0,17928,187,56,7.2,False,6,True,1,1,0,17505,208,68,7.2,True,28.388083333333334,423,0,-1,243,276,-33
BR1_2731026106,13,False,0,0,0,19306,209,52,7.2,True,7,True,1,1,0,16927,179,48,6.8,False,29.1454,2379,6,-1,261,227,34
BR1_2730856617,6,False,0,1,0,17398,183,56,7.2,True,6,True,1,0,0,16038,173,56,6.6,False,28.507916666666667,1360,0,-1,239,229,10
BR1_2729746757,9,True,1,1,0,19055,231,32,7.4,True,5,False,0,0,0,16512,193,60,7.0,False,28.55015,2543,4,1,263,253,10
BR1_2731260767,10,True,1,0,0,19272,231,71,7.2,True,4,False,0,0,0,15748,189,48,6.8,False,28.669633333333334,3524,6,1,302,237,65
BR1_2731238807,13,True,1,0,0,18259,171,32,6.6,True,3,False,0,0,0,12935,140,52,6.0,False,26.082416666666667,5324,10,1,203,192,11
BR1_2719729404,10,False,1,0,0,16957,201,52,7.2,True,4,True,0,0,0,14482,167,48,7.0,False,26.198083333333333,2475,6,1,253,215,38
BR1_2680175467,10,False,0,1,0,18154,188,48,7.0,True,5,True,0,0,0,14220,155,48,6.4,False,26.62226666666667,3934,5,0,236,203,33
BR1_2678268014,7,True,1,1,0,17240,217,48,7.6,True,3,False,0,0,0,15001,189,60,7.4,False,28.697266666666668,2239,4,1,265,249,16
BR1_2710718891,8,False,0,1,0,18951,170,68,7.0,False,13,True,1,0,0,19377,169,44,6.2,True,29.850366666666666,-426,-5,-1,238,213,25
BR1_2678814957,10,True,1,0,0,17107,219,52,7.2,True,1,False,0,0,0,13224,185,44,6.6,False,26.029816666666665,3883,9,1,271,229,42
BR1_2725858949,6,False,0,0,0,15255,170,60,6.8,False,9,True,1,0,0,17063,220,36,7.0,True,25.340366666666668,-1808,-3,-1,230,256,-26
BR1_2725014393,3,False,0,0,0,15249,187,62,6.8,True,5,True,0,0,0,15456,194,52,6.8,False,26.519633333333335,-207,-2,0,249,246,3
BR1_2726256512,11,True,0,0,0,19807,213,68,7.6,True,4,False,1,0,0,16175,201,64,7.2,False,29.9763,3632,7,-1,281,265,16
BR1_2722859558,4,True,0,0,0,15419,197,46,6.6,False,2,False,1,0,0,14053,195,52,7.0,True,26.23165,1366,2,-1,243,247,-4
BR1_2730355421,7,True,1,0,0,17373,180,48,7.0,True,6,False,0,0,0,17034,176,64,6.8,False,28.919616666666666,339,1,1,228,240,-12
BR1_2711400212,7,True,1,0,0,17379,201,64,7.2,True,2,False,0,0,0,15292,234,48,7.2,False,28.80365,2087,5,1,265,282,-17
BR1_2711389489,8,False,0,0,0,16677,152,40,6.6,False,13,True,1,1,0,18956,185,56,6.8,True,28.27625,-2279,-5,-1,192,241,-49
BR1_2711378501,4,False,0,0,0,15391,188,52,6.8,True,4,True,1,0,0,15096,174,60,6.6,False,27.319783333333334,295,0,-1,240,234,6
BR1_2729867077,2,False,0,0,0,13449,166,40,6.4,False,12,True,0,0,0,19104,208,48,7.0,True,26.526983333333334,-5655,-10,0,206,256,-50
BR1_2731095011,8,True,1,0,0,17904,189,56,6.8,True,8,False,0,1,0,17525,195,68,7.0,False,28.985566666666667,379,0,1,245,263,-18
BR1_2730332461,10,True,1,0,0,17949,181,44,6.6,False,14,False,0,1,0,19378,186,52,6.8,True,25.875716666666666,-1429,-4,1,225,238,-13
BR1_2730268407,8,True,0,0,0,17854,204,52,7.2,True,4,False,0,1,0,16086,187,64,7.2,False,28.578416666666666,1768,4,0,256,251,5
BR1_2731240473,2,False,0,1,0,15316,175,52,7.0,False,5,True,1,0,0,17153,228,51,7.0,True,29.61195,-1837,-3,-1,227,279,-52
BR1_2731345607,8,True,0,1,0,18069,216,52,7.6,True,3,False,1,0,0,16317,223,72,7.2,False,28.68326666666667,1752,5,-1,268,295,-27
BR1_2729361328,6,True,0,1,0,17165,189,60,7.4,False,10,False,1,0,0,18090,205,44,7.4,True,28.630233333333333,-925,-4,-1,249,249,0
BR1_2728512434,7,True,0,1,0,16991,173,60,7.0,False,4,False,1,0,0,16170,189,63,7.0,True,28.671383333333335,821,3,-1,233,252,-19
BR1_2726945809,3,True,1,0,0,14485,184,56,6.8,True,3,False,0,1,0,14697,186,48,6.8,False,27.482483333333334,-212,0,1,240,234,6
BR1_2731687595,4,True,0,0,0,15796,187,52,6.8,False,10,False,1,1,0,19086,201,52,7.0,True,28.400916666666667,-3290,-6,-1,239,253,-14
BR1_2728132426,4,True,0,1,0,15522,191,52,6.6,False,4,False,0,0,0,14750,190,48,6.8,True,27.122783333333334,772,0,0,243,238,5
BR1_2729253173,8,True,1,1,0,17675,222,58,7.2,True,2,False,0,0,0,15360,200,66,7.4,False,28.6436,2315,6,1,280,266,14
BR1_2690723483,8,True,0,0,0,17985,214,54,7.0,False,5,False,0,1,0,16440,183,52,7.4,True,28.401166666666665,1545,3,0,268,235,33
BR1_2724184392,7,False,0,0,0,16478,172,32,6.8,False,9,True,1,0,0,18670,196,68,7.6,True,28.122233333333334,-2192,-2,-1,204,264,-60
BR1_2724366612,7,False,0,0,0,17438,170,36,6.8,False,11,True,1,0,0,20496,225,64,7.6,True,28.35905,-3058,-4,-1,206,289,-83
BR1_2723452441,4,False,0,0,0,15368,192,52,6.8,False,6,True,1,0,0,15049,146,56,7.0,True,25.05625,319,-2,-1,244,202,42
BR1_2705404516,11,True,0,0,0,19161,198,44,6.8,True,9,False,1,0,0,16135,141,56,6.4,False,27.320516666666666,3026,2,-1,242,197,45
BR1_2705385680,7,False,0,0,0,15750,187,36,6.8,False,7,True,1,0,0,16626,172,56,7.0,True,26.5833,-876,0,-1,223,228,-5
BR1_2727840286,10,True,0,0,0,18848,201,52,7.4,False,8,False,1,0,0,17799,221,44,7.0,True,28.75485,1049,2,-1,253,265,-12
BR1_2727818889,10,False,0,0,0,18769,211,50,7.4,False,11,True,1,1,0,20244,238,60,7.4,True,29.984783333333333,-1475,-1,-1,261,298,-37
BR1_2697247480,2,False,0,0,0,13903,168,55,6.6,False,6,True,1,0,0,14928,150,61,6.8,True,26.838166666666666,-1025,-4,-1,223,211,12
BR1_2708329724,13,True,1,1,0,20454,193,76,7.4,True,6,False,0,0,0,15850,163,48,7.0,False,29.8082,4604,7,1,269,211,58
BR1_2710802537,7,True,0,0,0,16224,177,56,6.6,True,5,False,0,1,0,15141,181,52,7.0,False,27.109466666666666,1083,2,0,233,233,0
BR1_2710545840,5,False,0,1,0,15211,168,48,6.6,False,7,True,1,0,0,17249,207,56,6.8,True,26.28248333333333,-2038,-2,-1,216,263,-47
BR1_2680751224,9,True,1,0,0,16315,161,48,6.8,True,5,False,0,0,0,14742,193,48,6.6,False,27.123916666666666,1573,4,1,209,241,-32
BR1_2731582450,2,False,1,1,0,13571,185,64,6.8,False,5,True,0,0,0,14684,162,52,6.8,True,25.74585,-1113,-3,1,249,214,35
BR1_2731587916,10,True,1,0,0,19859,228,62,7.0,True,5,False,0,0,0,15846,200,48,7.2,False,29.593116666666667,4013,5,1,290,248,42
BR1_2707310790,7,True,1,0,0,17411,194,52,7.0,True,5,False,0,1,0,16345,172,59,7.2,False,29.2,1066,2,1,246,231,15
BR1_2706341296,9,False,1,1,0,16460,149,56,6.2,True,9,True,0,0,0,17011,176,64,6.6,False,25.768816666666666,-551,0,1,205,240,-35
BR1_2722568654,4,True,1,0,0,15839,230,47,7.0,True,3,False,0,0,0,13331,175,40,6.6,False,25.909816666666668,2508,1,1,277,215,62
BR1_2721082310,10,False,1,1,0,19126,190,61,7.2,True,5,True,0,0,0,16144,200,49,7.0,False,28.658133333333332,2982,5,1,251,249,2
BR1_2727766150,13,False,0,0,0,20833,216,51,7.6,False,8,True,0,0,0,17231,196,48,7.0,True,29.016383333333334,3602,5,0,267,244,23
BR1_2727191796,9,True,0,1,0,18780,197,48,7.0,False,15,False,1,0,0,20575,170,56,6.6,True,27.5249,-1795,-6,-1,245,226,19
BR1_2729697901,16,True,1,1,0,21647,229,52,7.6,True,8,False,0,0,0,17939,215,60,7.4,False,28.177983333333334,3708,8,1,281,275,6
BR1_2729673798,9,True,1,0,0,17153,203,52,7.2,True,7,False,0,0,0,17351,215,56,7.2,False,25.298733333333335,-198,2,1,255,271,-16
BR1_2707994492,5,False,1,0,0,15692,213,52,7.2,True,3,True,0,0,0,13657,175,56,6.8,False,26.5458,2035,2,1,265,231,34
BR1_2730782951,1,False,0,0,0,12479,148,48,6.4,False,12,True,1,0,0,17143,182,28,7.0,True,27.19785,-4664,-11,-1,196,210,-14
BR1_2709207636,7,True,1,0,0,16957,203,56,7.0,False,4,False,0,0,0,15931,191,56,7.2,True,29.964666666666666,1026,3,1,259,247,12
BR1_2730734688,6,True,0,0,0,15147,149,48,7.0,False,6,False,0,1,2,19792,217,52,7.2,True,27.74835,-4645,0,0,197,269,-72
BR1_2729502659,1,False,0,0,0,13919,186,60,6.4,False,8,True,0,0,0,16913,176,48,7.0,True,26.374216666666666,-2994,-7,0,246,224,22
BR1_2721946361,3,False,0,0,0,14497,185,49,6.8,True,4,True,1,0,0,15273,228,58,6.6,False,27.004083333333334,-776,-1,-1,234,286,-52
BR1_2731450336,7,False,0,0,0,14932,148,48,6.2,False,12,True,1,0,0,17711,173,51,6.8,True,26.1936,-2779,-5,-1,196,224,-28
BR1_2730904493,8,False,1,0,0,18011,180,48,6.6,False,12,True,0,0,0,18931,206,60,7.4,True,27.51625,-920,-4,1,228,266,-38
BR1_2731203878,6,False,0,0,0,17479,172,76,7.2,False,12,True,1,0,0,19100,200,36,7.2,True,29.690083333333334,-1621,-6,-1,248,236,12
BR1_2730511985,4,False,0,0,0,13538,162,29,6.6,False,7,True,1,1,1,20113,205,67,7.4,True,27.727283333333332,-6575,-3,-1,191,272,-81
BR1_2727030164,8,True,1,1,1,18812,192,60,7.0,True,5,False,0,0,0,15678,197,48,6.6,False,27.23955,3134,3,1,252,245,7
BR1_2724629301,8,True,1,0,0,17459,177,52,7.4,True,5,False,0,1,0,16675,233,60,7.0,False,28.466483333333333,784,3,1,229,293,-64
BR1_2718735744,3,False,0,0,0,13911,172,52,6.8,True,5,True,1,1,0,15644,207,56,7.0,False,26.053266666666666,-1733,-2,-1,224,263,-39
BR1_2721798177,20,True,1,1,0,23554,182,64,7.4,True,12,False,0,0,0,19474,175,52,7.0,False,28.0822,4080,8,1,246,227,19
BR1_2729760489,4,False,0,0,0,15880,217,40,7.0,False,5,True,1,0,0,17467,214,50,7.4,True,29.395333333333333,-1587,-1,-1,257,264,-7
BR1_2730989159,10,False,1,1,0,17896,191,52,7.0,True,7,True,0,0,0,15875,187,42,6.4,False,27.358883333333335,2021,3,1,243,229,14
BR1_2731533588,3,False,0,1,0,15541,182,44,6.8,False,13,True,1,0,0,20769,184,84,7.2,True,29.518183333333333,-5228,-10,-1,226,268,-42
BR1_2718388267,5,False,0,0,0,15400,163,60,6.8,False,6,True,1,1,0,16349,174,56,6.6,True,25.42385,-949,-1,-1,223,230,-7
BR1_2718481633,8,True,1,0,1,19738,204,64,7.6,True,4,False,0,0,0,15593,185,52,7.0,False,27.938666666666666,4145,4,1,268,237,31
BR1_2664334511,9,False,0,0,0,18538,197,42,7.2,False,11,True,1,0,0,18226,206,38,7.2,True,29.105033333333335,312,-2,-1,239,244,-5
BR1_2664275050,8,True,1,0,0,16449,191,40,6.8,True,5,False,0,0,0,14159,143,48,6.6,False,27.105433333333334,2290,3,1,231,191,40
BR1_2664201276,4,True,0,1,0,14062,128,60,6.2,False,7,False,1,0,0,16217,182,56,6.8,True,26.0491,-2155,-3,-1,188,238,-50
BR1_2710436135,10,False,1,0,0,18055,171,56,6.8,True,7,True,0,0,0,16610,186,44,6.8,False,29.1657,1445,3,1,227,230,-3
BR1_2688375985,4,True,0,0,0,14544,169,52,6.4,False,8,False,1,0,0,15464,177,52,6.6,True,25.657333333333334,-920,-4,-1,221,229,-8
BR1_2731692826,2,False,0,0,0,13444,152,52,6.2,False,12,True,0,0,0,18784,205,59,7.0,True,25.1602,-5340,-10,0,204,264,-60
BR1_2731716825,7,True,1,0,0,18416,225,56,7.4,True,4,False,0,0,0,15678,198,44,7.0,False,29.434616666666667,2738,3,1,281,242,39
BR1_2731282296,14,True,0,1,0,19923,177,54,7.4,False,7,False,1,0,1,18653,204,56,7.0,True,28.48185,1270,7,-1,231,260,-29
BR1_2731198398,7,True,1,1,0,16445,189,51,6.8,False,7,False,0,0,0,15654,132,72,6.6,True,27.20945,791,0,1,240,204,36
BR1_2730315741,7,False,0,1,0,16113,191,55,7.2,False,11,True,1,0,0,16923,163,44,7.0,True,27.1711,-810,-4,-1,246,207,39
BR1_2730513619,13,True,0,1,0,21206,191,50,7.2,True,10,False,1,0,0,19136,222,58,7.2,False,28.669783333333335,2070,3,-1,241,280,-39
BR1_2729392805,4,True,0,0,0,14712,189,40,6.8,False,5,False,1,0,0,16731,221,56,7.2,True,25.220633333333332,-2019,-1,-1,229,277,-48
BR1_2729374396,11,True,0,1,0,18833,217,54,6.8,True,1,False,1,0,0,13138,203,50,6.6,False,25.56915,5695,10,-1,271,253,18
BR1_2729351710,1,False,0,0,0,12433,184,40,6.2,False,9,True,1,0,0,17825,218,60,7.2,True,26.404333333333334,-5392,-8,-1,224,278,-54
BR1_2710101984,4,True,1,0,0,15752,191,68,7.2,False,8,False,0,0,0,18297,191,56,7.2,True,29.28925,-2545,-4,1,259,247,12
BR1_2702800575,8,True,0,0,0,16292,202,34,6.6,False,7,False,1,0,0,17975,218,64,7.2,True,28.645166666666668,-1683,1,-1,236,282,-46
BR1_2702743857,9,True,1,0,0,16581,183,56,7.0,True,1,False,0,1,0,14379,176,64,7.0,False,27.433,2202,8,1,239,240,-1
BR1_2683289173,8,True,1,0,0,17070,164,55,6.6,True,8,False,0,0,0,16261,154,40,6.4,False,25.690133333333332,809,0,1,219,194,25
BR1_2731651545,3,True,0,0,0,13646,166,46,6.8,False,6,False,1,0,0,16580,217,44,6.8,True,25.1307,-2934,-3,-1,212,261,-49
BR1_2731624423,8,False,0,1,1,17520,200,52,7.0,True,6,True,0,0,0,15367,170,36,6.4,False,26.044366666666665,2153,2,0,252,206,46
BR1_2731590640,9,True,1,0,0,16414,185,42,6.8,True,1,False,0,0,0,12785,164,50,6.6,False,27.4442,3629,8,1,227,214,13
BR1_2699941468,5,True,0,0,0,15796,208,44,6.8,True,0,False,1,0,0,12386,201,36,6.2,False,25.0586,3410,5,-1,252,237,15
BR1_2728857912,4,False,1,0,0,13258,157,40,6.2,False,7,True,0,0,0,16843,204,48,7.0,True,26.492316666666667,-3585,-3,1,197,252,-55
BR1_2731677635,5,True,1,1,0,15116,171,52,6.4,False,7,False,0,0,0,17480,235,56,7.0,True,25.619066666666665,-2364,-2,1,223,291,-68
BR1_2720207931,10,True,0,1,0,18250,204,40,7.6,False,6,False,1,0,0,16971,214,52,7.6,True,29.4822,1279,4,-1,244,266,-22
BR1_2727469253,4,True,0,1,0,16509,229,52,7.0,True,6,False,1,0,0,16509,193,56,7.0,False,29.187333333333335,0,-2,-1,281,249,32
BR1_2730651695,10,True,1,0,0,19659,209,60,7.2,True,7,False,0,0,0,17631,204,72,7.2,False,28.441966666666666,2028,3,1,269,276,-7
BR1_2730592922,12,True,1,1,0,19455,159,56,6.6,False,12,False,0,0,0,18802,182,52,6.8,True,27.9125,653,0,1,215,234,-19
BR1_2719576263,2,False,0,0,0,14432,178,52,6.6,False,9,True,0,1,0,19015,222,46,7.4,True,29.654466666666668,-4583,-7,0,230,268,-38
BR1_2725009921,9,False,0,0,0,18263,214,48,7.0,False,7,True,1,1,0,20091,239,72,7.8,True,28.875066666666665,-1828,2,-1,262,311,-49
BR1_2731232935,8,False,0,0,1,18326,185,48,7.2,False,8,True,1,1,0,17526,180,58,6.8,True,28.25733333333333,800,0,-1,233,238,-5
BR1_2730426806,12,False,1,1,0,17786,121,38,6.6,False,11,True,0,0,0,19562,186,44,7.2,True,29.478383333333333,-1776,1,1,159,230,-71
BR1_2729762769,6,True,0,1,0,16161,173,52,7.0,False,7,False,1,0,0,17829,212,56,6.8,True,27.673116666666665,-1668,-1,-1,225,268,-43
BR1_2729700832,4,False,0,0,0,14362,185,52,6.6,False,7,True,1,0,0,17223,200,52,6.8,True,25.781283333333334,-2861,-3,-1,237,252,-15
BR1_2728417534,6,True,1,1,0,15133,155,75,6.8,True,3,False,0,0,0,15275,206,49,6.8,False,26.486716666666666,-142,3,1,230,255,-25
BR1_2696194769,2,False,0,0,0,16276,212,64,7.2,True,4,True,1,0,0,14676,175,56,6.8,False,27.88175,1600,-2,-1,276,231,45
BR1_2695033430,8,True,0,0,0,17460,204,32,6.6,True,7,False,1,0,0,15397,169,56,6.8,False,25.92803333333333,2063,1,-1,236,225,11
BR1_2702569287,7,False,1,0,0,15426,191,36,6.8,False,7,True,0,0,0,16403,163,48,6.8,True,25.713033333333332,-977,0,1,227,211,16
BR1_2729745690,8,True,1,1,0,19106,237,55,7.2,True,4,False,0,0,0,15875,192,64,7.0,False,29.174683333333334,3231,4,1,292,256,36
BR1_2687175057,4,True,1,0,0,14034,152,48,6.4,False,7,False,0,0,0,17523,224,52,7.2,True,25.683333333333334,-3489,-3,1,200,276,-76
BR1_2687157351,7,True,0,1,0,16766,170,61,7.0,True,3,False,1,0,0,13139,151,42,6.4,False,25.37665,3627,4,-1,231,193,38
BR1_2730934338,4,True,0,0,0,13820,143,36,6.4,False,5,False,0,0,0,14745,178,40,6.8,True,27.165266666666668,-925,-1,0,179,218,-39
BR1_2729856946,12,True,1,0,0,19267,184,68,7.8,True,6,False,0,0,0,16415,168,44,7.0,False,29.8297,2852,6,1,252,212,40
BR1_2729844870,5,False,0,0,0,16012,174,52,7.0,False,8,True,1,0,1,18512,194,52,7.0,True,29.537766666666666,-2500,-3,-1,226,246,-20
BR1_2730951390,1,False,0,1,0,13603,182,52,6.4,False,3,True,1,0,0,14706,179,48,6.6,True,27.112483333333333,-1103,-2,-1,234,227,7
BR1_2689545897,0,False,1,0,0,12128,165,56,6.4,False,7,True,0,0,0,16517,207,52,7.0,True,25.67795,-4389,-7,1,221,259,-38
BR1_2680406727,6,True,1,0,1,18210,201,68,7.2,False,4,False,0,1,0,16378,188,52,7.2,True,28.998666666666665,1832,2,1,269,240,29
BR1_2727363404,5,False,0,1,0,17014,205,74,7.0,False,6,True,1,0,0,16431,206,33,7.2,True,29.5813,583,-1,-1,279,239,40
BR1_2726530428,6,False,0,0,0,15387,158,49,6.8,False,12,True,1,0,0,17336,170,56,6.6,True,26.840116666666667,-1949,-6,-1,207,226,-19
BR1_2710043246,5,True,0,0,0,16146,202,60,7.0,True,6,False,1,0,0,15085,167,52,6.4,False,25.17685,1061,-1,-1,262,219,43
BR1_2709989418,5,False,0,0,0,15432,181,32,6.4,False,10,True,0,0,0,19504,253,64,7.6,True,28.651016666666667,-4072,-5,0,213,317,-104
BR1_2709948559,8,True,1,1,0,18052,210,63,7.2,True,5,False,0,0,0,16019,208,40,7.0,False,28.986716666666666,2033,3,1,273,248,25
BR1_2708700759,3,False,0,0,0,15081,222,56,6.8,False,5,True,0,1,0,14832,161,52,6.6,True,27.206233333333333,249,-2,0,278,213,65
BR1_2728400649,12,False,0,1,0,20510,236,44,7.4,True,7,True,1,0,0,17558,213,58,7.0,False,29.476783333333334,2952,5,-1,280,271,9
BR1_2726886675,15,True,1,0,0,23209,229,56,7.4,False,8,False,0,0,0,17866,160,45,6.6,True,28.704266666666665,5343,7,1,285,205,80
BR1_2675831152,8,False,1,1,0,16939,191,56,7.2,True,3,True,0,0,0,14605,184,52,6.0,False,25.140833333333333,2334,5,1,247,236,11
BR1_2728085417,11,True,0,0,0,17075,188,40,6.6,False,4,False,0,0,0,15497,171,36,6.6,True,26.539566666666666,1578,7,0,228,207,21
BR1_2727076826,7,False,1,0,0,17224,240,51,7.4,False,6,True,0,1,0,17976,202,64,7.4,True,29.99738333333333,-752,1,1,291,266,25
BR1_2731037233,11,True,1,0,0,17590,186,60,7.0,True,4,False,0,0,0,13912,151,40,6.4,False,25.1837,3678,7,1,246,191,55
BR1_2718861213,7,True,0,0,0,16751,194,40,6.6,False,12,False,1,0,0,18188,188,60,6.8,True,29.166316666666667,-1437,-5,-1,234,248,-14
BR1_2728872067,8,True,1,0,0,16212,153,44,6.6,False,14,False,0,1,0,20426,186,40,6.8,True,28.3403,-4214,-6,1,197,226,-29
BR1_2722858637,6,True,0,0,0,15762,198,41,6.8,True,2,False,0,0,0,14590,198,38,6.8,False,25.175333333333334,1172,4,0,239,236,3
BR1_2728823186,8,False,0,0,0,17760,203,48,6.8,True,9,True,0,0,0,17750,153,36,6.6,False,29.039416666666668,10,-1,0,251,189,62
BR1_2723401608,4,True,1,1,0,15582,206,48,6.8,True,6,False,0,0,0,16461,191,44,6.8,False,27.117833333333333,-879,-2,1,254,235,19
BR1_2730959302,5,False,1,0,0,15812,186,56,6.8,True,9,True,0,0,0,16439,168,52,6.8,False,26.261766666666666,-627,-4,1,242,220,22
BR1_2726687976,4,False,0,0,0,15813,211,40,6.8,False,4,True,0,0,0,16605,220,60,7.4,True,29.526833333333332,-792,0,0,251,280,-29
BR1_2726680483,12,False,1,0,0,17651,199,61,7.2,True,4,True,0,0,0,14039,142,43,6.4,False,27.13425,3612,8,1,260,185,75
BR1_2731334828,1,False,0,1,0,14343,226,52,6.8,True,4,True,1,0,0,13825,145,48,6.6,False,27.095033333333333,518,-3,-1,278,193,85
BR1_2720401000,5,False,1,0,0,15841,207,47,7.0,False,6,True,0,1,0,16832,214,49,7.2,True,27.701866666666668,-991,-1,1,254,263,-9
BR1_2728018846,8,False,0,0,0,18588,251,60,7.2,False,4,True,0,0,0,16486,234,48,7.6,True,29.411683333333333,2102,4,0,311,282,29
BR1_2717286059,5,True,0,0,0,15828,170,52,6.6,False,8,False,1,0,0,17127,186,48,7.0,True,28.208916666666667,-1299,-3,-1,222,234,-12
BR1_2720252718,10,True,1,1,0,18358,210,52,7.2,True,2,False,0,0,0,14832,207,38,7.0,False,28.158283333333333,3526,8,1,262,245,17
BR1_2731531616,5,True,0,0,0,15154,185,60,6.8,True,4,False,0,0,0,14313,163,43,6.4,False,26.770183333333332,841,1,0,245,206,39
BR1_2730367456,7,True,0,1,0,18059,198,60,7.4,True,6,False,0,0,0,15186,157,36,6.4,False,29.614733333333334,2873,1,0,258,193,65
BR1_2722285963,8,False,0,0,0,17555,216,40,6.8,True,6,True,1,0,0,17586,204,48,7.4,False,28.393833333333333,-31,2,-1,256,252,4
BR1_2726654189,5,True,0,0,0,13693,141,36,6.2,False,8,False,0,0,0,16748,188,58,6.6,True,26.16085,-3055,-3,0,177,246,-69
BR1_2731293944,5,False,0,0,0,16700,219,36,7.0,False,11,True,1,1,0,19409,189,84,7.2,True,29.8396,-2709,-6,-1,255,273,-18
BR1_2725852859,3,False,0,0,0,14549,204,48,6.8,False,7,True,1,0,0,17371,217,59,7.0,True,25.005233333333333,-2822,-4,-1,252,276,-24
BR1_2725834456,12,False,1,1,0,17925,152,64,6.6,True,13,True,0,0,0,19428,208,44,6.8,False,26.218,-1503,-1,1,216,252,-36
BR1_2727030356,5,True,0,1,0,15166,170,52,6.8,True,4,False,1,0,0,14256,183,60,7.0,False,27.161416666666668,910,1,-1,222,243,-21
BR1_2730784533,7,False,0,0,0,17737,210,47,7.2,False,11,True,1,0,0,19385,197,76,7.6,True,29.479283333333335,-1648,-4,-1,257,273,-16
BR1_2730747912,12,True,1,0,0,18839,194,52,7.4,True,6,False,0,0,0,16824,204,60,7.0,False,28.678,2015,6,1,246,264,-18
BR1_2731622725,9,True,1,0,0,18189,178,64,7.0,True,5,False,0,0,0,17650,214,68,7.2,False,28.67185,539,4,1,242,282,-40
BR1_2730801691,9,True,0,0,0,18779,250,48,7.4,True,4,False,0,0,0,15420,189,52,7.2,False,28.75615,3359,5,0,298,241,57
BR1_2730775720,8,True,0,1,0,18431,224,60,7.4,True,5,False,1,0,0,16101,202,64,7.2,False,28.72965,2330,3,-1,284,266,18
BR1_2720611522,11,True,1,1,0,19147,195,48,6.8,True,8,False,0,0,0,17816,200,48,7.0,False,28.432,1331,3,1,243,248,-5
BR1_2694526500,5,True,0,0,0,16544,198,44,7.0,True,10,False,1,0,0,15632,140,51,6.6,False,27.993983333333333,912,-5,-1,242,191,51
BR1_2694503002,6,False,1,0,0,18616,235,52,7.6,True,8,True,0,1,0,17301,189,56,7.2,False,28.57115,1315,-2,1,287,245,42
BR1_2691395166,4,True,0,1,0,14090,182,50,6.6,False,7,False,1,0,0,15994,218,49,7.0,True,25.222416666666668,-1904,-3,-1,232,267,-35
BR1_2731687302,5,True,0,1,0,16283,183,56,7.2,False,12,False,1,0,0,19358,224,66,7.8,True,28.873783333333332,-3075,-7,-1,239,290,-51
BR1_2730348974,17,False,0,1,0,20671,167,64,7.2,True,11,True,0,0,0,19628,197,44,7.0,False,28.8467,1043,6,0,231,241,-10
BR1_2730960167,18,True,1,0,0,17782,216,56,7.2,True,3,False,0,0,0,12329,99,60,6.0,False,25.500183333333332,5453,15,1,272,159,113
BR1_2728874576,8,False,1,0,0,18533,233,76,7.4,True,7,True,0,1,0,18250,208,62,7.6,False,29.669,283,1,1,309,270,39
BR1_2702391941,2,True,0,1,0,15044,191,52,7.0,False,5,False,0,0,0,16290,189,56,7.4,True,27.52585,-1246,-3,0,243,245,-2
BR1_2731303656,6,True,1,0,0,15959,188,44,6.6,False,11,False,0,1,0,17677,160,52,6.8,True,27.34348333333333,-1718,-5,1,232,212,20
BR1_2731023288,4,True,0,0,0,14227,173,48,6.8,False,12,False,0,1,0,19227,216,56,7.0,True,25.03355,-5000,-8,0,221,272,-51
BR1_2708154323,10,False,1,0,0,18300,218,60,7.2,True,3,True,0,0,0,13630,141,44,6.6,False,27.160716666666666,4670,7,1,278,185,93
BR1_2708047173,4,True,1,0,0,16220,204,60,7.2,True,6,False,0,1,0,18109,241,55,7.6,False,27.6876,-1889,-2,1,264,296,-32
BR1_2727030258,9,True,1,0,0,16529,209,53,7.0,True,4,False,0,0,0,13974,163,26,6.4,False,27.03735,2555,5,1,262,189,73
BR1_2731161236,10,True,1,0,0,17837,156,52,6.6,True,6,False,0,1,0,15327,188,40,6.6,False,26.172833333333333,2510,4,1,208,228,-20
BR1_2730755145,4,True,0,0,0,14317,192,45,6.2,False,5,False,1,1,0,16854,205,54,7.0,True,25.250216666666667,-2537,-1,-1,237,259,-22
BR1_2711779015,9,True,0,0,0,16737,191,52,6.8,True,2,False,0,0,0,13354,176,48,6.6,False,25.67805,3383,7,0,243,224,19
BR1_2731699222,5,True,1,0,0,15714,181,60,7.0,True,7,False,0,0,0,17833,212,56,7.4,False,27.786983333333332,-2119,-2,1,241,268,-27
BR1_2731132089,13,True,0,0,0,18492,194,52,6.6,True,5,False,0,0,0,14326,160,36,6.4,False,25.64205,4166,8,0,246,196,50
BR1_2729772042,11,True,0,0,0,19252,201,44,6.8,True,11,False,0,0,0,18033,172,48,7.2,False,27.519233333333332,1219,0,0,245,220,25
BR1_2725603313,5,False,1,0,0,14409,185,28,6.8,False,3,True,0,0,0,14243,188,48,6.8,True,26.40595,166,2,1,213,236,-23
BR1_2725569055,6,True,0,0,0,14961,192,40,6.8,True,6,False,0,0,0,15215,166,44,6.6,False,26.6832,-254,0,0,232,210,22
BR1_2704942396,2,False,0,0,0,13542,171,40,6.4,False,5,True,1,0,0,15581,202,64,7.0,True,26.384916666666665,-2039,-3,-1,211,266,-55
BR1_2704925676,3,False,1,0,0,15921,207,60,7.4,True,6,True,0,1,0,18389,262,56,7.6,False,28.19696666666667,-2468,-3,1,267,318,-51
BR1_2704520313,7,True,0,0,0,17297,200,60,7.2,True,6,False,0,0,0,16768,208,52,7.4,False,28.321583333333333,529,1,0,260,260,0
BR1_2729249618,14,True,1,1,0,19524,200,64,7.6,True,6,False,0,0,0,16839,192,52,7.4,False,27.882483333333333,2685,8,1,264,244,20
BR1_2694443969,13,True,1,0,0,19545,190,56,7.0,True,4,False,0,0,0,17210,219,58,7.4,False,28.859016666666665,2335,9,1,246,277,-31
BR1_2729200153,8,False,0,0,0,18477,225,52,7.2,True,6,True,0,0,0,16817,210,44,6.8,False,27.910916666666665,1660,2,0,277,254,23
BR1_2729193549,4,True,0,0,0,14726,187,26,6.6,False,7,False,0,0,0,16236,179,52,6.6,True,28.53098333333333,-1510,-3,0,213,231,-18
BR1_2685858332,3,False,1,0,0,14820,181,60,7.2,False,7,True,0,0,0,17672,220,48,7.4,True,29.828883333333334,-2852,-4,1,241,268,-27
BR1_2730576004,5,True,1,0,0,15858,187,44,6.8,True,5,False,0,0,0,15159,186,64,7.0,False,26.517983333333333,699,0,1,231,250,-19
BR1_2703693830,11,True,0,1,0,19483,186,56,7.4,True,7,False,0,0,0,17143,215,52,7.4,False,29.4119,2340,4,0,242,267,-25
BR1_2726533345,4,True,0,0,0,16500,225,68,7.4,True,4,False,0,0,0,16970,244,54,7.4,False,28.286466666666666,-470,0,0,293,298,-5
BR1_2723701698,12,True,1,0,0,19484,225,44,7.2,False,7,False,0,1,1,19701,197,60,7.4,True,29.079516666666667,-217,5,1,269,257,12
BR1_2729959540,7,False,0,0,0,15809,190,44,6.6,True,8,True,0,0,0,16812,181,56,7.0,False,27.2961,-1003,-1,0,234,237,-3
BR1_2692564696,5,False,0,0,0,16250,208,60,7.0,True,5,True,1,0,0,14859,172,60,6.8,False,27.278266666666667,1391,0,-1,268,232,36
BR1_2731652037,5,True,0,0,0,14281,158,48,6.4,True,8,False,1,0,0,16205,189,56,7.0,False,26.491966666666666,-1924,-3,-1,206,245,-39
BR1_2731626141,7,False,0,0,0,16928,198,52,7.2,True,6,True,1,0,0,17274,230,44,7.0,False,28.470416666666665,-346,1,-1,250,274,-24
BR1_2730045974,5,False,0,0,0,14820,163,44,6.6,False,6,True,1,0,0,14753,157,44,6.6,True,27.13981666666667,67,-1,-1,207,201,6
BR1_2729239886,5,True,0,0,0,15912,206,48,6.6,True,13,False,1,0,0,20853,190,52,7.0,False,28.824616666666667,-4941,-8,-1,254,242,12
BR1_2729796696,2,False,0,0,0,14047,214,40,6.8,False,3,True,1,0,0,14298,183,64,7.0,True,25.4375,-251,-1,-1,254,247,7
BR1_2731491498,10,True,0,0,0,17612,187,28,6.4,True,13,False,1,0,0,18052,169,44,6.8,False,25.206266666666668,-440,-3,-1,215,213,2
BR1_2729350716,14,True,0,0,0,21495,260,50,7.4,True,6,False,0,1,0,16984,192,40,6.8,False,29.672133333333335,4511,8,0,310,232,78
BR1_2704117207,6,True,1,0,0,18345,228,76,7.6,True,1,False,0,0,0,14566,225,50,7.2,False,28.622816666666665,3779,5,1,304,275,29
BR1_2729816430,16,True,0,0,0,21069,211,44,7.6,True,6,False,0,0,0,16473,181,56,7.0,False,29.07435,4596,10,0,255,237,18
BR1_2729802516,1,True,0,0,0,14613,191,78,7.4,False,6,False,1,1,0,17704,208,68,7.2,True,28.616366666666668,-3091,-5,-1,269,276,-7
BR1_2731251959,6,True,0,1,0,16150,192,60,6.8,True,3,False,1,0,0,14185,187,52,6.6,False,25.194,1965,3,-1,252,239,13
BR1_2731227585,6,True,0,1,0,18228,242,51,7.6,False,8,False,0,0,0,17991,201,72,7.4,True,29.29415,237,-2,0,293,273,20
BR1_2728075198,6,False,0,1,0,15592,161,43,6.4,False,8,True,1,0,0,16226,195,47,6.8,True,26.4867,-634,-2,-1,204,242,-38
BR1_2709797812,2,False,1,0,0,13822,169,52,7.4,False,5,True,0,1,1,19073,226,64,7.4,True,27.569783333333334,-5251,-3,1,221,290,-69
BR1_2709631168,6,True,0,0,0,15022,141,24,6.2,True,12,False,1,0,0,17799,157,40,6.6,False,27.016533333333335,-2777,-6,-1,165,197,-32
BR1_2729939365,3,False,0,0,0,16082,206,48,6.8,False,12,True,1,0,0,18631,182,40,7.0,True,27.693166666666666,-2549,-9,-1,254,222,32
BR1_2704497693,4,False,0,0,0,15961,198,61,7.2,False,8,True,1,1,0,18118,229,59,7.4,True,28.226333333333333,-2157,-4,-1,259,288,-29
BR1_2704480144,2,False,0,1,0,15669,188,60,7.0,True,7,True,1,0,0,17286,152,64,6.0,False,29.931316666666667,-1617,-5,-1,248,216,32
BR1_2699253213,10,False,1,0,0,19138,206,68,7.2,True,6,True,0,1,0,16581,194,55,7.2,False,28.531216666666666,2557,4,1,274,249,25
BR1_2691960371,9,True,1,1,0,17584,221,52,7.2,True,3,False,0,0,0,14419,166,68,7.0,False,27.239566666666665,3165,6,1,273,234,39
BR1_2691933918,5,False,0,1,0,17690,216,56,7.4,False,6,True,1,0,0,17125,231,64,7.4,True,28.054716666666668,565,-1,-1,272,295,-23
BR1_2731331156,3,True,0,1,0,16425,225,56,6.8,False,5,False,1,0,0,15338,191,64,7.2,True,27.149933333333333,1087,-2,-1,281,255,26
BR1_2728996521,4,True,0,0,0,16726,235,47,7.0,False,8,False,0,1,0,17698,192,56,7.0,True,28.58205,-972,-4,0,282,248,34
BR1_2729503436,8,False,0,1,0,16036,143,48,6.6,False,4,True,1,0,0,15120,178,60,6.6,True,26.485616666666665,916,4,-1,191,238,-47
BR1_2726350715,8,True,1,0,0,15839,187,44,6.8,True,5,False,0,0,0,15080,191,52,6.4,False,25.574666666666666,759,3,1,231,243,-12
BR1_2716934146,4,False,0,0,0,15322,204,32,6.8,False,11,True,1,0,0,16973,164,36,6.2,True,26.477516666666666,-1651,-7,-1,236,200,36
BR1_2716768757,1,False,0,0,0,14145,180,44,6.6,False,14,True,0,0,0,20755,221,48,7.2,True,29.575783333333334,-6610,-13,0,224,269,-45
BR1_2722365331,4,True,0,0,0,15066,160,72,7.0,False,5,False,1,1,0,17098,221,52,7.4,True,27.740966666666665,-2032,-1,-1,232,273,-41
BR1_2731268241,11,True,0,0,0,18691,208,47,7.2,False,8,False,1,1,0,17171,175,52,7.2,True,29.08195,1520,3,-1,255,227,28
BR1_2730975363,9,True,1,0,0,16893,171,64,6.8,True,7,False,0,0,0,14988,163,40,6.4,False,25.740933333333334,1905,2,1,235,203,32
BR1_2730924493,6,True,0,0,0,15831,214,40,6.8,True,7,False,1,0,0,15740,180,48,6.4,False,27.460316666666667,91,-1,-1,254,228,26
BR1_2700585349,8,False,0,0,0,17336,193,52,7.6,True,5,True,0,1,0,16926,178,48,7.0,False,27.638683333333333,410,3,0,245,226,19
BR1_2699171804,6,False,0,0,0,17948,221,60,7.0,True,11,True,1,1,0,19156,241,64,7.4,False,29.447683333333334,-1208,-5,-1,281,305,-24
BR1_2685700509,4,False,0,0,0,15255,211,56,7.2,False,7,True,0,0,0,17598,226,44,7.4,True,29.6086,-2343,-3,0,267,270,-3
BR1_2710239711,6,True,1,0,0,17383,221,60,7.4,True,5,False,0,0,0,15787,185,56,7.0,False,28.807833333333335,1596,1,1,281,241,40
BR1_2710203683,5,False,1,0,0,14335,156,48,6.4,False,4,True,0,0,0,14356,157,39,6.4,True,26.891366666666666,-21,1,1,204,196,8
BR1_2731234219,9,True,0,0,0,17461,161,52,6.8,False,12,False,0,0,0,18749,158,52,7.2,True,29.586116666666666,-1288,-3,0,213,210,3
BR1_2722750275,8,False,1,0,0,17719,208,58,7.2,True,5,True,0,0,0,17399,208,72,7.0,False,27.827483333333333,320,3,1,266,280,-14
BR1_2722723797,5,True,1,0,0,14818,158,44,6.8,False,5,False,0,0,0,15420,169,60,6.6,True,25.0742,-602,0,1,202,229,-27
BR1_2725331445,8,True,1,0,0,17224,230,48,6.8,True,10,False,0,0,0,16263,182,39,6.8,False,25.903483333333334,961,-2,1,278,221,57
BR1_2730270040,3,True,0,0,0,16018,226,67,7.4,False,6,False,1,0,0,17279,226,56,7.4,True,27.601066666666668,-1261,-3,-1,293,282,11
BR1_2709211632,6,False,0,0,0,14992,166,40,6.4,True,6,True,1,0,0,16452,203,60,6.8,False,25.435416666666665,-1460,0,-1,206,263,-57
BR1_2709156748,3,True,0,0,0,15397,191,56,7.0,False,9,False,1,0,0,18359,219,68,7.4,True,27.54195,-2962,-6,-1,247,287,-40
BR1_2723882960,8,True,1,0,0,16928,181,64,7.2,True,13,False,0,0,0,19939,186,64,7.4,False,29.468766666666667,-3011,-5,1,245,250,-5
BR1_2705208642,2,False,0,0,0,12752,167,56,6.6,False,7,True,1,0,0,16500,182,44,6.8,True,26.83815,-3748,-5,-1,223,226,-3
BR1_2704799483,8,True,1,0,0,17643,191,47,7.2,True,1,False,0,0,0,14763,207,65,7.2,False,29.623666666666665,2880,7,1,238,272,-34
BR1_2730739893,8,False,0,1,0,18931,179,56,7.2,True,6,True,0,0,0,17721,217,56,6.8,False,29.836616666666668,1210,2,0,235,273,-38
BR1_2730716420,2,True,1,0,0,13525,173,48,6.6,True,3,False,0,0,0,14419,180,52,6.8,False,26.637966666666667,-894,-1,1,221,232,-11
BR1_2730688653,5,True,1,0,0,15926,176,52,7.0,False,6,False,0,1,0,17529,191,76,7.4,True,29.986033333333335,-1603,-1,1,228,267,-39
BR1_2713948488,6,True,0,1,0,18227,248,56,7.6,True,2,False,1,0,0,14534,140,80,7.0,False,27.7306,3693,4,-1,304,220,84
BR1_2700055251,10,False,1,0,0,19321,197,60,7.2,True,13,True,0,0,0,19904,173,40,7.2,False,28.11915,-583,-3,1,257,213,44
BR1_2731577053,6,False,0,0,0,16446,190,60,6.8,True,5,True,1,0,0,15215,204,44,6.8,False,25.096683333333335,1231,1,-1,250,248,2
BR1_2728369211,10,False,1,0,0,18079,210,52,7.4,True,5,True,0,0,0,15931,216,36,7.0,False,27.86955,2148,5,1,262,252,10
BR1_2722807170,9,False,1,0,0,16853,176,50,7.0,True,4,True,0,0,0,14229,198,53,6.6,False,26.11005,2624,5,1,226,251,-25
BR1_2718297068,7,True,1,0,0,16263,206,43,6.8,True,3,False,0,0,0,13502,156,40,6.4,False,25.002766666666666,2761,4,1,249,196,53
BR1_2730940532,7,True,0,1,0,16201,151,60,6.8,False,4,False,1,0,0,14411,157,48,6.4,True,26.569916666666668,1790,3,-1,211,205,6
BR1_2726689979,6,False,1,0,0,15125,160,52,6.6,True,9,True,0,0,0,16310,168,48,6.6,False,26.209683333333334,-1185,-3,1,212,216,-4
BR1_2695415760,11,False,1,1,0,20013,243,54,7.6,True,6,True,0,0,0,15806,152,56,7.2,False,27.96078333333333,4207,5,1,297,208,89
BR1_2731673967,12,True,0,0,0,19113,177,48,7.0,False,9,False,1,0,0,18405,207,60,7.2,True,27.591383333333333,708,3,-1,225,267,-42
BR1_2731647378,3,True,0,1,0,15685,188,48,7.0,False,8,False,1,0,0,17412,176,56,7.0,True,29.965933333333332,-1727,-5,-1,236,232,4
BR1_2695583300,6,True,0,0,0,16116,185,44,6.4,True,2,False,0,0,0,13196,171,45,6.4,False,25.073966666666667,2920,4,0,229,216,13
BR1_2731049193,6,False,0,0,0,14695,184,44,6.6,False,7,True,0,0,0,16344,170,56,6.8,True,25.138366666666666,-1649,-1,0,228,226,2
BR1_2730503777,17,False,1,1,0,21176,168,64,6.8,True,7,True,0,0,0,17389,174,40,6.6,False,29.030816666666666,3787,10,1,232,214,18
BR1_2724196614,7,False,1,1,0,16383,163,54,7.4,True,5,True,0,0,0,16534,192,61,7.2,False,29.154166666666665,-151,2,1,217,253,-36
BR1_2731384380,15,True,0,0,0,18875,153,48,6.6,True,4,False,1,0,0,13788,182,40,6.6,False,26.066433333333332,5087,11,-1,201,222,-21
BR1_2731721201,6,False,1,0,0,15903,157,56,7.0,False,9,True,0,1,0,16373,184,44,6.8,True,25.188233333333333,-470,-3,1,213,228,-15
BR1_2731668787,11,False,1,1,0,18474,170,51,7.0,False,10,True,0,0,0,19294,176,58,7.0,True,27.90695,-820,1,1,221,234,-13
BR1_2731119171,2,False,0,1,0,13369,179,44,6.8,True,5,True,1,0,0,14667,168,44,7.0,False,25.277033333333332,-1298,-3,-1,223,212,11
BR1_2731153271,9,False,0,0,0,17833,167,36,6.6,True,10,True,1,0,0,18375,179,47,6.8,False,28.615033333333333,-542,-1,-1,203,226,-23
BR1_2727278534,8,False,1,1,0,16377,143,64,7.0,True,5,True,0,0,0,14768,177,46,6.2,False,25.72985,1609,3,1,207,223,-16
BR1_2730511025,4,True,0,0,0,15041,208,44,7.0,True,5,False,0,0,0,14567,169,60,6.8,False,26.911366666666666,474,-1,0,252,229,23
BR1_2727902178,3,False,0,0,0,14760,194,57,7.0,False,11,True,1,0,0,19898,241,50,7.4,True,29.13545,-5138,-8,-1,251,291,-40
BR1_2722607436,7,True,1,0,0,18045,222,48,7.4,True,4,False,0,0,0,16692,197,68,7.2,False,27.71526666666667,1353,3,1,270,265,5
BR1_2700309538,3,False,0,1,0,15513,181,56,7.4,False,7,True,1,0,0,17156,173,56,7.2,True,29.04915,-1643,-4,-1,237,229,8
BR1_2730762094,4,True,0,0,0,14388,168,60,6.6,False,4,False,0,0,0,15697,224,44,6.8,True,26.646316666666667,-1309,0,0,228,268,-40
BR1_2728151260,9,True,1,1,0,17227,175,60,6.8,True,2,False,0,0,0,13089,146,40,6.2,False,25.405933333333333,4138,7,1,235,186,49
BR1_2704403415,14,True,0,1,0,19571,222,34,7.4,True,6,False,0,0,0,15985,182,54,6.8,False,28.571616666666667,3586,8,0,256,236,20
BR1_2724534830,5,False,0,0,0,16455,203,56,7.2,False,7,True,0,0,0,18280,207,72,7.6,True,28.013633333333335,-1825,-2,0,259,279,-20
BR1_2725500786,6,True,1,0,0,17497,207,59,7.4,True,7,False,0,0,0,18543,213,56,7.4,False,29.474483333333332,-1046,-1,1,266,269,-3
BR1_2725467501,4,False,0,1,0,14205,158,52,6.6,True,3,True,1,0,0,14697,200,52,6.8,False,26.6801,-492,1,-1,210,252,-42
BR1_2730256425,13,False,1,0,0,20798,192,56,7.4,True,12,True,0,0,0,19143,180,44,6.8,False,28.268066666666666,1655,1,1,248,224,24
BR1_2725449643,3,True,0,0,0,14990,176,52,7.2,False,7,False,1,0,0,17189,238,44,7.6,True,29.611983333333335,-2199,-4,-1,228,282,-54
BR1_2731575058,6,False,1,0,0,15738,184,52,7.0,True,2,True,0,1,0,12765,136,39,6.4,False,25.704333333333334,2973,4,1,236,175,61
BR1_2731513717,10,True,0,0,0,18819,199,52,7.2,True,9,False,1,0,0,18370,168,60,7.4,False,29.1645,449,1,-1,251,228,23
BR1_2730671465,10,False,0,0,0,20282,223,48,7.4,True,10,True,0,0,1,19826,174,68,7.4,False,28.824233333333332,456,0,0,271,242,29
BR1_2728022853,3,False,0,0,0,13679,166,54,7.0,False,6,True,0,0,0,16673,208,73,7.0,True,26.608116666666668,-2994,-3,0,220,281,-61
BR1_2671126221,10,True,0,0,0,17250,166,44,6.8,False,9,False,0,1,0,17276,156,55,6.8,True,25.867133333333335,-26,1,0,210,211,-1
BR1_2731328992,14,True,1,1,0,20172,176,44,7.2,True,6,False,0,0,0,17446,194,48,7.2,False,28.510783333333332,2726,8,1,220,242,-22
BR1_2728956806,5,False,0,0,0,13483,132,36,6.4,False,7,True,0,0,0,14607,146,48,6.4,True,26.56735,-1124,-2,0,168,194,-26
BR1_2718678114,6,True,0,1,0,15907,172,60,6.8,True,4,False,0,0,0,14857,161,28,6.8,False,29.35485,1050,2,0,232,189,43
BR1_2718287528,12,False,0,1,0,20345,220,36,7.2,True,6,True,1,0,0,16097,150,44,6.6,False,27.977,4248,6,-1,256,194,62
BR1_2731139566,11,True,1,1,0,18176,182,71,7.2,True,7,False,0,0,0,15241,156,36,6.8,False,27.015983333333335,2935,4,1,253,192,61
BR1_2726976409,10,True,0,1,0,18434,183,62,7.4,True,5,False,1,0,0,14965,168,53,6.4,False,29.4006,3469,5,-1,245,221,24
BR1_2730138519,11,True,1,0,0,17077,189,44,6.8,True,8,False,0,0,0,16049,145,36,6.2,False,27.25423333333333,1028,3,1,233,181,52
BR1_2731096550,8,True,0,1,0,18192,208,60,7.6,False,7,False,1,0,0,17278,187,52,7.2,True,29.086866666666666,914,1,-1,268,239,29
BR1_2728505204,5,False,1,0,0,14614,169,55,6.6,True,7,True,0,0,0,15929,192,56,6.8,False,25.678433333333334,-1315,-2,1,224,248,-24
BR1_2727593161,4,False,0,0,0,13938,157,40,6.2,False,5,True,0,0,0,16074,213,66,7.0,True,26.148333333333333,-2136,-1,0,197,279,-82
BR1_2727570197,4,False,0,0,0,13565,170,44,6.8,False,7,True,0,0,0,15270,184,36,6.2,True,26.659833333333335,-1705,-3,0,214,220,-6
BR1_2730095880,8,False,0,0,0,16642,159,52,7.0,False,7,True,1,0,0,16801,211,68,7.2,True,27.205266666666667,-159,1,-1,211,279,-68
BR1_2709287040,8,False,0,0,0,17480,198,56,7.0,False,6,True,0,0,0,16747,201,42,6.8,True,28.656933333333335,733,2,0,254,243,11
BR1_2730432826,9,False,0,0,0,17707,182,52,7.0,True,4,True,0,0,0,15585,192,56,7.0,False,28.477616666666666,2122,5,0,234,248,-14
BR1_2730736032,3,True,0,0,0,14781,173,36,6.8,False,6,False,1,0,0,16445,192,67,7.2,True,26.54655,-1664,-3,-1,209,259,-50
BR1_2730735395,5,True,0,0,0,15470,198,47,6.8,False,7,False,0,0,0,16935,179,56,6.8,True,25.208233333333332,-1465,-2,0,245,235,10
BR1_2730246610,10,True,0,1,0,19591,223,60,7.6,True,4,False,0,0,0,14908,180,36,7.0,False,29.61925,4683,6,0,283,216,67
BR1_2730217556,6,False,0,0,0,16342,191,52,7.0,False,13,True,1,0,0,20166,179,68,7.4,True,29.14143333333333,-3824,-7,-1,243,247,-4
BR1_2730372154,4,False,0,0,0,14822,209,40,6.6,True,10,True,1,0,0,17174,186,48,6.6,False,26.005316666666666,-2352,-6,-1,249,234,15
BR1_2731542615,14,True,1,0,0,20132,139,42,6.6,True,14,False,0,1,0,20487,141,52,7.0,False,29.084783333333334,-355,0,1,181,193,-12
BR1_2731344183,8,True,1,0,0,14230,160,28,6.2,False,11,False,0,0,0,18392,193,60,6.8,True,25.198616666666666,-4162,-3,1,188,253,-65
BR1_2730392784,9,False,1,0,0,15823,137,52,6.2,True,7,True,0,0,0,16576,182,44,6.6,False,25.0302,-753,2,1,189,226,-37
BR1_2731328515,6,True,0,0,0,17585,237,52,7.2,True,6,False,1,0,0,17344,218,72,7.4,False,28.4985,241,0,-1,289,290,-1
BR1_2731049298,4,False,1,0,0,14622,182,36,6.8,False,8,True,0,1,0,15937,201,40,7.2,True,26.310833333333335,-1315,-4,1,218,241,-23
BR1_2730472164,10,True,0,0,0,18125,179,56,7.2,False,14,False,1,0,0,19706,171,52,7.0,True,29.4503,-1581,-4,-1,235,223,12
BR1_2724646021,12,True,0,1,0,18414,166,48,7.0,False,10,False,0,0,0,19116,205,64,7.2,True,28.018483333333332,-702,2,0,214,269,-55
BR1_2724618197,5,False,0,0,0,16858,211,52,7.2,False,3,True,1,0,0,15554,216,56,7.4,True,29.529533333333333,1304,2,-1,263,272,-9
BR1_2731616984,9,False,1,0,0,20186,228,72,7.8,True,10,True,0,1,0,17283,152,32,7.2,False,29.769833333333334,2903,-1,1,300,184,116
BR1_2726119847,14,True,1,1,0,19983,183,60,7.2,True,9,False,0,0,0,17815,185,32,6.4,False,28.4903,2168,5,1,243,217,26
BR1_2731532289,8,True,1,1,1,18133,179,44,6.6,True,4,False,0,0,0,13303,134,44,5.8,False,26.206483333333335,4830,4,1,223,178,45
BR1_2731368455,7,True,0,0,0,16069,176,40,6.6,False,4,False,1,0,0,15470,230,56,6.8,True,27.3565,599,3,-1,216,286,-70
BR1_2731148937,4,True,0,0,0,15180,178,56,7.4,True,4,False,0,0,0,17185,230,76,7.8,False,28.65735,-2005,0,0,234,306,-72
BR1_2730668065,10,True,1,1,0,17937,218,56,7.4,True,3,False,0,0,0,13201,131,60,6.2,False,25.859066666666667,4736,7,1,274,191,83
BR1_2730636714,4,True,0,1,0,14737,175,52,6.6,False,4,False,1,0,0,15370,203,52,6.8,True,26.731483333333333,-633,0,-1,227,255,-28
BR1_2730930503,13,True,0,0,0,19723,217,56,7.4,False,7,False,1,1,0,18655,189,56,7.4,True,27.67193333333333,1068,6,-1,273,245,28
BR1_2731480509,5,False,1,0,0,18305,251,80,7.6,True,5,True,0,0,0,15855,211,56,7.4,False,29.622516666666666,2450,0,1,331,267,64
BR1_2725452609,7,False,0,0,0,17731,216,56,7.0,False,6,True,0,0,0,16312,188,44,7.0,True,27.9638,1419,1,0,272,232,40
BR1_2721077664,3,True,1,0,0,15168,181,64,6.8,True,5,False,0,0,0,14606,163,40,6.8,False,25.67085,562,-2,1,245,203,42
BR1_2700152436,3,True,0,0,0,14201,155,44,6.4,False,8,False,1,1,0,15281,167,56,6.4,True,27.016583333333333,-1080,-5,-1,199,223,-24
BR1_2696677885,10,True,1,0,0,18400,192,52,7.0,True,6,False,0,0,0,17082,162,56,6.6,False,29.61985,1318,4,1,244,218,26
BR1_2731254754,11,True,1,0,0,18871,183,43,6.6,True,9,False,0,0,0,17323,166,58,6.8,False,27.742933333333333,1548,2,1,226,224,2
BR1_2731195263,7,False,0,1,0,17626,173,56,7.0,False,9,True,0,0,0,17683,206,52,6.8,True,28.957566666666665,-57,-2,0,229,258,-29
BR1_2712545843,9,True,0,0,0,16950,154,48,6.8,False,8,False,0,1,0,16995,191,44,6.8,True,27.27315,-45,1,0,202,235,-33
BR1_2728511847,6,True,0,0,0,16866,217,60,7.4,False,8,False,0,0,0,18296,231,56,7.6,True,28.85935,-1430,-2,0,277,287,-10
BR1_2727495483,11,False,0,0,0,17098,156,52,6.8,True,7,True,0,1,0,16019,203,52,6.6,False,25.6428,1079,4,0,208,255,-47
BR1_2725652735,4,True,0,0,0,15531,187,48,7.0,True,6,False,0,0,0,17038,206,60,7.6,False,29.5659,-1507,-2,0,235,266,-31
BR1_2724034939,10,True,1,0,0,19266,222,68,7.4,False,7,False,0,1,0,18564,231,68,7.6,True,27.7229,702,3,1,290,299,-9
BR1_2714404491,2,True,0,0,0,14010,178,60,6.8,False,3,False,1,0,0,15174,237,44,6.8,True,26.142416666666666,-1164,-1,-1,238,281,-43
BR1_2693245381,10,True,0,0,0,18417,209,40,6.8,True,6,False,0,0,0,15040,144,55,6.6,False,26.537283333333335,3377,4,0,249,199,50
BR1_2693140751,10,False,0,1,0,18630,165,48,7.2,False,12,True,1,0,0,20068,225,52,7.6,True,28.607633333333332,-1438,-2,-1,213,277,-64
BR1_2731508969,12,True,1,1,0,19127,189,60,7.2,True,0,False,0,0,0,13182,171,48,6.2,False,28.589733333333335,5945,12,1,249,219,30
BR1_2730984930,9,True,0,0,0,17048,177,44,6.8,False,2,False,1,1,0,13290,167,40,6.6,True,26.854466666666667,3758,7,-1,221,207,14
BR1_2706114089,10,True,1,1,0,16918,178,60,7.0,True,5,False,0,0,0,14814,167,48,6.6,False,26.497866666666667,2104,5,1,238,215,23
BR1_2731195550,6,False,0,1,0,17302,189,52,7.6,True,4,True,1,0,0,15791,212,68,7.4,False,29.712333333333333,1511,2,-1,241,280,-39
BR1_2730208015,8,True,1,1,0,17669,166,56,7.4,True,4,False,0,0,0,15376,200,58,7.0,False,27.673983333333332,2293,4,1,222,258,-36
BR1_2727799796,4,True,1,1,0,15372,187,76,7.0,True,3,False,0,0,0,14135,174,56,6.8,False,25.88735,1237,1,1,263,230,33
BR1_2725344175,2,False,0,0,0,14305,182,48,7.0,False,9,True,1,0,0,17194,169,68,7.2,True,29.25995,-2889,-7,-1,230,237,-7
BR1_2716288929,3,True,0,0,0,16810,235,64,7.6,False,6,False,1,0,0,17717,257,56,7.6,True,28.868683333333333,-907,-3,-1,299,313,-14
BR1_2731394861,3,False,0,0,0,12317,142,36,6.4,False,9,True,0,0,0,17146,182,40,6.8,True,25.471416666666666,-4829,-6,0,178,222,-44
BR1_2731394398,7,False,1,0,0,14731,138,36,6.4,False,10,True,0,1,0,17473,198,56,7.0,True,27.014666666666667,-2742,-3,1,174,254,-80
BR1_2728140079,3,False,1,1,0,15070,175,72,7.6,False,3,True,0,0,0,15709,221,49,7.0,True,28.644633333333335,-639,0,1,247,270,-23
BR1_2724798875,12,True,0,0,0,18494,213,52,7.4,True,9,False,1,0,0,17543,203,55,7.0,False,27.501433333333335,951,3,-1,265,258,7
BR1_2721712687,2,False,0,0,0,13775,172,47,6.6,False,6,True,1,0,0,14980,144,52,6.4,True,25.8175,-1205,-4,-1,219,196,23
BR1_2718672608,7,False,1,0,0,16216,206,54,7.0,False,6,True,0,0,0,15100,172,36,6.6,True,25.507166666666667,1116,1,1,260,208,52
BR1_2718510449,4,True,0,0,0,16318,161,64,7.0,False,9,False,1,0,0,18552,229,60,7.2,True,28.06385,-2234,-5,-1,225,289,-64
BR1_2698699369,7,True,0,1,0,16938,209,56,7.0,True,5,False,0,0,0,15684,169,52,6.6,False,25.59035,1254,2,0,265,221,44
BR1_2730382532,3,True,1,0,0,16193,201,48,7.0,True,3,False,0,1,0,14988,186,56,7.0,False,29.4314,1205,0,1,249,242,7
BR1_2729173477,7,True,0,0,0,15864,208,52,6.8,True,1,False,0,0,0,13271,160,60,6.6,False,26.636616666666665,2593,6,0,260,220,40
BR1_2714497604,10,True,1,0,0,18551,186,64,7.4,True,7,False,0,0,0,17210,221,48,7.0,False,28.6766,1341,3,1,250,269,-19
BR1_2731302566,5,False,0,0,0,17048,202,59,7.2,False,8,True,1,1,0,19128,246,47,7.6,True,29.637983333333334,-2080,-3,-1,261,293,-32
BR1_2680661075,5,False,0,1,0,16044,177,64,7.0,True,5,True,1,0,0,14649,168,44,6.6,False,26.1316,1395,0,-1,241,212,29
BR1_2731632054,11,False,0,0,0,17180,175,40,6.8,True,7,True,0,0,0,15534,147,44,6.6,False,26.646266666666666,1646,4,0,215,191,24
BR1_2710654033,7,False,0,0,0,17107,159,44,6.6,False,13,True,0,0,0,20003,202,56,7.0,True,28.494716666666665,-2896,-6,0,203,258,-55
BR1_2684110836,11,True,1,1,0,19681,177,48,7.2,True,7,False,0,0,0,16951,174,68,7.2,False,28.893666666666668,2730,4,1,225,242,-17
BR1_2707034708,3,False,0,1,0,14072,127,60,6.8,False,7,True,1,0,0,17346,199,52,7.4,True,29.10165,-3274,-4,-1,187,251,-64
BR1_2701129214,7,True,1,0,0,14147,123,44,6.2,False,12,False,0,1,0,17412,160,40,6.4,True,26.6317,-3265,-5,1,167,200,-33
BR1_2730822733,5,False,0,0,0,14770,181,44,6.6,False,10,True,1,1,0,16586,159,56,6.8,True,27.301433333333332,-1816,-5,-1,225,215,10
BR1_2730878445,4,True,0,0,0,15002,173,48,7.0,False,10,False,1,0,0,19769,216,88,8.0,True,29.6899,-4767,-6,-1,221,304,-83
BR1_2731511103,6,False,1,0,0,15280,171,65,6.8,True,5,True,0,0,0,14753,172,42,6.6,False,27.212066666666665,527,1,1,236,214,22
BR1_2718743824,8,True,0,0,0,16973,206,47,7.0,True,2,False,1,1,0,13514,179,44,6.6,False,27.112716666666667,3459,6,-1,253,223,30
BR1_2707035121,7,True,1,0,0,16289,174,60,6.6,False,7,False,0,1,0,17002,182,56,6.8,True,26.839933333333335,-713,0,1,234,238,-4
BR1_2731239114,8,True,0,0,0,16770,165,39,7.0,False,4,False,1,0,0,16640,190,72,7.2,True,29.143533333333334,130,4,-1,204,262,-58
BR1_2725945485,5,True,1,0,0,16527,156,56,7.0,False,9,False,0,0,1,17129,159,52,6.8,True,28.373733333333334,-602,-4,1,212,211,1
BR1_2731648462,11,True,1,1,0,18169,183,60,7.2,True,6,False,0,0,0,17781,184,64,6.6,False,29.949033333333333,388,5,1,243,248,-5
BR1_2731387618,6,True,0,0,0,16101,169,52,6.6,True,6,False,0,0,0,15739,172,51,6.6,False,27.4029,362,0,0,221,223,-2
BR1_2731360962,9,True,0,0,0,17084,178,56,6.8,True,7,False,1,0,0,15586,170,64,6.6,False,25.411066666666667,1498,2,-1,234,234,0
BR1_2731648481,4,True,0,0,0,13923,169,36,6.2,False,6,False,1,0,0,15256,207,56,6.8,True,25.37911666666667,-1333,-2,-1,205,263,-58
BR1_2719323244,7,True,1,0,0,16029,154,50,6.8,True,7,False,0,0,0,16360,173,42,6.6,False,28.700833333333332,-331,0,1,204,215,-11
BR1_2707757359,4,True,0,0,0,16025,179,52,7.0,False,4,False,1,0,0,15601,202,52,7.0,True,29.795183333333334,424,0,-1,231,254,-23
BR1_2728297589,14,True,0,0,0,18697,216,48,7.0,True,4,False,0,0,0,13811,135,44,6.4,False,26.763583333333333,4886,10,0,264,179,85
BR1_2728278803,3,False,0,0,0,13820,160,48,6.6,False,6,True,0,1,0,16297,231,60,7.4,True,26.4393,-2477,-3,0,208,291,-83
BR1_2712856455,11,True,0,0,0,18003,177,48,6.8,True,9,False,0,0,0,16641,156,40,6.4,False,26.603183333333334,1362,2,0,225,196,29
BR1_2668165854,7,False,0,0,0,15118,175,48,6.8,True,9,True,1,0,0,16705,181,54,6.8,False,25.221466666666668,-1587,-2,-1,223,235,-12
BR1_2667107206,9,False,1,0,0,18021,192,52,7.2,True,6,True,0,0,0,14692,169,44,6.8,False,25.2535,3329,3,1,244,213,31
BR1_2718246935,7,True,0,0,0,13796,143,32,6.4,False,4,False,1,0,0,16547,181,64,7.2,True,27.075783333333334,-2751,3,-1,175,245,-70
BR1_2688554893,10,True,1,1,0,20104,265,60,7.4,False,5,False,0,0,0,16356,221,60,7.4,True,29.198266666666665,3748,5,1,325,281,44
BR1_2685360667,10,False,0,0,0,18477,223,43,6.8,False,11,True,1,0,0,18946,173,63,7.0,True,25.835616666666667,-469,-1,-1,266,236,30
BR1_2726677659,2,True,0,0,0,14939,191,56,7.4,True,7,False,1,0,0,15888,181,48,7.4,False,27.824166666666667,-949,-5,-1,247,229,18
BR1_2726755784,12,True,1,0,0,18157,176,56,6.6,True,4,False,0,0,0,13424,182,32,6.2,False,27.1585,4733,8,1,232,214,18
BR1_2693732522,2,True,0,0,0,14527,179,44,7.2,False,3,False,1,0,0,15432,210,56,7.4,True,29.537,-905,-1,-1,223,266,-43
BR1_2731501792,2,True,0,0,0,13927,180,55,7.0,False,4,False,1,0,0,15388,205,64,7.2,True,25.67728333333333,-1461,-2,-1,235,269,-34
BR1_2731451287,12,True,1,0,0,20272,218,53,7.2,True,4,False,0,0,0,16952,241,44,7.0,False,29.77125,3320,8,1,271,285,-14
BR1_2731444045,5,True,0,0,0,16737,219,41,6.8,True,5,False,0,0,0,15902,195,64,7.0,False,26.462066666666665,835,0,0,260,259,1
BR1_2730150633,5,True,1,0,0,16145,193,56,7.0,True,4,False,0,0,0,14154,129,60,6.0,False,26.2031,1991,1,1,249,189,60
BR1_2731151828,6,True,1,0,0,16045,197,60,6.8,True,4,False,0,0,0,15315,189,40,6.6,False,27.466983333333335,730,2,1,257,229,28
BR1_2731095121,10,True,1,1,1,19631,178,56,6.8,True,6,False,0,0,0,14775,139,47,5.8,False,25.5447,4856,4,1,234,186,48
BR1_2731073970,7,True,0,1,0,16096,177,48,6.8,True,9,False,0,0,0,16713,208,48,6.8,False,25.916633333333333,-617,-2,0,225,256,-31
BR1_2696269500,6,True,0,0,0,16075,186,50,6.6,True,5,False,1,0,0,15024,167,44,6.4,False,26.946816666666667,1051,1,-1,236,211,25
BR1_2692236125,8,False,1,0,0,16904,191,44,7.0,True,5,True,0,0,0,14568,168,52,6.4,False,25.6219,2336,3,1,235,220,15
BR1_2692223839,4,False,0,0,0,13550,162,40,6.4,False,9,True,0,0,0,17804,185,56,7.0,True,25.0156,-4254,-5,0,202,241,-39
BR1_2729154717,0,False,0,0,0,13107,188,44,6.6,True,5,True,1,1,0,16127,180,56,7.0,False,26.772516666666668,-3020,-5,-1,232,236,-4
BR1_2688157387,7,True,1,0,0,15762,163,48,6.6,True,2,False,0,0,0,12899,174,44,6.4,False,25.883933333333335,2863,5,1,211,218,-7
BR1_2722895222,6,False,1,0,0,16711,176,52,7.0,True,9,True,0,1,0,18555,205,48,7.2,False,29.470683333333334,-1844,-3,1,228,253,-25
BR1_2722867559,7,False,0,0,0,16423,180,56,7.2,False,11,True,1,0,0,20211,223,36,7.4,True,29.40726666666667,-3788,-4,-1,236,259,-23
BR1_2722764933,6,False,0,0,0,15326,154,44,6.6,False,8,True,1,1,0,16228,143,40,6.2,True,26.9749,-902,-2,-1,198,183,15
BR1_2731339132,5,True,1,0,0,16362,215,60,7.2,True,5,False,0,1,0,17238,243,48,7.4,False,28.37685,-876,0,1,275,291,-16
BR1_2730857577,4,False,1,0,0,16659,221,49,7.0,False,5,True,0,1,0,16252,190,39,7.0,True,27.976933333333335,407,-1,1,270,229,41
BR1_2690236584,14,True,0,0,0,19203,202,38,7.0,True,6,False,1,0,0,15713,165,57,6.0,False,25.7494,3490,8,-1,240,222,18
BR1_2687153410,5,True,0,0,0,14329,152,36,6.6,False,12,False,0,0,0,17253,179,56,7.2,True,25.765666666666668,-2924,-7,0,188,235,-47
BR1_2724947641,3,False,0,1,0,15125,168,63,7.0,False,14,True,1,0,0,19214,194,56,7.6,True,29.974333333333334,-4089,-11,-1,231,250,-19
BR1_2724585501,5,False,1,0,0,15389,201,56,7.0,True,6,True,0,1,0,15848,211,60,6.8,False,25.75123333333333,-459,-1,1,257,271,-14
BR1_2730076467,6,False,0,0,0,17222,247,55,7.8,True,6,True,0,1,0,18103,258,48,7.2,False,28.028683333333333,-881,0,0,302,306,-4
BR1_2731018376,12,False,1,0,0,20642,194,63,7.4,True,7,True,0,0,0,17746,208,32,6.8,False,28.02545,2896,5,1,257,240,17
BR1_2727478413,3,True,0,0,0,17174,237,68,7.2,False,10,False,1,1,0,18872,206,56,7.4,True,29.440183333333334,-1698,-7,-1,305,262,43
BR1_2716243594,8,False,1,0,0,17293,151,75,7.4,True,5,True,0,1,0,17356,213,56,7.4,False,29.0865,-63,3,1,226,269,-43
BR1_2727097356,4,False,0,0,0,15207,159,52,7.2,False,9,True,0,1,0,19463,245,44,7.4,True,27.509016666666668,-4256,-5,0,211,289,-78
BR1_2697635887,5,True,0,0,0,13862,132,52,6.6,False,6,False,1,0,0,16240,222,52,7.2,True,25.278866666666666,-2378,-1,-1,184,274,-90
BR1_2696144730,12,True,0,0,0,20510,237,68,7.6,True,7,False,1,0,0,16336,180,52,6.8,False,28.044183333333333,4174,5,-1,305,232,73
BR1_2721968716,5,True,0,0,0,14326,166,40,6.2,False,7,False,0,0,0,16166,195,52,7.0,True,26.330366666666666,-1840,-2,0,206,247,-41
BR1_2689314129,5,False,1,1,0,15019,166,52,6.4,True,6,True,0,0,0,14837,161,60,6.2,False,27.355833333333333,182,-1,1,218,221,-3
BR1_2731573761,6,False,0,1,0,17974,219,68,7.4,False,12,True,1,0,1,20545,221,60,7.4,True,27.6285,-2571,-6,-1,287,281,6
BR1_2731560149,6,True,1,0,0,16756,199,48,7.0,False,5,False,0,1,0,17321,221,60,7.2,True,27.51235,-565,1,1,247,281,-34
BR1_2730310506,1,False,0,1,0,12869,148,47,6.4,False,8,True,1,0,0,16085,161,52,6.6,True,26.04975,-3216,-7,-1,195,213,-18
BR1_2731529115,5,False,0,0,0,14432,181,46,6.8,False,8,True,0,0,0,17345,191,46,6.8,True,26.41946666666667,-2913,-3,0,227,237,-10
BR1_2731311408,5,False,0,0,0,15945,176,51,6.6,False,15,True,1,1,0,20577,198,44,7.2,True,28.62301666666667,-4632,-10,-1,227,242,-15
BR1_2730503920,6,False,0,1,0,17100,201,52,7.2,True,7,True,0,0,0,16868,183,52,7.2,False,29.88225,232,-1,0,253,235,18
BR1_2693283441,7,False,0,0,0,18827,222,64,7.6,False,5,True,1,1,0,16016,199,52,7.6,True,28.4629,2811,2,-1,286,251,35
BR1_2726567782,8,False,0,1,0,18448,201,56,7.4,True,9,True,1,0,0,17582,193,70,7.2,False,28.26275,866,-1,-1,257,263,-6
BR1_2701831902,6,True,1,0,0,15697,164,48,6.8,True,4,False,0,0,0,14599,149,44,6.6,False,26.917033333333332,1098,2,1,212,193,19
BR1_2700186545,4,False,1,1,1,17175,205,52,7.2,True,9,True,0,0,0,19077,206,68,7.4,False,28.3906,-1902,-5,1,257,274,-17
BR1_2689889024,8,False,0,0,0,16620,194,24,6.8,False,15,True,0,0,0,21464,229,51,7.4,True,29.724183333333333,-4844,-7,0,218,280,-62
BR1_2689750090,2,False,0,0,0,15319,206,60,6.8,False,5,True,1,0,0,18011,260,68,7.4,True,28.514366666666668,-2692,-3,-1,266,328,-62
BR1_2727735012,5,True,1,1,0,14982,191,52,6.8,True,1,False,0,0,0,13745,172,68,7.2,False,27.00711666666667,1237,4,1,243,240,3
BR1_2729581018,4,True,1,0,0,16221,216,54,7.2,True,5,False,0,1,0,16283,183,43,7.2,False,28.778683333333333,-62,-1,1,270,226,44
BR1_2725856828,7,True,0,0,0,16820,193,59,7.0,False,12,False,1,1,0,17723,178,37,7.4,True,27.6989,-903,-5,-1,252,215,37
BR1_2663294879,4,False,0,0,0,16148,217,60,7.8,False,4,True,1,1,0,17058,214,76,7.2,True,29.492583333333332,-910,0,-1,277,290,-13
BR1_2731351836,16,False,0,1,0,20794,175,40,7.2,False,10,True,1,0,0,18958,198,48,7.0,True,29.868,1836,6,-1,215,246,-31
BR1_2731338958,4,False,0,0,0,12900,155,0,5.8,False,5,True,0,1,0,16000,182,64,6.6,True,26.15438333333333,-3100,-1,0,155,246,-91
BR1_2730587703,8,False,1,1,0,17007,176,48,6.8,False,13,True,0,0,0,21309,230,47,7.2,True,29.88521666666667,-4302,-5,1,224,277,-53
BR1_2699034344,5,True,0,0,0,16928,193,52,7.4,False,9,False,1,1,0,18058,183,68,7.2,True,28.87255,-1130,-4,-1,245,251,-6
BR1_2714943614,11,True,1,0,0,18465,196,64,7.6,False,3,False,0,1,0,15847,208,48,7.0,True,29.155116666666668,2618,8,1,260,256,4
BR1_2697263272,10,True,1,0,0,17881,190,47,7.0,True,2,False,0,1,0,13340,159,48,6.2,False,26.796583333333334,4541,8,1,237,207,30
BR1_2712762827,11,False,0,0,0,17260,155,48,6.6,True,10,True,0,0,0,16566,161,32,6.6,False,27.064866666666667,694,1,0,203,193,10
BR1_2723879144,12,True,0,0,0,18025,156,36,6.8,False,8,False,0,0,0,16067,170,40,6.4,True,26.6974,1958,4,0,192,210,-18
BR1_2730248566,5,True,0,0,0,12995,125,31,5.8,False,10,False,1,0,0,17720,164,56,6.4,True,25.241966666666666,-4725,-5,-1,156,220,-64
BR1_2725022707,5,True,1,0,0,16533,207,68,7.4,True,3,False,0,1,0,14747,169,58,7.4,False,27.98865,1786,2,1,275,227,48
BR1_2722925719,7,True,0,0,0,17771,219,60,7.4,True,5,False,1,1,0,17344,202,56,7.4,False,29.152633333333334,427,2,-1,279,258,21
BR1_2726041942,12,False,1,0,0,19166,181,48,6.6,True,6,True,0,0,0,15934,190,40,6.4,False,26.47745,3232,6,1,229,230,-1
BR1_2692171780,11,False,1,1,0,18455,152,58,7.2,False,9,True,0,0,0,17675,194,53,7.0,True,29.001433333333335,780,2,1,210,247,-37
BR1_2676596782,5,False,1,0,0,14783,193,52,6.8,False,5,True,0,0,0,15012,194,56,6.8,True,26.618166666666667,-229,0,1,245,250,-5
BR1_2673587183,11,True,1,0,1,22658,217,71,7.8,True,7,False,0,1,0,17816,201,58,7.2,False,28.751666666666665,4842,4,1,288,259,29
BR1_2724010467,8,True,1,0,0,17722,198,60,7.0,False,7,False,0,1,0,18617,221,72,7.4,True,29.56005,-895,1,1,258,293,-35
BR1_2725576557,4,False,1,0,0,16499,204,56,7.2,False,9,True,0,1,0,17739,215,52,7.8,True,27.543083333333332,-1240,-5,1,260,267,-7
BR1_2704070747,3,False,0,0,0,15200,263,40,7.2,False,5,True,1,0,0,17055,249,48,7.2,True,29.6923,-1855,-2,-1,303,297,6
BR1_2731524076,6,True,0,0,0,17587,211,44,7.2,False,10,False,1,0,0,17693,176,52,7.2,True,28.404583333333335,-106,-4,-1,255,228,27
BR1_2731510112,4,False,0,0,0,14552,182,52,6.6,True,2,True,0,0,0,14046,208,56,6.8,False,26.7619,506,2,0,234,264,-30
BR1_2688553616,8,False,1,0,0,16922,190,52,7.2,True,1,True,0,0,0,13697,189,59,6.4,False,27.020783333333334,3225,7,1,242,248,-6
BR1_2688207580,11,False,1,0,0,18473,234,50,7.0,False,7,True,0,1,0,18014,205,64,7.2,True,28.772916666666667,459,4,1,284,269,15
BR1_2713959307,10,True,0,1,0,17514,156,44,6.8,True,5,False,1,0,0,14970,161,52,6.4,False,25.060983333333333,2544,5,-1,200,213,-13
BR1_2713929434,5,True,1,0,0,16467,188,65,7.2,False,10,False,0,1,0,19131,216,68,7.6,True,29.532566666666668,-2664,-5,1,253,284,-31
BR1_2713894423,5,True,0,0,0,16224,202,60,7.0,False,12,False,1,0,0,20858,221,72,7.4,True,28.784116666666666,-4634,-7,-1,262,293,-31
BR1_2730536491,10,True,1,1,0,19053,216,72,7.2,True,6,False,0,0,0,16405,193,52,7.2,False,29.188833333333335,2648,4,1,288,245,43
BR1_2729551555,4,False,0,1,0,14938,188,43,6.8,False,3,True,1,0,1,17811,238,65,7.4,True,29.6778,-2873,1,-1,231,303,-72
BR1_2694301861,9,True,1,0,0,16680,188,52,7.0,True,3,False,0,0,0,12976,136,48,6.2,False,26.659516666666665,3704,6,1,240,184,56
BR1_2719236102,5,False,0,0,0,13977,154,36,6.4,False,13,True,0,1,0,20546,214,52,7.6,True,29.62035,-6569,-8,0,190,266,-76
BR1_2719216051,10,True,0,0,0,18090,180,32,7.2,True,7,False,1,1,0,17249,177,60,7.2,False,28.179366666666667,841,3,-1,212,237,-25
BR1_2719184883,8,True,1,0,0,16196,182,56,6.6,True,3,False,0,0,0,14374,158,56,6.8,False,25.082933333333333,1822,5,1,238,214,24
BR1_2719171166,14,True,1,1,1,22353,212,49,7.0,True,13,False,0,0,0,19979,182,44,7.0,False,29.632416666666668,2374,1,1,261,226,35
BR1_2726284468,5,False,1,1,0,16697,190,60,7.2,True,5,True,0,0,0,15734,177,44,6.8,False,28.445133333333334,963,0,1,250,221,29
BR1_2730174266,12,True,1,0,0,18762,179,40,6.8,True,5,False,0,0,0,13959,160,36,6.6,False,25.646816666666666,4803,7,1,219,196,23
BR1_2718365589,4,True,1,0,0,14989,174,52,6.8,False,9,False,0,1,0,17385,206,64,7.2,True,26.70005,-2396,-5,1,226,270,-44
BR1_2717936997,3,False,0,0,0,13591,166,24,6.2,False,11,True,1,0,0,17869,180,60,6.8,True,25.194433333333333,-4278,-8,-1,190,240,-50
BR1_2723231709,5,True,0,1,0,14602,183,48,6.6,True,7,False,1,0,0,16842,208,60,7.0,False,26.064833333333333,-2240,-2,-1,231,268,-37
BR1_2731132566,6,True,0,1,0,16539,206,56,7.0,True,7,False,1,0,0,15332,145,48,7.0,False,26.204516666666667,1207,-1,-1,262,193,69
BR1_2730781363,8,True,0,0,0,17154,188,52,6.4,False,7,False,1,0,0,14683,143,60,6.4,True,26.0177,2471,1,-1,240,203,37
BR1_2728553029,3,True,1,0,0,16220,238,48,7.2,True,6,False,0,0,0,17202,203,76,7.4,False,29.614216666666668,-982,-3,1,286,279,7
BR1_2731566109,7,True,1,1,0,15863,167,49,6.8,True,4,False,0,0,0,15424,199,53,6.8,False,25.839783333333333,439,3,1,216,252,-36
BR1_2730473984,5,False,0,0,0,15387,195,12,6.4,False,6,True,1,0,0,17593,211,64,7.2,True,29.05385,-2206,-1,-1,207,275,-68
BR1_2730450810,5,False,0,0,0,15874,177,60,7.2,True,3,True,1,1,0,15288,206,52,7.0,False,29.219466666666666,586,2,-1,237,258,-21
BR1_2690639101,8,True,1,0,0,16009,187,60,6.8,True,3,False,0,0,0,12777,160,51,6.6,False,26.53685,3232,5,1,247,211,36
BR1_2686469743,1,False,0,1,0,13221,162,48,6.4,False,4,True,0,0,0,15700,217,52,6.6,True,25.196233333333332,-2479,-3,0,210,269,-59
BR1_2686431895,6,True,0,0,0,15715,182,54,6.6,True,7,False,0,0,0,16762,188,46,7.2,False,26.997833333333332,-1047,-1,0,236,234,2
BR1_2729609252,8,True,1,1,0,17497,190,70,7.2,True,3,False,0,0,0,16518,243,56,7.0,False,28.913416666666667,979,5,1,260,299,-39
BR1_2729607960,9,True,0,0,0,17024,179,70,6.8,False,10,False,0,0,0,16432,175,41,6.6,True,26.398966666666666,592,-1,0,249,216,33
BR1_2687112955,4,True,0,0,0,14572,178,52,6.6,False,4,False,0,0,0,14663,163,58,7.0,True,26.818133333333332,-91,0,0,230,221,9
BR1_2731489676,4,True,0,0,0,14357,188,40,6.6,False,5,False,1,0,0,15709,188,56,6.8,True,25.10965,-1352,-1,-1,228,244,-16
BR1_2714317200,4,False,0,0,0,13578,155,55,7.0,False,5,True,1,0,0,15300,197,40,6.6,True,26.256466666666668,-1722,-1,-1,210,237,-27
BR1_2726547472,7,False,0,0,0,15573,156,36,6.6,False,9,True,1,0,0,16585,168,44,6.8,True,27.0705,-1012,-2,-1,192,212,-20
BR1_2729422041,8,False,0,0,0,17288,174,50,6.8,False,13,True,1,1,0,20153,196,49,7.4,True,29.830033333333333,-2865,-5,-1,224,245,-21
BR1_2730812773,7,True,0,1,0,18166,200,55,7.2,True,6,False,0,0,0,16926,240,48,7.6,False,28.048233333333332,1240,1,0,255,288,-33
BR1_2731170460,3,False,0,0,0,14033,162,48,6.4,False,5,True,1,1,0,15591,197,48,6.8,True,26.38105,-1558,-2,-1,210,245,-35
BR1_2731132394,6,False,0,0,0,15752,162,40,6.6,True,14,True,1,0,0,19449,159,52,6.8,False,29.575733333333332,-3697,-8,-1,202,211,-9
BR1_2729734638,3,False,0,0,0,14908,190,44,7.2,False,10,True,1,1,0,19396,229,68,7.8,True,27.99363333333333,-4488,-7,-1,234,297,-63
BR1_2731346541,7,True,0,0,0,17285,211,60,7.2,True,8,False,0,0,0,16760,166,39,6.8,False,29.42905,525,-1,0,271,205,66
BR1_2731336147,3,False,0,1,0,16934,256,56,7.2,False,5,True,1,0,0,16562,206,64,7.4,True,29.75365,372,-2,-1,312,270,42
BR1_2730940037,8,True,0,1,0,20037,213,52,7.6,True,13,False,0,0,1,21428,224,80,7.8,False,28.1878,-1391,-5,0,265,304,-39
BR1_2689296027,4,False,0,1,0,15402,200,56,6.8,True,3,True,1,0,0,14553,190,52,7.0,False,27.092266666666667,849,1,-1,256,242,14
BR1_2720081139,8,False,0,0,0,16522,135,52,7.0,False,12,True,1,0,0,20577,218,58,7.4,True,28.1767,-4055,-4,-1,187,276,-89
BR1_2697421915,3,False,0,0,0,16261,225,40,7.2,True,7,True,1,0,0,16931,189,64,7.4,False,28.557366666666667,-670,-4,-1,265,253,12
BR1_2708112390,4,False,0,0,0,15219,174,56,6.6,False,8,True,1,1,0,16946,183,60,6.8,True,27.4522,-1727,-4,-1,230,243,-13
BR1_2695506144,9,False,0,0,0,17527,194,52,7.4,True,8,True,0,1,0,17612,203,58,7.2,False,28.18551666666667,-85,1,0,246,261,-15
BR1_2695478226,7,True,0,0,0,15662,176,48,6.8,False,8,False,0,0,1,18801,175,68,7.0,True,29.484116666666665,-3139,-1,0,224,243,-19
BR1_2688641650,2,True,0,0,0,14468,191,53,6.8,False,7,False,1,1,0,17518,189,55,7.2,True,27.702133333333332,-3050,-5,-1,244,244,0
BR1_2725809173,8,False,0,1,0,17262,196,36,6.6,True,10,True,0,0,0,16414,143,40,6.6,False,25.583383333333334,848,-2,0,232,183,49
BR1_2717011075,9,True,0,0,0,18032,222,51,6.6,True,5,False,0,0,0,15096,179,36,6.4,False,26.239016666666668,2936,4,0,273,215,58
BR1_2703552614,2,True,0,1,0,15069,178,68,6.8,True,3,False,1,0,0,14296,183,68,7.0,False,25.041133333333335,773,-1,-1,246,251,-5
BR1_2698173534,5,False,1,0,0,16620,219,56,7.2,False,12,True,0,0,0,18121,193,48,7.2,True,27.56855,-1501,-7,1,275,241,34
BR1_2709467433,6,True,1,1,0,17774,210,56,7.2,True,2,False,0,0,0,15304,203,60,7.2,False,28.582566666666665,2470,4,1,266,263,3
BR1_2708995975,11,True,0,0,0,19625,240,52,7.2,True,8,False,0,0,0,18699,229,51,7.6,False,28.159216666666666,926,3,0,292,280,12
BR1_2718315082,3,False,1,0,0,14487,172,36,7.0,False,13,True,0,1,0,21131,194,64,7.4,True,29.671166666666668,-6644,-10,1,208,258,-50
BR1_2717906174,8,True,1,0,0,17292,191,60,7.0,True,2,False,0,0,0,13549,186,48,6.4,False,27.081216666666666,3743,6,1,251,234,17
BR1_2731645218,4,False,0,0,0,13901,143,48,6.6,False,7,True,1,0,0,16111,186,48,7.0,True,25.652433333333335,-2210,-3,-1,191,234,-43
BR1_2727181321,5,True,1,0,0,15872,183,52,7.0,True,6,False,0,1,0,17125,191,32,7.0,False,28.6139,-1253,-1,1,235,223,12
BR1_2724146867,6,True,0,0,0,16622,203,44,7.2,False,6,False,1,1,0,16843,204,72,7.2,True,27.940883333333332,-221,0,-1,247,276,-29
BR1_2724127572,6,True,1,0,0,19233,271,52,7.4,False,6,False,0,1,0,17931,214,64,7.2,True,28.4951,1302,0,1,323,278,45
BR1_2731686579,9,True,1,1,1,19757,227,44,7.2,True,3,False,0,0,0,15692,179,76,7.0,False,29.05505,4065,6,1,271,255,16
BR1_2731572444,9,False,0,0,0,16472,153,44,6.2,False,7,True,1,1,0,17000,175,56,7.0,True,28.7334,-528,2,-1,197,231,-34
BR1_2715513348,10,False,1,0,0,19240,232,44,7.4,True,10,True,0,0,0,19161,238,67,7.8,False,29.720333333333333,79,0,1,276,305,-29
BR1_2717449127,10,False,1,0,0,18224,200,60,7.0,True,5,True,0,0,0,14515,149,48,6.8,False,25.856283333333334,3709,5,1,260,197,63
BR1_2729306893,6,False,0,0,0,15233,137,52,6.4,False,9,True,1,0,0,18120,213,44,7.0,True,28.8907,-2887,-3,-1,189,257,-68
BR1_2731697850,1,False,1,0,0,13405,174,56,6.8,False,8,True,0,1,0,17874,183,56,6.8,True,26.925066666666666,-4469,-7,1,230,239,-9
BR1_2731635489,9,True,0,1,0,16824,183,48,6.8,False,6,False,0,0,0,16574,190,32,6.6,True,25.6312,250,3,0,231,222,9
BR1_2730944522,9,True,1,0,0,17899,211,52,7.6,True,6,False,0,1,0,16594,167,59,7.0,False,29.501883333333332,1305,3,1,263,226,37
BR1_2703481944,5,True,0,1,0,17262,198,52,7.2,False,10,False,1,0,0,18283,167,64,7.4,True,28.2269,-1021,-5,-1,250,231,19
BR1_2696191841,7,False,0,1,0,16932,188,48,7.2,False,12,True,1,0,0,20764,235,68,7.4,True,29.5295,-3832,-5,-1,236,303,-67
BR1_2706884373,3,False,0,1,0,14826,197,56,7.2,True,5,True,1,0,0,16524,208,60,7.2,False,29.60025,-1698,-2,-1,253,268,-15
BR1_2730791307,5,True,1,0,0,15439,205,60,6.8,True,2,False,0,0,0,14061,169,52,6.6,False,25.631333333333334,1378,3,1,265,221,44
BR1_2730861805,7,False,0,0,0,17638,217,52,7.4,True,6,True,1,0,0,16729,198,52,6.8,False,28.66565,909,1,-1,269,250,19
BR1_2721037151,6,True,0,0,0,16334,175,56,7.2,False,13,False,1,1,0,21211,227,56,7.6,True,29.024433333333334,-4877,-7,-1,231,283,-52
BR1_2731571909,9,True,0,0,0,17598,207,52,7.2,True,7,False,0,0,0,17847,183,52,7.2,False,29.1559,-249,2,0,259,235,24
BR1_2731198624,10,False,0,1,0,19631,183,64,7.2,True,9,True,1,0,0,16333,143,56,6.8,False,27.561716666666666,3298,1,-1,247,199,48
BR1_2729933868,2,False,0,0,0,15155,231,40,7.2,False,7,True,0,0,0,18407,250,64,7.6,True,28.684116666666668,-3252,-5,0,271,314,-43
BR1_2731640790,11,False,0,1,0,18675,180,56,7.4,True,4,True,1,0,0,15319,176,68,7.0,False,28.03685,3356,7,-1,236,244,-8
BR1_2730146580,15,True,1,1,0,18742,162,44,6.6,True,4,False,0,0,0,12552,131,12,5.4,False,25.838783333333332,6190,11,1,206,143,63
BR1_2670822937,11,False,1,1,0,18980,205,84,8.2,True,3,True,0,0,0,15419,190,60,7.0,False,28.3029,3561,8,1,289,250,39
BR1_2670642266,13,True,1,0,0,18849,194,44,7.8,True,4,False,0,0,0,16489,191,60,7.6,False,28.400183333333334,2360,9,1,238,251,-13
BR1_2730066275,10,True,1,1,0,17706,158,64,7.4,True,6,False,0,0,0,18012,223,56,7.4,False,28.04545,-306,4,1,222,279,-57
BR1_2729868245,2,False,0,0,0,13939,175,50,6.4,True,6,True,1,0,0,15169,162,60,6.6,False,26.338933333333333,-1230,-4,-1,225,222,3
BR1_2707246502,10,True,1,0,0,18350,177,58,7.0,True,5,False,0,1,0,15772,204,38,6.6,False,28.903666666666666,2578,5,1,235,242,-7
BR1_2731112210,8,True,1,0,0,15388,156,48,7.0,True,0,False,0,0,0,13213,190,64,6.6,False,26.440733333333334,2175,8,1,204,254,-50
BR1_2730997956,2,True,1,0,0,16947,245,68,7.4,True,0,False,0,1,0,14742,211,44,7.4,False,29.8395,2205,2,1,313,255,58
BR1_2719627625,6,False,1,0,0,16085,192,52,7.0,True,3,True,0,0,0,13677,152,52,6.6,False,26.397483333333334,2408,3,1,244,204,40
BR1_2729066062,14,True,0,0,0,20571,205,56,7.2,True,7,False,1,1,0,18192,189,48,7.4,False,29.733166666666666,2379,7,-1,261,237,24
BR1_2730312326,4,True,1,0,0,15082,203,64,7.0,True,3,False,0,0,0,14448,192,40,6.4,False,26.09755,634,1,1,267,232,35
BR1_2729897030,7,True,1,0,0,15566,157,32,6.4,False,5,False,0,0,0,13619,140,52,6.6,True,26.140783333333335,1947,2,1,189,192,-3
BR1_2731247358,7,True,0,0,0,14864,130,32,5.6,False,7,False,1,0,0,17086,161,72,6.6,True,26.3633,-2222,0,-1,162,233,-71
BR1_2728379515,10,True,0,0,0,19549,209,48,7.6,False,3,False,1,1,0,16597,226,64,7.4,True,29.007233333333332,2952,7,-1,257,290,-33
BR1_2731692346,5,False,0,0,0,14230,161,40,6.4,False,8,True,1,1,0,17250,175,68,7.0,True,26.034233333333333,-3020,-3,-1,201,243,-42
BR1_2670010973,4,True,0,0,0,13699,192,40,6.6,True,3,False,1,0,0,13530,163,56,6.6,False,26.440483333333333,169,1,-1,232,219,13
BR1_2728503692,12,False,1,0,0,19237,163,60,7.0,True,9,True,0,0,0,18217,194,48,6.8,False,29.837883333333334,1020,3,1,223,242,-19
BR1_2731425707,4,False,0,0,0,15576,205,36,6.8,False,7,True,1,0,0,17274,202,52,7.2,True,29.97305,-1698,-3,-1,241,254,-13
BR1_2730472721,6,True,0,0,0,15029,153,48,6.4,False,7,False,1,1,0,16317,164,68,6.6,True,26.853883333333332,-1288,-1,-1,201,232,-31
BR1_2730495604,9,True,0,0,0,17676,196,72,7.2,True,7,False,1,0,0,16099,144,58,6.8,False,25.7552,1577,2,-1,268,202,66
BR1_2731615101,6,True,0,0,0,17406,211,64,7.2,True,6,False,1,0,0,16482,174,64,7.0,False,28.858133333333335,924,0,-1,275,238,37
BR1_2731594304,10,False,0,1,0,17959,184,56,7.0,True,5,True,1,0,0,16532,180,56,6.8,False,27.644233333333332,1427,5,-1,240,236,4
BR1_2724709810,7,False,0,1,0,17992,215,48,7.0,True,4,True,1,0,0,16820,244,56,7.0,False,27.82975,1172,3,-1,263,300,-37
BR1_2719380892,8,False,0,0,0,18584,215,56,7.4,True,5,True,1,0,0,16553,206,72,7.4,False,29.451083333333333,2031,3,-1,271,278,-7
BR1_2702185832,9,True,1,0,0,17160,185,56,7.0,True,3,False,0,0,0,13841,153,44,6.6,False,26.165633333333332,3319,6,1,241,197,44
BR1_2717677169,12,False,1,0,0,19598,192,52,7.0,False,11,True,0,1,0,18738,183,44,6.6,True,27.525983333333333,860,1,1,244,227,17
BR1_2689085857,6,False,0,1,0,15928,171,60,6.8,True,2,True,1,0,0,13721,180,57,6.8,False,26.255116666666666,2207,4,-1,231,237,-6
BR1_2685132291,2,False,0,1,0,14728,182,52,7.2,False,5,True,1,0,0,17498,228,68,7.8,True,28.3349,-2770,-3,-1,234,296,-62
BR1_2725568723,9,False,0,0,0,17946,192,56,7.0,True,9,True,1,0,0,19427,198,64,7.0,False,29.663983333333334,-1481,0,-1,248,262,-14
BR1_2724522834,7,False,0,0,0,16805,203,60,7.2,False,6,True,0,1,0,17458,220,48,7.4,True,27.64435,-653,1,0,263,268,-5
BR1_2698891156,7,True,1,0,0,15110,143,43,6.2,True,10,False,0,0,0,17408,161,40,6.6,False,25.107283333333335,-2298,-3,1,186,201,-15
BR1_2730701561,10,True,1,1,0,17812,145,60,6.8,True,7,False,0,0,0,17027,173,44,6.6,False,28.1889,785,3,1,205,217,-12
BR1_2708428244,4,True,0,0,1,15630,180,36,6.8,True,5,False,0,0,0,14390,144,32,6.2,False,26.08705,1240,-1,0,216,176,40
BR1_2707682007,2,False,0,1,0,13285,150,48,6.4,False,13,True,1,0,0,17758,176,40,7.0,True,25.020116666666667,-4473,-11,-1,198,216,-18
BR1_2705361123,5,False,0,0,0,14377,148,44,6.2,False,7,True,0,0,0,15284,169,52,6.6,True,26.740666666666666,-907,-2,0,192,221,-29
BR1_2722678092,11,True,1,1,0,17382,148,52,6.4,False,19,False,0,0,0,19811,162,40,6.6,True,25.020166666666668,-2429,-8,1,200,202,-2
BR1_2722019100,9,True,0,1,0,19903,225,66,7.2,True,2,False,1,0,0,13998,158,52,7.0,False,29.44365,5905,7,-1,291,210,81
BR1_2724151481,5,True,0,1,0,16127,162,56,6.8,True,2,False,0,0,0,15215,199,36,6.8,False,28.3944,912,3,0,218,235,-17
BR1_2723317402,8,True,1,0,0,14496,113,48,6.2,False,3,False,0,1,0,14519,201,32,6.6,True,27.464866666666666,-23,5,1,161,233,-72
BR1_2731445769,2,False,0,0,0,13779,171,48,6.6,False,12,True,1,1,0,19341,212,42,7.6,True,27.726783333333334,-5562,-10,-1,219,254,-35
BR1_2718135450,7,False,1,0,0,15988,163,52,6.4,False,6,True,0,1,0,16467,198,52,6.8,True,26.459516666666666,-479,1,1,215,250,-35
BR1_2723791060,7,False,1,0,0,16455,175,44,6.6,True,8,True,0,1,0,15102,112,60,5.6,False,26.631916666666665,1353,-1,1,219,172,47
BR1_2684890899,8,False,0,0,0,17036,172,40,7.2,False,11,True,1,0,0,17688,200,48,7.0,True,26.24053333333333,-652,-3,-1,212,248,-36
BR1_2674155788,10,False,0,0,0,17475,196,36,7.0,True,6,True,1,0,0,14922,166,48,6.8,False,26.635933333333334,2553,4,-1,232,214,18
BR1_2730191010,1,False,0,0,0,13089,203,32,6.4,False,5,True,0,1,0,15801,198,52,6.8,True,25.16705,-2712,-4,0,235,250,-15
BR1_2676863709,3,True,0,0,0,15839,201,52,7.0,False,8,False,1,1,0,18514,198,55,7.4,True,28.510633333333335,-2675,-5,-1,253,253,0
BR1_2731345853,7,False,1,1,0,17545,190,52,6.8,True,6,True,0,0,0,15205,176,38,6.4,False,25.617366666666666,2340,1,1,242,214,28
BR1_2728500446,5,False,0,0,0,16001,204,56,7.4,False,9,True,1,0,0,17928,208,44,7.2,True,29.544116666666667,-1927,-4,-1,260,252,8
BR1_2728470741,6,True,1,1,1,18142,234,44,7.2,True,8,False,0,0,0,16445,158,60,6.8,False,29.114533333333334,1697,-2,1,278,218,60
BR1_2682889484,2,True,1,0,0,13149,192,24,6.6,False,3,False,0,1,0,15359,238,64,7.0,True,25.582716666666666,-2210,-1,1,216,302,-86
BR1_2679580470,12,True,1,0,0,18976,202,52,7.6,False,9,False,0,1,0,18945,225,52,7.4,True,28.2902,31,3,1,254,277,-23
BR1_2716329389,4,False,1,0,0,15104,223,48,7.0,True,3,True,0,0,0,14407,196,50,6.6,False,26.693033333333332,697,1,1,271,246,25
BR1_2716272688,5,True,0,0,0,15417,187,56,6.8,False,6,False,1,0,0,15882,198,51,6.6,True,26.67145,-465,-1,-1,243,249,-6
BR1_2704261423,3,False,0,0,0,16176,267,52,7.4,False,7,True,0,1,0,18584,225,56,7.2,True,29.467483333333334,-2408,-4,0,319,281,38
BR1_2730625496,6,True,1,0,0,16792,214,56,6.8,False,2,False,0,1,0,15402,190,52,7.2,True,29.27253333333333,1390,4,1,270,242,28
BR1_2729784804,2,False,0,0,0,13559,150,51,6.4,False,6,True,1,0,0,15837,176,62,6.8,True,25.64591666666667,-2278,-4,-1,201,238,-37
BR1_2681109134,7,True,0,0,0,15489,121,36,6.6,False,9,False,1,1,0,16614,156,68,6.6,True,26.5914,-1125,-2,-1,157,224,-67
BR1_2729976607,4,True,0,0,0,14714,177,47,6.4,True,10,False,0,0,0,17218,171,48,6.8,False,27.468666666666667,-2504,-6,0,224,219,5
BR1_2729451958,6,True,0,0,0,17388,206,40,7.0,True,6,False,1,1,0,16928,190,60,7.4,False,29.175483333333332,460,0,-1,246,250,-4
BR1_2731460968,6,True,1,0,0,16520,178,60,7.0,False,9,False,0,1,0,19195,212,68,7.6,True,28.6034,-2675,-3,1,238,280,-42
BR1_2703375882,8,True,1,0,0,17020,194,48,6.6,True,7,False,0,0,0,15045,150,52,6.4,False,25.059833333333334,1975,1,1,242,202,40
BR1_2703361835,4,False,0,1,0,14026,168,40,6.4,False,6,True,1,0,0,15579,202,44,6.8,True,25.1817,-1553,-2,-1,208,246,-38
BR1_2724613139,8,True,1,0,0,16346,193,36,6.8,False,12,False,0,0,0,20216,192,56,7.2,True,28.726733333333332,-3870,-4,1,229,248,-19
BR1_2729191419,8,False,0,0,0,16189,170,52,6.6,False,9,True,1,1,0,16202,141,44,6.4,True,26.336816666666667,-13,-1,-1,222,185,37
BR1_2729185684,8,True,1,0,0,15523,175,43,6.4,True,7,False,0,0,0,14256,130,39,6.4,False,26.106833333333334,1267,1,1,218,169,49
BR1_2729889725,12,True,1,1,1,20651,205,68,7.4,True,9,False,0,0,0,17301,169,55,6.8,False,28.342416666666665,3350,3,1,273,224,49
BR1_2720370344,4,False,1,0,0,13717,161,48,6.2,False,10,True,0,1,0,17142,178,52,7.0,True,26.5885,-3425,-6,1,209,230,-21
BR1_2681907487,6,True,1,0,0,16158,173,60,7.2,False,6,False,0,1,0,17891,214,72,7.4,True,28.9328,-1733,0,1,233,286,-53
BR1_2681881566,11,True,1,1,0,18823,177,72,7.2,True,2,False,0,0,0,13071,163,46,6.2,False,27.064266666666665,5752,9,1,249,209,40
BR1_2714907021,3,False,0,0,0,16051,228,68,7.4,True,4,True,1,1,0,16132,205,64,7.2,False,28.9452,-81,-1,-1,296,269,27
BR1_2729480054,3,False,0,1,0,14616,208,48,6.8,False,5,True,1,0,0,16976,237,60,7.0,True,26.663183333333333,-2360,-2,-1,256,297,-41
BR1_2719439548,10,False,1,0,0,18583,166,56,6.8,True,13,True,0,0,0,19160,205,52,7.2,False,28.965466666666668,-577,-3,1,222,257,-35
BR1_2719407217,11,True,0,0,0,17630,210,38,7.0,False,9,False,0,0,0,17282,157,57,6.8,True,25.86018333333333,348,2,0,248,214,34
BR1_2696666596,7,False,1,0,0,17122,185,60,7.2,False,6,True,0,0,0,16117,190,40,7.2,True,29.66358333333333,1005,1,1,245,230,15
BR1_2729121701,11,False,1,0,0,20187,239,64,7.6,True,6,True,0,0,0,16750,194,62,7.4,False,29.560066666666668,3437,5,1,303,256,47
BR1_2731497417,2,True,0,1,0,14394,188,52,6.8,True,5,False,1,0,0,15307,170,48,6.8,False,27.193016666666665,-913,-3,-1,240,218,22
BR1_2684700304,4,False,1,0,0,16446,189,64,7.0,False,7,True,0,0,0,17152,205,32,7.4,True,29.84355,-706,-3,1,253,237,16
BR1_2730169906,6,True,0,0,0,15818,190,48,6.6,False,7,False,1,1,0,15749,169,52,7.0,True,27.3013,69,-1,-1,238,221,17
BR1_2729334147,7,True,1,0,0,16980,192,49,7.4,False,10,False,0,0,0,18101,185,51,7.2,True,29.20235,-1121,-3,1,241,236,5
BR1_2726186433,6,False,0,0,0,15058,150,48,6.4,True,4,True,0,0,0,14421,175,52,6.6,False,26.52705,637,2,0,198,227,-29
BR1_2712891392,6,True,1,1,0,15168,184,64,6.8,True,2,False,0,0,0,14039,169,50,6.4,False,27.228766666666665,1129,4,1,248,219,29
BR1_2731669365,5,False,0,0,0,14965,182,44,6.8,False,8,True,1,1,0,16661,188,76,7.4,True,27.1372,-1696,-3,-1,226,264,-38
BR1_2730765958,7,True,0,0,0,16643,197,52,6.6,True,6,False,0,0,0,14674,156,32,6.6,False,26.647216666666665,1969,1,0,249,188,61
BR1_2730746118,3,False,0,1,0,14567,178,61,6.6,True,3,True,1,0,0,13951,200,44,6.8,False,26.3033,616,0,-1,239,244,-5
BR1_2729910116,6,True,1,0,0,16960,178,68,7.0,False,6,False,0,1,0,17730,235,64,7.4,True,27.81275,-770,0,1,246,299,-53
BR1_2707413519,4,True,0,1,0,16141,207,64,7.2,False,6,False,1,0,0,17497,249,60,7.8,True,28.877633333333332,-1356,-2,-1,271,309,-38
BR1_2728810603,8,True,0,0,0,17982,194,64,7.2,True,3,False,1,0,0,15319,221,56,7.2,False,29.037366666666667,2663,5,-1,258,277,-19
BR1_2728703267,4,False,0,0,0,15082,199,48,6.6,False,8,True,1,1,0,17488,218,66,6.8,True,25.627583333333334,-2406,-4,-1,247,284,-37
BR1_2731003743,4,False,0,0,0,16190,231,52,7.2,False,10,True,1,1,0,20032,261,56,7.6,True,27.775466666666667,-3842,-6,-1,283,317,-34
BR1_2695857285,5,True,0,1,0,15142,168,48,6.4,False,12,False,1,0,0,18966,188,60,7.0,True,27.2549,-3824,-7,-1,216,248,-32
BR1_2695844252,3,True,1,0,0,16683,238,67,7.6,True,3,False,0,0,0,14837,169,44,7.0,False,29.61385,1846,0,1,305,213,92
BR1_2694720680,9,True,1,1,0,17879,164,60,7.4,True,5,False,0,0,0,17145,235,60,7.2,False,28.351333333333333,734,4,1,224,295,-71
BR1_2726935412,11,True,1,0,0,17403,163,64,7.4,False,2,False,0,1,0,16273,248,76,7.4,True,29.56811666666667,1130,9,1,227,324,-97
BR1_2716488828,6,True,0,1,0,16599,210,48,6.6,True,3,False,1,0,0,13595,186,52,6.4,False,26.625766666666667,3004,3,-1,258,238,20
BR1_2715049498,10,True,1,0,0,19249,220,60,7.6,True,6,False,0,1,0,16841,211,52,7.2,False,29.423416666666668,2408,4,1,280,263,17
BR1_2690804447,6,True,1,0,0,15106,175,52,6.6,True,6,False,0,0,0,14901,188,35,6.6,False,25.900433333333332,205,0,1,227,223,4
BR1_2730685980,2,False,0,0,0,12914,128,44,6.6,False,6,True,0,1,1,18175,238,52,7.0,True,25.898583333333335,-5261,-4,0,172,290,-118
BR1_2731192303,7,True,1,0,0,15605,187,44,6.6,True,9,False,0,1,0,16271,187,56,7.0,False,26.871033333333333,-666,-2,1,231,243,-12
BR1_2665961825,9,True,0,1,0,18985,232,50,7.6,True,6,False,0,0,0,16316,187,56,7.4,False,28.93335,2669,3,0,282,243,39
BR1_2665940799,5,True,0,0,0,16887,174,56,6.6,False,8,False,0,0,0,18245,211,62,7.2,True,29.391666666666666,-1358,-3,0,230,273,-43
BR1_2674153250,4,True,1,1,0,17149,218,58,7.2,True,6,False,0,0,0,15337,135,56,7.0,False,29.425683333333332,1812,-2,1,276,191,85
BR1_2674117085,8,True,0,0,0,17252,201,56,7.2,True,2,False,1,0,0,15791,205,72,7.2,False,29.5604,1461,6,-1,257,277,-20
BR1_2723195742,3,False,0,0,0,15726,235,51,7.4,True,4,True,1,1,0,16480,231,72,7.2,False,29.157583333333335,-754,-1,-1,286,303,-17
BR1_2722742295,7,True,1,0,0,17592,212,67,7.6,True,5,False,0,1,0,16636,201,52,7.4,False,28.593166666666665,956,2,1,279,253,26
BR1_2703047542,4,True,1,0,0,15695,190,52,6.6,True,6,False,0,0,0,14678,135,44,6.2,False,26.07133333333333,1017,-2,1,242,179,63
BR1_2699230635,3,False,1,0,0,14467,186,52,6.6,True,5,True,0,0,0,14350,183,36,6.6,False,26.682116666666666,117,-2,1,238,219,19
BR1_2731218437,6,True,1,0,0,17288,238,52,7.2,True,10,False,0,1,0,18319,202,60,7.6,False,29.31811666666667,-1031,-4,1,290,262,28
BR1_2730714069,2,True,0,0,0,14483,227,40,6.4,False,2,False,0,0,0,13421,202,40,7.0,True,26.496783333333333,1062,0,0,267,242,25
BR1_2730687634,6,False,0,0,0,14858,168,44,6.6,False,8,True,1,0,0,15950,169,36,6.8,True,25.18965,-1092,-2,-1,212,205,7
BR1_2731352543,6,False,0,0,0,15659,180,41,6.4,False,13,True,1,0,0,17905,176,50,6.6,True,27.43555,-2246,-7,-1,221,226,-5
BR1_2728492746,5,True,0,0,0,15994,191,64,6.8,False,4,False,1,0,0,14921,203,56,7.2,True,27.068083333333334,1073,1,-1,255,259,-4
BR1_2727034691,6,True,0,0,0,16623,216,52,7.0,True,7,False,1,1,0,17212,176,56,7.0,False,28.197983333333333,-589,-1,-1,268,232,36
BR1_2730949684,6,False,0,0,0,15406,141,58,6.6,False,10,True,1,0,0,18949,229,47,7.2,True,27.611366666666665,-3543,-4,-1,199,276,-77
BR1_2731566098,6,False,0,0,0,16328,174,44,7.2,True,3,True,0,1,0,14886,162,60,7.4,False,28.06811666666667,1442,3,0,218,222,-4
BR1_2731694185,8,True,0,0,0,15042,146,36,6.2,False,9,False,1,1,0,16391,173,48,6.8,True,26.114583333333332,-1349,-1,-1,182,221,-39
BR1_2730804106,9,True,1,0,1,18301,189,68,6.8,True,6,False,0,0,0,15657,148,63,6.6,False,25.49745,2644,3,1,257,211,46
BR1_2730779438,9,False,1,0,0,15816,167,40,6.4,True,5,True,0,0,0,15215,210,52,6.6,False,27.26425,601,4,1,207,262,-55
BR1_2730759150,3,False,0,0,0,13980,185,44,6.6,False,5,True,1,0,0,14892,160,60,6.6,True,26.247433333333333,-912,-2,-1,229,220,9
BR1_2707081291,5,True,1,0,0,16665,201,52,7.0,True,3,False,0,0,0,14223,184,52,6.4,False,25.798616666666668,2442,2,1,253,236,17
BR1_2727465799,5,True,0,0,0,16939,233,44,7.2,False,3,False,1,1,0,15727,199,72,7.2,True,29.618233333333333,1212,2,-1,277,271,6
BR1_2708084134,6,True,1,0,0,16659,212,60,7.2,True,7,False,0,0,0,15164,150,32,5.6,False,25.191366666666667,1495,-1,1,272,182,90
BR1_2730905302,9,False,0,0,0,16367,152,40,6.4,True,12,True,1,0,0,17361,163,60,7.0,False,26.2693,-994,-3,-1,192,223,-31
BR1_2674302496,10,True,1,0,0,19074,220,52,7.6,True,8,False,0,0,0,17226,190,44,7.0,False,27.869116666666667,1848,2,1,272,234,38
BR1_2700377182,9,True,1,0,0,16375,139,59,6.8,True,4,False,0,0,0,13410,146,44,6.4,False,26.10396666666667,2965,5,1,198,190,8
BR1_2714546711,7,False,1,0,0,16424,189,52,7.2,True,8,True,0,0,0,17646,171,52,7.0,False,29.09135,-1222,-1,1,241,223,18
BR1_2731617388,10,False,0,0,0,18816,245,56,7.6,True,5,True,1,1,0,16493,207,46,7.2,False,28.48656666666667,2323,5,-1,301,253,48
BR1_2724677308,6,True,1,0,0,16557,188,48,7.2,True,7,False,0,0,0,16184,146,48,7.0,False,29.674866666666667,373,-1,1,236,194,42
BR1_2730363521,7,True,1,0,0,17246,201,60,7.2,True,6,False,0,1,0,15940,198,47,7.0,False,28.96255,1306,1,1,261,245,16
BR1_2730229143,9,True,0,0,0,16787,197,35,7.0,False,3,False,0,0,0,14491,193,52,6.6,True,27.1104,2296,6,0,232,245,-13
BR1_2730196373,5,False,1,0,0,15510,166,52,7.0,False,9,True,0,0,0,17209,201,40,7.0,True,27.946166666666667,-1699,-4,1,218,241,-23
BR1_2683142865,5,True,0,1,0,16414,202,68,7.6,False,11,False,1,0,0,18059,183,60,7.8,True,27.6006,-1645,-6,-1,270,243,27
BR1_2729440642,5,False,0,0,0,14004,163,47,6.6,False,7,True,0,0,0,15924,176,40,6.6,True,26.646966666666668,-1920,-2,0,210,216,-6
BR1_2675915147,8,True,1,0,0,18103,225,54,7.8,True,3,False,0,0,0,15704,206,52,7.6,False,29.024516666666667,2399,5,1,279,258,21
BR1_2675716964,6,False,1,1,0,17617,199,72,7.6,True,8,True,0,0,0,17740,189,48,7.6,False,28.5926,-123,-2,1,271,237,34
BR1_2675712078,7,True,1,1,0,15838,179,44,6.6,True,7,False,0,0,0,14651,162,40,6.6,False,26.9811,1187,0,1,223,202,21
BR1_2729994413,8,False,1,0,0,16059,188,52,6.6,True,7,True,0,0,0,14828,156,36,6.8,False,26.052633333333333,1231,1,1,240,192,48
BR1_2728067638,3,False,0,0,0,15184,188,55,7.4,True,5,True,0,0,0,16549,242,32,7.0,False,28.329766666666668,-1365,-2,0,243,274,-31
BR1_2731737389,3,False,0,0,0,13163,125,44,6.4,False,6,True,1,0,0,15748,185,48,6.8,True,27.377083333333335,-2585,-3,-1,169,233,-64
BR1_2729544743,6,False,1,0,0,15733,181,60,6.8,True,5,True,0,0,0,14944,176,52,6.8,False,26.461783333333333,789,1,1,241,228,13
BR1_2681947463,7,False,0,0,0,15919,157,51,6.6,False,12,True,1,0,0,18653,185,68,7.4,True,27.437266666666666,-2734,-5,-1,208,253,-45
BR1_2681926750,11,False,0,0,0,20166,210,48,7.8,False,16,True,1,0,0,21510,199,64,7.6,True,29.62623333333333,-1344,-5,-1,258,263,-5
BR1_2722292220,3,True,0,0,0,14476,187,44,6.8,False,2,False,0,1,0,14929,204,64,7.0,True,25.137516666666667,-453,1,0,231,268,-37
BR1_2726507913,9,False,1,0,0,16778,182,43,7.0,True,5,True,0,0,0,14818,174,37,6.4,False,26.848133333333333,1960,4,1,225,211,14
BR1_2722788150,5,True,0,0,0,17919,232,48,7.4,True,4,False,1,1,0,15327,196,52,7.2,False,28.674266666666668,2592,1,-1,280,248,32
BR1_2723779115,7,True,1,0,0,17193,215,44,6.8,True,10,False,0,0,0,16944,201,23,6.6,False,26.04,249,-3,1,259,224,35
BR1_2726242824,7,True,1,0,1,18805,201,52,7.2,True,5,False,0,1,0,17839,205,59,7.2,False,28.794616666666666,966,2,1,253,264,-11
BR1_2726188402,2,False,1,1,0,15213,205,68,7.0,False,6,True,0,0,0,16856,218,44,6.8,True,27.047233333333335,-1643,-4,1,273,262,11
BR1_2705084098,6,False,1,0,0,17096,188,48,7.0,True,11,True,0,0,0,18802,181,56,7.0,False,28.289366666666666,-1706,-5,1,236,237,-1
BR1_2731154954,6,True,0,0,0,15780,165,48,6.8,False,6,False,1,1,0,18155,226,63,7.0,True,29.60055,-2375,0,-1,213,289,-76
BR1_2689375557,5,True,0,0,0,17087,226,52,7.4,False,6,False,0,1,0,17110,214,72,7.6,True,28.0308,-23,-1,0,278,286,-8
BR1_2730773280,1,True,0,0,0,13399,195,36,6.6,False,4,False,0,1,0,15611,230,56,6.8,True,27.21575,-2212,-3,0,231,286,-55
BR1_2731546048,4,True,0,1,0,15557,206,55,7.2,True,3,False,1,0,0,14005,172,47,6.8,False,25.834666666666667,1552,1,-1,261,219,42
BR1_2724815806,13,True,1,0,0,20539,238,48,7.6,True,5,False,0,0,0,15586,173,52,7.0,False,28.396166666666666,4953,8,1,286,225,61
BR1_2716859420,4,False,1,1,0,15242,186,60,7.0,True,5,True,0,0,0,14907,185,20,6.6,False,26.54885,335,-1,1,246,205,41
BR1_2730231472,6,False,1,1,0,18329,240,80,7.6,True,3,True,0,0,0,16231,244,56,7.2,False,28.951066666666666,2098,3,1,320,300,20
BR1_2730749805,7,False,0,0,0,15374,150,48,6.4,False,16,True,1,0,0,19225,158,44,6.8,True,25.96463333333333,-3851,-9,-1,198,202,-4
BR1_2729155742,11,True,0,1,1,21287,189,44,7.0,False,12,False,1,0,0,18911,201,52,6.8,True,27.576766666666668,2376,-1,-1,233,253,-20
BR1_2727983232,7,False,1,0,0,16325,171,40,6.6,False,10,True,0,0,0,19106,201,52,7.0,True,28.525,-2781,-3,1,211,253,-42
BR1_2723114106,8,False,0,0,0,15437,143,21,6.6,False,8,True,0,0,0,15420,180,35,6.4,True,26.926666666666666,17,0,0,164,215,-51
BR1_2730049778,2,False,0,0,0,14001,190,40,6.8,False,7,True,1,1,0,16210,173,72,7.0,True,26.859716666666667,-2209,-5,-1,230,245,-15
BR1_2729684328,4,False,0,0,0,14251,163,44,6.6,False,5,True,0,1,0,15001,182,52,6.6,True,26.345133333333333,-750,-1,0,207,234,-27
BR1_2726414758,1,False,0,0,0,13323,178,44,6.2,False,6,True,1,0,0,15730,194,52,6.8,True,25.4832,-2407,-5,-1,222,246,-24
BR1_2726525835,5,False,0,0,0,15652,170,51,6.4,False,5,True,1,0,0,15766,192,48,6.4,True,26.106383333333333,-114,0,-1,221,240,-19
BR1_2730417955,8,False,1,0,0,15949,185,40,6.6,False,6,True,0,0,0,16399,184,64,6.6,True,27.435383333333334,-450,2,1,225,248,-23
BR1_2693817929,6,True,0,0,1,16355,201,52,7.2,True,7,False,0,1,0,18658,202,52,7.6,False,29.17655,-2303,-1,0,253,254,-1
BR1_2693381270,7,False,1,0,0,16136,158,52,6.4,True,12,True,0,0,0,18628,202,40,6.6,False,27.053316666666667,-2492,-5,1,210,242,-32
BR1_2721990548,7,True,1,0,0,15808,169,44,6.8,False,7,False,0,0,0,15854,154,44,6.6,True,25.5614,-46,0,1,213,198,15
BR1_2672159485,4,False,1,1,0,15517,197,48,7.4,True,1,True,0,0,0,13899,233,56,6.8,False,26.97855,1618,3,1,245,289,-44
BR1_2700697680,5,True,0,0,0,14513,162,52,6.2,False,4,False,0,0,0,15122,197,56,6.6,True,27.013833333333334,-609,1,0,214,253,-39
BR1_2698310308,7,True,0,0,0,17725,212,47,7.2,False,7,False,1,0,0,16822,173,56,7.0,True,28.6227,903,0,-1,259,229,30
BR1_2716765125,12,True,1,1,0,20290,180,68,7.4,True,4,False,0,0,0,14821,187,47,6.8,False,27.68188333333333,5469,8,1,248,234,14
BR1_2731334705,3,False,0,0,0,13484,146,40,6.0,False,7,True,1,1,0,16144,158,64,6.6,True,26.398416666666666,-2660,-4,-1,186,222,-36
BR1_2699376230,4,True,0,1,0,15790,166,48,7.0,False,4,False,1,0,0,16559,241,63,7.2,True,28.71463333333333,-769,0,-1,214,304,-90
BR1_2718393862,7,True,0,1,0,17569,195,64,7.2,False,3,False,0,0,0,15384,202,48,6.8,True,29.2208,2185,4,0,259,250,9
BR1_2717781481,6,True,1,0,0,17782,237,68,7.6,True,3,False,0,0,0,15465,198,44,7.4,False,28.721683333333335,2317,3,1,305,242,63
BR1_2702565607,0,False,0,1,0,13596,176,61,6.6,False,8,True,1,0,0,15577,182,40,6.8,True,26.5938,-1981,-8,-1,237,222,15
BR1_2730822983,9,True,0,1,0,17466,192,52,7.0,True,3,False,0,0,0,14184,181,44,7.0,False,26.997016666666667,3282,6,0,244,225,19
BR1_2731354339,8,False,0,0,0,17153,193,40,6.8,False,8,True,1,0,0,18667,242,52,7.4,True,28.95375,-1514,0,-1,233,294,-61
BR1_2718671568,6,False,0,0,0,14327,145,52,6.4,False,8,True,0,0,0,16460,155,44,6.8,True,25.544783333333335,-2133,-2,0,197,199,-2
BR1_2723724347,15,True,1,0,0,19861,203,68,7.0,True,8,False,0,1,0,17288,141,56,6.6,False,28.124783333333333,2573,7,1,271,197,74
BR1_2722693536,9,False,1,0,0,18172,201,68,6.8,True,8,True,0,1,0,17690,208,44,7.0,False,29.773366666666668,482,1,1,269,252,17
BR1_2728533504,12,True,1,1,0,20085,183,56,7.2,True,4,False,0,0,0,14753,173,48,6.6,False,27.461966666666665,5332,8,1,239,221,18
BR1_2692976679,9,True,1,1,0,18229,184,60,6.8,True,6,False,0,0,0,17062,168,60,6.8,False,29.03875,1167,3,1,244,228,16
BR1_2730705689,9,False,0,0,0,15447,122,32,6.0,False,14,True,1,0,0,18431,140,44,6.4,True,26.86875,-2984,-5,-1,154,184,-30
BR1_2730328722,6,True,1,0,0,17385,224,60,7.4,False,7,False,0,0,0,16596,192,52,7.2,True,27.7204,789,-1,1,284,244,40
BR1_2730673692,10,False,0,1,0,18327,195,52,7.0,True,4,True,0,0,0,15070,200,52,6.4,False,25.657183333333332,3257,6,0,247,252,-5
BR1_2730648415,9,True,0,0,0,17642,219,52,7.0,True,4,False,0,0,0,14831,185,44,6.4,False,25.65545,2811,5,0,271,229,42
BR1_2723999111,6,False,1,0,0,15331,187,46,7.0,False,6,True,0,0,0,17824,216,78,7.4,True,28.9247,-2493,0,1,233,294,-61
BR1_2706978094,9,False,0,0,0,17072,175,47,6.8,True,9,True,0,0,0,17476,188,36,6.6,False,28.935716666666668,-404,0,0,222,224,-2
BR1_2706858203,12,False,1,0,0,18782,174,53,7.0,True,9,True,0,0,0,18151,187,46,6.6,False,29.0838,631,3,1,227,233,-6
BR1_2706821618,5,True,1,0,0,15609,191,60,7.0,False,11,False,0,0,0,18920,185,60,7.2,True,26.689783333333335,-3311,-6,1,251,245,6
BR1_2731558850,5,True,1,1,0,15512,170,56,7.0,True,6,False,0,0,0,14370,146,52,6.8,False,27.37465,1142,-1,1,226,198,28
BR1_2730320704,11,True,1,0,0,18684,206,70,7.6,False,4,False,0,1,0,16389,205,54,7.4,True,28.276133333333334,2295,7,1,276,259,17
BR1_2708400514,3,False,1,0,0,14210,157,60,6.6,True,9,True,0,0,0,16868,194,40,6.8,False,26.602666666666668,-2658,-6,1,217,234,-17
BR1_2708375832,4,False,1,0,0,14087,167,48,6.6,False,11,True,0,1,0,18446,165,52,7.0,True,26.39495,-4359,-7,1,215,217,-2
BR1_2704925701,11,True,0,1,0,19299,196,50,7.2,True,3,False,1,0,0,14801,196,51,7.0,False,27.527783333333332,4498,8,-1,246,247,-1
BR1_2693826841,6,False,0,0,0,15658,182,37,6.8,False,9,True,1,0,0,18431,210,66,7.2,True,29.454733333333333,-2773,-3,-1,219,276,-57
BR1_2729600024,7,True,1,0,0,17759,229,76,7.6,True,8,False,0,1,0,17821,228,56,7.6,False,29.1788,-62,-1,1,305,284,21
BR1_2676288862,8,True,0,0,0,16592,205,48,7.4,False,7,False,1,0,0,17032,177,50,8.0,True,28.87975,-440,1,-1,253,227,26
BR1_2699534041,16,False,1,1,0,19661,171,72,7.6,True,12,True,0,0,0,19958,176,40,7.0,False,27.9411,-297,4,1,243,216,27
BR1_2729319962,12,True,0,0,0,18482,189,56,7.0,True,5,False,1,0,0,14903,164,60,6.6,False,27.467033333333333,3579,7,-1,245,224,21
BR1_2731608752,6,True,0,0,0,15850,187,40,7.0,False,4,False,0,0,0,16174,215,50,7.0,True,28.89275,-324,2,0,227,265,-38
BR1_2724583998,7,True,1,0,0,17454,200,64,7.4,False,1,False,0,1,0,15572,237,60,7.2,True,29.26021666666667,1882,6,1,264,297,-33
BR1_2731329608,7,False,0,0,0,15192,133,47,6.2,False,9,True,1,0,0,16806,157,48,6.6,True,26.582166666666666,-1614,-2,-1,180,205,-25
BR1_2708201611,3,False,0,0,0,15686,174,64,6.8,False,9,True,1,1,0,19975,241,63,7.4,True,28.14218333333333,-4289,-6,-1,238,304,-66
BR1_2707950107,15,False,0,1,1,21289,169,49,7.0,False,12,True,0,0,0,19985,198,57,6.8,True,28.746466666666667,1304,3,0,218,255,-37
BR1_2671375823,9,True,0,0,0,18310,185,56,7.0,True,5,False,0,1,0,13592,154,40,6.6,False,25.511066666666668,4718,4,0,241,194,47
BR1_2671361355,12,True,1,1,0,18561,171,46,6.6,True,4,False,0,0,0,13959,177,48,6.6,False,25.699266666666666,4602,8,1,217,225,-8
BR1_2671335267,4,True,1,0,0,14942,170,56,6.8,True,10,False,0,0,0,17311,160,46,6.8,False,29.110116666666666,-2369,-6,1,226,206,20
BR1_2731240827,10,True,1,0,0,18490,226,47,7.4,True,6,False,0,0,0,16410,208,56,7.2,False,29.140983333333335,2080,4,1,273,264,9
BR1_2727596872,3,False,0,0,0,13930,179,40,6.6,False,7,True,1,0,0,15844,178,58,6.8,True,25.482966666666666,-1914,-4,-1,219,236,-17
BR1_2729778565,9,True,0,0,0,17084,189,56,7.0,True,3,False,0,0,0,13516,157,44,6.4,False,26.596566666666668,3568,6,0,245,201,44
BR1_2728503866,9,True,1,1,0,17592,205,54,7.0,True,5,False,0,0,0,15442,186,49,6.8,False,28.66765,2150,4,1,259,235,24
BR1_2729818729,2,False,0,0,0,12602,168,46,6.6,False,9,True,1,0,0,17096,212,38,6.8,True,27.190616666666667,-4494,-7,-1,214,250,-36
BR1_2731618840,7,True,0,1,0,16723,177,66,7.0,False,8,False,1,0,0,18796,209,54,7.2,True,28.98368333333333,-2073,-1,-1,243,263,-20
BR1_2731594000,7,True,0,0,0,17190,197,44,6.6,False,10,False,1,1,0,18643,200,64,7.0,True,28.05915,-1453,-3,-1,241,264,-23
BR1_2702363690,9,True,0,0,1,17083,178,43,6.6,False,17,False,1,1,0,23011,198,64,7.2,True,28.361083333333333,-5928,-8,-1,221,262,-41
BR1_2694683657,9,False,0,1,0,17520,164,36,6.8,False,13,True,0,0,0,19238,194,48,7.8,True,29.740716666666668,-1718,-4,0,200,242,-42
BR1_2694664623,6,False,0,0,0,14229,153,48,5.8,False,8,True,1,0,1,17231,167,44,6.8,True,27.016866666666665,-3002,-2,-1,201,211,-10
BR1_2729680282,10,True,0,0,1,20267,213,52,7.2,True,9,False,1,0,0,18339,193,60,7.2,False,27.74135,1928,1,-1,265,253,12
BR1_2725072202,8,True,1,0,0,16549,188,55,6.8,True,7,False,0,0,0,15516,182,44,6.6,False,25.67735,1033,1,1,243,226,17
BR1_2722049109,8,False,0,0,0,16330,205,46,6.8,False,7,True,1,0,0,15800,147,68,6.8,True,26.03875,530,1,-1,251,215,36
BR1_2690622888,6,False,0,0,0,16624,155,40,6.6,False,13,True,1,1,0,20372,210,68,7.6,True,28.330083333333334,-3748,-7,-1,195,278,-83
BR1_2725337890,12,True,0,0,0,19013,206,68,7.6,True,3,False,0,1,0,15359,197,44,7.0,False,28.096066666666665,3654,9,0,274,241,33
BR1_2718197532,2,False,1,0,0,14486,170,68,6.8,True,9,True,0,0,0,16971,180,28,6.6,False,26.9437,-2485,-7,1,238,208,30
BR1_2731270669,8,True,1,0,0,17002,186,44,6.8,False,4,False,0,0,0,13437,156,48,6.6,True,26.604233333333333,3565,4,1,230,204,26
BR1_2730264574,5,True,0,0,0,14533,157,40,6.6,False,1,False,1,0,0,12979,161,44,6.6,True,25.39115,1554,4,-1,197,205,-8
BR1_2730235144,11,False,1,0,0,18845,183,56,7.2,True,10,True,0,1,0,19029,178,47,7.2,False,29.627266666666667,-184,1,1,239,225,14
BR1_2729114616,10,True,1,1,1,20063,206,64,7.6,False,6,False,0,0,0,15942,178,48,7.0,True,28.496883333333333,4121,4,1,270,226,44
BR1_2722940625,6,True,0,0,0,17511,218,58,7.6,True,4,False,1,0,0,16564,210,69,7.2,False,29.699533333333335,947,2,-1,276,279,-3
BR1_2668591636,5,False,0,0,0,16125,211,52,7.2,False,10,True,1,0,0,20396,246,76,7.4,True,28.070383333333332,-4271,-5,-1,263,322,-59
BR1_2722965902,3,True,1,1,0,17812,249,72,7.6,True,0,False,0,0,0,14100,218,56,7.2,False,29.53135,3712,3,1,321,274,47
BR1_2730060461,8,False,0,1,0,16387,190,44,6.4,True,15,True,1,0,0,18365,169,48,7.0,False,26.20375,-1978,-7,-1,234,217,17
BR1_2729137497,9,False,1,0,0,18153,208,52,7.2,True,7,True,0,0,0,16921,191,36,7.0,False,27.941283333333335,1232,2,1,260,227,33
BR1_2717081838,5,True,1,0,0,16372,233,56,7.4,False,9,False,0,1,0,18862,228,75,7.2,True,28.904783333333334,-2490,-4,1,289,303,-14
BR1_2731034015,4,True,0,0,0,13663,161,36,6.2,False,4,False,1,0,0,14602,182,64,6.6,True,25.856816666666667,-939,0,-1,197,246,-49
BR1_2731002118,9,False,0,0,0,15838,114,36,6.4,False,9,True,0,0,0,16405,165,40,6.6,True,25.563166666666667,-567,0,0,150,205,-55
BR1_2729738191,4,False,0,0,0,15026,172,68,6.8,False,6,True,0,0,0,16240,203,44,7.0,True,27.196566666666666,-1214,-2,0,240,247,-7
BR1_2695090157,5,False,0,0,0,17147,213,48,7.0,False,7,True,1,1,0,17703,213,52,7.4,True,28.76085,-556,-2,-1,261,265,-4
BR1_2729756606,13,False,0,0,0,19938,212,40,6.8,False,9,True,0,0,0,18454,145,72,6.8,True,29.215166666666665,1484,4,0,252,217,35
BR1_2728467439,5,False,0,0,0,13472,126,47,6.6,False,9,True,1,0,0,17637,215,64,6.6,True,25.342416666666665,-4165,-4,-1,173,279,-106
BR1_2730860975,4,False,1,1,0,15184,202,60,7.6,True,6,True,0,0,0,16881,180,64,7.2,False,28.3644,-1697,-2,1,262,244,18
BR1_2731462128,8,False,0,0,0,18101,244,56,7.4,True,1,True,1,0,0,13739,195,48,7.2,False,27.953,4362,7,-1,300,243,57
BR1_2726965586,3,False,0,0,0,15973,230,52,7.2,False,6,True,1,0,0,16975,205,56,7.2,True,28.1642,-1002,-3,-1,282,261,21
BR1_2726939200,9,True,1,1,0,18356,194,56,7.2,True,8,False,0,0,0,16726,160,44,7.0,False,27.695066666666666,1630,1,1,250,204,46
BR1_2730811548,12,False,1,0,0,16377,142,44,6.4,True,8,True,0,0,0,16528,214,40,6.6,False,26.114333333333335,-151,4,1,186,254,-68
BR1_2723346247,6,False,0,0,0,15077,170,35,6.8,True,5,True,0,1,0,15110,161,35,6.8,False,25.205066666666667,-33,1,0,205,196,9
BR1_2721332697,4,False,0,0,0,14328,186,63,6.6,False,5,True,0,0,0,15373,175,53,6.8,True,26.850983333333332,-1045,-1,0,249,228,21
BR1_2726561433,4,True,0,1,0,17082,212,45,7.0,True,7,False,1,0,0,16689,195,46,7.4,False,29.18915,393,-3,-1,257,241,16
BR1_2728902221,17,True,1,1,1,24017,289,55,8.0,True,1,False,0,0,0,13608,175,52,6.8,False,27.946066666666667,10409,16,1,344,227,117
BR1_2726319485,5,True,1,1,0,15960,190,48,6.8,False,7,False,0,0,0,18274,212,72,7.2,True,27.622966666666667,-2314,-2,1,238,284,-46
BR1_2731187999,5,False,0,0,0,16145,169,52,7.0,True,6,True,0,0,0,16539,185,48,7.2,False,29.29905,-394,-1,0,221,233,-12
BR1_2689709438,7,True,0,1,0,18666,207,60,7.4,False,7,False,0,0,0,18102,233,68,7.2,True,27.632033333333332,564,0,0,267,301,-34
BR1_2731349712,9,False,1,0,0,17420,176,72,7.6,False,8,True,0,0,0,18007,217,36,7.0,True,29.029766666666667,-587,1,1,248,253,-5
BR1_2731011789,12,True,1,0,0,19390,197,48,7.4,True,4,False,0,0,0,14479,147,39,6.8,False,28.8362,4911,8,1,245,186,59
BR1_2730761036,5,True,1,0,0,15763,168,52,6.8,False,5,False,0,1,0,16117,165,56,6.8,True,28.06025,-354,0,1,220,221,-1
BR1_2728499161,11,True,1,0,0,18606,192,48,7.4,True,5,False,0,0,0,14879,142,48,7.0,False,28.08025,3727,6,1,240,190,50
BR1_2731553549,13,False,1,1,0,19779,155,52,7.2,False,10,True,0,0,0,18596,189,68,7.2,True,28.700133333333333,1183,3,1,207,257,-50
BR1_2731478687,4,True,1,1,0,17146,216,68,7.6,True,4,False,0,0,0,17053,212,56,7.4,False,29.053266666666666,93,0,1,284,268,16
BR1_2728956211,8,False,0,0,0,14873,112,42,6.2,False,13,True,1,0,0,17464,169,37,6.4,True,25.4961,-2591,-5,-1,154,206,-52
BR1_2727705538,5,True,0,0,0,13523,153,32,6.6,False,5,False,1,0,0,14659,157,48,6.8,True,25.999216666666666,-1136,0,-1,185,205,-20
BR1_2731516284,11,True,0,1,0,18878,171,40,7.2,False,4,False,1,0,0,15504,172,64,7.2,True,29.7723,3374,7,-1,211,236,-25
BR1_2725829950,2,False,0,0,0,14952,205,54,7.2,False,2,True,1,0,0,15121,201,62,7.4,True,27.616416666666666,-169,0,-1,259,263,-4
BR1_2726406962,14,True,1,1,0,21020,227,60,7.6,True,11,False,0,0,0,17571,143,56,7.4,False,28.921633333333332,3449,3,1,287,199,88
BR1_2684447457,3,False,1,0,0,15134,181,44,7.4,True,8,True,0,0,0,17009,202,50,7.4,False,29.82945,-1875,-5,1,225,252,-27
BR1_2690003771,3,False,0,0,0,15477,208,44,7.2,False,11,True,0,1,0,18929,212,60,7.2,True,28.468733333333333,-3452,-8,0,252,272,-20
BR1_2713698695,7,True,1,0,0,18104,206,64,7.2,True,10,False,0,0,0,19051,219,46,7.2,False,27.895416666666666,-947,-3,1,270,265,5
BR1_2713666116,6,True,1,1,0,17045,200,72,7.2,True,8,False,0,0,0,17841,202,60,7.4,False,28.408,-796,-2,1,272,262,10
BR1_2683888629,3,False,0,0,0,14199,162,70,6.6,False,8,True,1,0,0,16163,185,56,6.8,True,27.05705,-1964,-5,-1,232,241,-9
BR1_2727189140,10,False,1,1,0,19080,202,72,7.6,True,7,True,0,0,0,17056,204,56,7.4,False,27.980833333333333,2024,3,1,274,260,14
BR1_2731661651,6,False,0,0,0,14463,133,48,6.8,False,9,True,0,0,0,17551,200,48,7.0,True,29.127233333333333,-3088,-3,0,181,248,-67
BR1_2731736614,3,False,0,0,0,14339,206,44,6.6,False,7,True,1,0,0,16046,183,64,6.8,True,26.638666666666666,-1707,-4,-1,250,247,3
BR1_2731712167,4,False,0,0,0,16474,193,52,7.0,True,8,True,0,0,0,16685,173,56,6.8,False,28.667083333333334,-211,-4,0,245,229,16
BR1_2731682058,9,True,0,0,0,17349,148,42,6.8,True,10,False,1,0,0,19184,170,64,7.0,False,28.44708333333333,-1835,-1,-1,190,234,-44
BR1_2668511101,7,False,1,0,0,18165,226,72,7.8,True,6,True,0,0,0,16298,201,28,7.4,False,29.4853,1867,1,1,298,229,69
BR1_2730228470,3,False,0,0,0,14308,156,40,6.4,False,11,True,1,0,0,17925,209,60,7.2,True,25.125583333333335,-3617,-8,-1,196,269,-73
BR1_2727340774,10,True,1,0,0,18291,194,64,7.2,True,3,False,0,0,0,14152,168,40,6.8,False,28.032183333333332,4139,7,1,258,208,50
BR1_2727256020,8,False,0,1,0,16593,131,50,6.8,False,6,True,1,0,0,16271,174,50,6.6,True,29.197383333333335,322,2,-1,181,224,-43
BR1_2731656209,5,True,0,1,0,14881,184,68,7.0,True,6,False,1,0,0,14301,134,54,6.2,False,25.4186,580,-1,-1,252,188,64
BR1_2731470116,7,False,0,0,0,15742,179,44,6.6,False,3,True,1,1,0,14981,184,48,6.6,True,26.04235,761,4,-1,223,232,-9
BR1_2715335773,11,True,1,1,0,18860,171,62,7.0,True,9,False,0,0,0,19644,193,48,7.0,False,28.733633333333334,-784,2,1,233,241,-8
BR1_2690160179,3,False,0,1,0,15530,211,52,7.2,False,3,True,1,0,0,15632,223,52,7.2,True,29.371033333333333,-102,0,-1,263,275,-12
BR1_2730856514,3,False,1,0,0,15086,176,64,7.0,False,6,True,0,1,0,16496,175,64,7.2,True,28.002016666666666,-1410,-3,1,240,239,1
BR1_2728597429,4,False,1,0,0,14336,191,44,7.2,True,4,True,0,0,0,13263,157,44,6.6,False,25.694283333333335,1073,0,1,235,201,34
BR1_2725823010,4,True,0,0,0,13833,165,40,6.6,False,11,False,1,0,0,16909,168,52,7.0,True,26.106366666666666,-3076,-7,-1,205,220,-15
BR1_2719724393,9,False,0,0,0,17128,161,52,6.8,False,7,True,1,0,0,15809,183,49,7.0,True,29.0328,1319,2,-1,213,232,-19
BR1_2711914823,10,True,0,0,0,16944,204,48,7.0,False,6,False,1,0,0,15465,185,52,6.6,True,26.737283333333334,1479,4,-1,252,237,15
BR1_2694201516,6,True,1,0,0,15480,180,52,6.8,True,7,False,0,1,0,16093,196,48,6.8,False,26.99665,-613,-1,1,232,244,-12
BR1_2731721523,6,False,0,1,0,15396,157,44,6.8,False,9,True,0,0,1,18643,193,44,7.0,True,28.4137,-3247,-3,0,201,237,-36
BR1_2724556938,5,False,1,0,0,14529,165,44,6.6,False,4,True,0,0,0,13787,164,52,6.6,True,27.451016666666668,742,1,1,209,216,-7
BR1_2720995593,10,True,1,1,0,18903,185,52,7.2,True,5,False,0,0,0,16383,209,55,7.2,False,29.773066666666665,2520,5,1,237,264,-27
BR1_2720314920,3,True,1,0,0,15330,173,48,6.6,True,1,False,0,0,0,12701,165,48,6.6,False,25.58255,2629,2,1,221,213,8
BR1_2720266403,9,True,1,0,0,17366,159,52,6.8,True,5,False,0,0,0,15867,190,52,6.8,False,29.54085,1499,4,1,211,242,-31
BR1_2720243518,4,True,0,0,0,14194,147,52,6.8,True,4,False,0,0,0,14436,183,51,6.8,False,27.050116666666668,-242,0,0,199,234,-35
BR1_2688667906,3,False,1,0,0,13081,145,53,6.4,False,6,True,0,0,0,15731,193,46,6.6,True,26.667066666666667,-2650,-3,1,198,239,-41
BR1_2688273073,3,False,0,0,0,15027,200,52,7.2,False,10,True,1,1,0,19012,197,56,7.4,True,29.102,-3985,-7,-1,252,253,-1
BR1_2694839262,2,False,1,0,0,15354,178,56,6.8,False,7,True,0,1,0,17758,208,68,7.0,True,29.532666666666668,-2404,-5,1,234,276,-42
BR1_2667635175,5,True,1,0,0,15504,198,48,7.0,False,5,False,0,0,0,16987,193,60,7.2,True,26.520116666666667,-1483,0,1,246,253,-7
BR1_2667629584,5,False,0,0,0,17908,264,59,7.8,False,8,True,1,0,0,17981,208,44,7.4,True,28.810883333333333,-73,-3,-1,323,252,71
BR1_2664400903,5,True,0,0,0,15119,194,52,6.4,False,9,False,1,0,0,16490,172,50,7.2,True,26.300433333333334,-1371,-4,-1,246,222,24
BR1_2699965776,11,False,0,0,0,19132,188,60,7.4,False,7,True,1,0,0,17502,208,48,6.8,True,29.537516666666665,1630,4,-1,248,256,-8
BR1_2731369700,9,False,1,1,0,18394,166,46,6.6,False,7,True,0,0,0,18214,181,61,6.8,True,29.178383333333333,180,2,1,212,242,-30
BR1_2730878978,9,False,0,0,0,17721,197,40,7.2,False,10,True,1,1,0,19634,206,72,7.6,True,29.93245,-1913,-1,-1,237,278,-41
BR1_2728425764,9,True,0,1,0,18865,249,44,7.4,True,8,False,1,0,0,18885,195,63,7.4,False,29.4659,-20,1,-1,293,258,35
BR1_2728400081,5,True,1,0,0,15034,201,48,6.6,False,6,False,0,1,0,15662,192,48,6.4,True,26.953333333333333,-628,-1,1,249,240,9
BR1_2706964551,1,False,0,0,0,15339,210,60,7.4,True,5,True,0,0,0,16334,189,56,7.0,False,27.541,-995,-4,0,270,245,25
BR1_2701313285,16,False,1,1,0,21483,228,64,7.6,True,8,True,0,0,0,16786,179,40,7.2,False,27.50025,4697,8,1,292,219,73
BR1_2703995909,10,False,1,0,0,17154,172,44,6.8,False,6,True,0,0,1,17646,205,44,6.6,True,29.03745,-492,4,1,216,249,-33
BR1_2703334360,4,False,1,0,0,15579,223,60,7.0,True,3,True,0,1,0,13640,156,48,6.8,False,25.954816666666666,1939,1,1,283,204,79
BR1_2729873323,6,True,0,0,0,16174,191,52,7.0,False,6,False,1,0,0,16763,199,72,7.4,True,29.755733333333332,-589,0,-1,243,271,-28
BR1_2731696567,7,False,0,1,0,18706,209,64,7.4,False,14,True,0,0,0,21466,266,44,7.8,True,29.050283333333333,-2760,-7,0,273,310,-37
BR1_2729921487,8,True,1,1,0,17114,210,60,7.0,True,4,False,0,0,0,14606,199,51,6.6,False,25.256166666666665,2508,4,1,270,250,20
BR1_2728291292,6,False,0,0,0,16665,182,44,7.0,False,7,True,1,1,0,18959,212,60,7.4,True,27.7776,-2294,-1,-1,226,272,-46
BR1_2731416811,13,True,1,1,0,18736,209,56,7.4,False,6,False,0,0,0,15052,141,56,7.0,True,29.093466666666668,3684,7,1,265,197,68
BR1_2686190115,6,False,0,0,0,16249,208,40,6.8,True,11,True,0,0,0,19318,204,60,7.6,False,28.920683333333333,-3069,-5,0,248,264,-16
BR1_2695461482,5,False,1,0,0,15315,197,44,6.6,False,7,True,0,1,0,15923,165,64,6.8,True,25.4885,-608,-2,1,241,229,12
BR1_2664209924,9,False,0,0,0,18433,200,59,7.0,False,8,True,1,0,0,17553,195,56,7.2,True,25.638183333333334,880,1,-1,259,251,8
BR1_2731153366,5,False,1,1,0,16293,160,68,6.8,False,6,True,0,0,0,16705,173,50,6.6,True,28.381466666666668,-412,-1,1,228,223,5
BR1_2731519853,11,True,1,1,0,19946,224,56,7.2,True,11,False,0,0,0,18296,179,36,7.0,False,29.063316666666665,1650,0,1,280,215,65
BR1_2731137636,8,True,1,0,0,16330,198,60,6.6,True,2,False,0,0,0,13748,161,44,6.4,False,27.352633333333333,2582,6,1,258,205,53
BR1_2731114664,6,False,1,0,0,14807,139,44,6.2,False,10,True,0,1,0,17898,183,44,6.6,True,25.207516666666667,-3091,-4,1,183,227,-44
BR1_2730673988,5,False,1,0,0,14508,177,50,6.8,False,6,True,0,1,0,15212,160,52,6.8,True,25.249716666666668,-704,-1,1,227,212,15
BR1_2710063407,7,False,1,1,0,18340,230,60,7.0,False,10,True,0,0,0,18059,159,56,7.2,True,28.583466666666666,281,-3,1,290,215,75
BR1_2708961010,9,True,0,0,0,16648,175,56,7.0,False,12,False,0,0,0,19603,182,60,7.0,True,28.02178333333333,-2955,-3,0,231,242,-11
BR1_2687822870,11,True,0,0,0,17324,166,40,7.0,False,7,False,0,0,0,16542,200,44,7.0,True,27.533933333333334,782,4,0,206,244,-38
BR1_2726813707,8,True,1,0,0,17857,218,60,7.2,True,5,False,0,0,0,15707,147,51,6.8,False,29.601633333333332,2150,3,1,278,198,80
BR1_2723744241,6,False,0,0,0,15751,206,48,6.8,False,7,True,1,1,0,16897,211,56,6.8,True,26.97211666666667,-1146,-1,-1,254,267,-13
BR1_2716482449,6,False,0,0,0,16802,229,52,7.6,False,6,True,1,0,0,16654,212,48,7.2,True,28.1721,148,0,-1,281,260,21
BR1_2730832424,5,False,1,1,0,16485,191,52,7.0,False,9,True,0,0,0,18732,232,60,7.2,True,29.600833333333334,-2247,-4,1,243,292,-49
BR1_2701080675,9,False,1,1,0,17380,152,40,7.2,True,9,True,0,0,0,17452,189,76,7.0,False,28.45095,-72,0,1,192,265,-73
BR1_2725765022,4,True,1,0,0,14164,168,36,6.4,True,8,False,0,1,0,16483,170,46,6.8,False,25.330333333333332,-2319,-4,1,204,216,-12
BR1_2731188580,6,False,0,1,0,16128,179,68,7.4,True,3,True,1,0,0,15077,183,44,7.4,False,29.458666666666666,1051,3,-1,247,227,20
BR1_2731632579,8,True,1,0,0,17793,195,64,7.0,False,8,False,0,1,0,18496,224,48,7.0,True,28.7185,-703,0,1,259,272,-13
BR1_2731590308,10,True,0,0,0,17549,156,36,7.0,False,8,False,1,1,0,16989,173,56,7.2,True,27.683033333333334,560,2,-1,192,229,-37
BR1_2685490588,13,False,0,0,0,19660,204,56,7.6,False,9,True,0,0,0,18682,206,48,7.2,True,29.76695,978,4,0,260,254,6
BR1_2730713698,4,True,0,0,0,15861,181,40,6.4,False,8,False,1,1,0,18287,180,48,6.8,True,27.71365,-2426,-4,-1,221,228,-7
BR1_2725340392,5,True,0,0,0,15866,187,46,6.8,True,4,False,1,1,0,16934,244,56,7.4,False,29.754966666666668,-1068,1,-1,233,300,-67
BR1_2730279542,10,False,1,0,0,18125,202,52,7.4,True,6,True,0,0,0,17527,187,48,7.0,False,29.1185,598,4,1,254,235,19
BR1_2730755568,9,False,1,0,0,15836,126,36,6.4,False,13,True,0,0,0,17392,173,40,6.6,True,25.371366666666667,-1556,-4,1,162,213,-51
BR1_2728527323,6,True,1,0,0,14442,152,40,6.2,False,8,False,0,0,0,16625,176,44,6.4,True,25.061183333333332,-2183,-2,1,192,220,-28
BR1_2724020957,14,True,0,0,0,18588,185,34,6.8,False,13,False,1,1,0,20066,186,44,7.2,True,28.147666666666666,-1478,1,-1,219,230,-11
BR1_2692127448,10,True,0,0,0,17783,186,36,7.2,False,6,False,0,0,0,18203,237,64,7.2,True,28.02335,-420,4,0,222,301,-79
BR1_2697580785,4,False,0,0,0,13980,192,30,6.8,False,2,True,0,1,0,14935,182,56,6.6,True,25.99195,-955,2,0,222,238,-16
BR1_2731082269,7,True,0,0,0,15232,146,44,6.6,True,6,False,1,0,0,14921,168,48,6.6,False,27.33015,311,1,-1,190,216,-26
BR1_2692468760,3,False,0,0,0,14920,178,40,7.0,False,8,True,1,0,0,18039,197,52,7.0,True,28.42475,-3119,-5,-1,218,249,-31
BR1_2720653140,5,False,0,0,0,15441,210,38,6.4,False,6,True,1,1,0,15717,195,56,6.6,True,26.5573,-276,-1,-1,248,251,-3
BR1_2720617522,4,True,0,0,0,14386,163,44,6.4,False,7,False,0,1,0,16470,173,68,6.8,True,26.68555,-2084,-3,0,207,241,-34
BR1_2723104423,8,False,0,0,0,17903,188,48,6.6,False,19,True,1,1,0,23377,177,64,7.2,True,29.428766666666668,-5474,-11,-1,236,241,-5
BR1_2695728579,9,True,0,0,0,17090,160,40,6.2,False,10,False,0,0,0,18002,195,52,6.6,True,25.352716666666666,-912,-1,0,200,247,-47
BR1_2694510275,6,True,1,0,0,16528,176,52,6.8,False,13,False,0,1,0,20174,162,64,7.2,True,29.520816666666665,-3646,-7,1,228,226,2
BR1_2729353408,10,False,1,0,0,18748,206,52,7.4,True,12,True,0,1,0,19434,190,54,7.4,False,29.566216666666666,-686,-2,1,258,244,14
BR1_2708433796,6,False,1,0,0,15900,187,48,7.2,False,6,True,0,0,0,18170,228,64,7.4,True,27.561666666666667,-2270,0,1,235,292,-57
BR1_2721991940,8,True,1,0,0,17505,208,52,7.2,False,2,False,0,1,0,15595,189,80,7.2,True,28.95955,1910,6,1,260,269,-9
BR1_2719396233,8,True,1,1,0,18829,225,48,7.4,True,2,False,0,0,0,15461,213,64,7.4,False,28.79185,3368,6,1,273,277,-4
BR1_2728377354,8,False,0,0,0,18450,208,56,7.2,False,16,True,0,0,0,20639,180,48,7.6,True,28.6433,-2189,-8,0,264,228,36
BR1_2730481682,5,True,1,0,0,16599,196,64,7.6,True,2,False,0,0,0,14712,203,28,6.2,False,29.104066666666668,1887,3,1,260,231,29
BR1_2730467668,5,True,1,0,0,16049,187,64,7.2,True,5,False,0,0,0,15371,187,60,7.0,False,26.403783333333333,678,0,1,251,247,4
BR1_2730958213,13,False,1,0,0,20495,171,48,6.8,False,10,True,0,0,0,17711,126,48,6.6,True,27.67268333333333,2784,3,1,219,174,45
BR1_2719094554,6,True,1,0,0,15822,151,44,6.4,False,10,False,0,0,0,16958,189,48,6.8,True,25.3883,-1136,-4,1,195,237,-42
BR1_2698310844,8,True,1,0,0,16803,156,51,6.8,False,8,False,0,1,0,17830,184,36,6.8,True,29.443433333333335,-1027,0,1,207,220,-13
BR1_2730806279,6,True,0,0,0,16357,207,52,6.6,True,3,False,0,0,0,14221,180,40,6.4,False,25.576333333333334,2136,3,0,259,220,39
BR1_2668298889,5,False,0,0,0,15643,176,36,7.0,False,5,True,1,0,0,17121,226,68,7.8,True,27.595083333333335,-1478,0,-1,212,294,-82
BR1_2667441607,10,False,0,0,0,16786,190,36,6.6,False,12,True,0,0,0,18849,177,44,6.6,True,26.1394,-2063,-2,0,226,221,5
BR1_2725698263,6,False,0,0,0,16718,161,66,6.8,True,4,True,1,1,0,15706,160,52,7.0,False,29.17995,1012,2,-1,227,212,15
BR1_2730367291,11,False,0,0,0,19919,211,40,6.8,False,17,True,1,0,0,21649,173,68,7.2,True,28.47223333333333,-1730,-6,-1,251,241,10
BR1_2718280850,2,True,0,0,0,15406,202,44,6.8,False,6,False,0,1,0,17151,203,52,7.2,True,28.195233333333334,-1745,-4,0,246,255,-9
BR1_2721698661,7,False,0,0,0,16154,161,44,6.8,False,14,True,1,0,0,19912,210,40,7.0,True,28.160566666666668,-3758,-7,-1,205,250,-45
BR1_2731003117,11,True,0,0,0,18044,169,36,6.8,True,8,False,0,0,0,15306,163,36,6.4,False,26.36835,2738,3,0,205,199,6
BR1_2731311683,9,False,0,0,0,17139,174,44,6.4,False,12,True,1,0,0,18964,171,48,6.6,True,28.55516666666667,-1825,-3,-1,218,219,-1
BR1_2731166936,7,True,0,0,0,16361,169,52,6.6,True,5,False,1,0,0,15390,152,63,6.4,False,26.230016666666668,971,2,-1,221,215,6
BR1_2714392599,13,False,0,1,0,20303,215,46,7.2,True,9,True,1,0,0,18072,184,57,7.2,False,27.93415,2231,4,-1,261,241,20
BR1_2721027858,6,True,1,1,1,19591,266,44,7.2,True,3,False,0,0,0,15778,191,72,7.0,False,28.193516666666667,3813,3,1,310,263,47
BR1_2726249416,9,True,0,0,0,20997,239,68,7.6,True,5,False,1,1,0,14534,148,44,6.8,False,27.987033333333333,6463,4,-1,307,192,115
BR1_2724053069,6,True,1,0,0,17422,234,60,7.2,True,4,False,0,1,0,15685,170,60,7.0,False,28.845183333333335,1737,2,1,294,230,64
BR1_2731548240,11,True,1,1,1,22119,234,76,7.8,True,4,False,0,0,0,14673,167,48,6.2,False,28.579783333333335,7446,7,1,310,215,95
BR1_2729532738,1,False,0,0,0,13393,192,36,6.4,False,6,True,1,0,0,15651,182,56,6.8,True,26.043616666666665,-2258,-5,-1,228,238,-10
BR1_2729503775,2,False,0,0,0,14137,194,44,7.0,False,4,True,0,1,0,16251,183,80,7.4,True,28.8245,-2114,-2,0,238,263,-25
BR1_2731187345,12,True,0,1,0,17936,186,60,7.6,False,8,False,0,0,0,18965,225,52,7.4,True,29.382833333333334,-1029,4,0,246,277,-31
BR1_2731265768,4,False,0,0,0,14399,179,52,6.4,False,7,True,0,0,0,16685,236,48,7.0,True,27.01305,-2286,-3,0,231,284,-53
BR1_2731038006,4,True,1,0,0,14966,188,72,6.6,True,10,False,0,0,0,16231,160,44,6.8,False,26.349066666666666,-1265,-6,1,260,204,56
BR1_2731153674,8,True,0,0,0,17006,192,56,7.0,False,8,False,1,0,0,17592,200,64,7.2,True,29.6202,-586,0,-1,248,264,-16
BR1_2731131307,4,False,0,0,0,15891,173,56,7.0,False,12,True,1,1,0,20018,172,64,7.0,True,28.732833333333332,-4127,-8,-1,229,236,-7
BR1_2712166410,4,True,1,0,0,15121,183,60,6.6,True,2,False,0,0,0,13911,175,52,6.8,False,25.678066666666666,1210,2,1,243,227,16
BR1_2727536554,8,True,0,0,0,15283,193,42,6.6,False,5,False,0,0,0,15555,219,50,6.8,True,25.197,-272,3,0,235,269,-34
BR1_2700585952,7,False,0,0,0,16468,181,44,7.0,False,6,True,1,1,0,17105,180,60,7.4,True,27.851,-637,1,-1,225,240,-15
BR1_2698418164,7,False,0,1,0,17140,165,64,7.2,True,5,True,0,0,0,16913,223,48,7.0,False,27.641583333333333,227,2,0,229,271,-42
BR1_2730235288,9,True,0,1,0,17983,186,60,7.2,True,10,False,0,0,0,19530,208,64,7.4,False,28.11545,-1547,-1,0,246,272,-26
BR1_2723738488,4,False,0,1,0,16108,194,70,7.4,False,9,True,1,0,0,17062,171,38,7.2,True,28.647166666666667,-954,-5,-1,264,209,55
BR1_2731442377,11,False,0,0,0,19527,208,56,7.4,False,11,True,1,1,0,19963,202,64,7.4,True,29.45681666666667,-436,0,-1,264,266,-2
BR1_2699777912,5,True,0,0,0,16674,215,56,7.4,True,4,False,0,1,0,16534,197,64,7.2,False,27.62325,140,1,0,271,261,10
BR1_2701898762,8,False,1,0,0,16909,178,44,7.0,True,9,True,0,0,0,17081,191,56,7.2,False,29.267566666666667,-172,-1,1,222,247,-25
BR1_2697710859,10,False,1,0,0,16835,150,52,6.6,False,11,True,0,1,0,18268,173,48,6.8,True,26.981483333333333,-1433,-1,1,202,221,-19
BR1_2730174219,4,False,0,0,0,13633,170,56,6.2,False,3,True,0,0,0,14765,197,36,6.6,True,26.871266666666667,-1132,1,0,226,233,-7
BR1_2706793818,3,False,0,0,0,15344,185,52,7.0,False,10,True,1,0,0,18998,214,56,7.4,True,27.98995,-3654,-7,-1,237,270,-33
BR1_2699048255,6,True,1,0,0,16772,189,72,7.2,True,4,False,0,0,0,15422,178,56,7.4,False,28.953,1350,2,1,261,234,27
BR1_2694915138,4,False,0,1,0,14312,157,40,6.4,False,10,True,1,0,0,17064,192,43,6.4,True,26.191533333333332,-2752,-6,-1,197,235,-38
BR1_2723671670,12,True,1,1,0,19171,189,56,7.4,True,5,False,0,0,0,14650,153,36,6.8,False,27.629,4521,7,1,245,189,56
BR1_2731700979,9,True,0,1,0,18486,226,36,7.0,False,10,False,1,0,0,18310,179,56,7.0,True,28.831266666666668,176,-1,-1,262,235,27
BR1_2719651932,10,True,1,0,0,18001,180,52,7.4,False,9,False,0,0,0,18849,183,52,7.2,True,29.013333333333332,-848,1,1,232,235,-3
BR1_2719645244,3,True,0,0,0,13932,199,40,6.8,False,1,False,0,0,0,12687,170,48,6.8,True,25.01775,1245,2,0,239,218,21
BR1_2680862551,10,True,0,0,0,19148,217,52,7.0,False,13,False,1,0,0,22183,233,64,7.6,True,29.16595,-3035,-3,-1,269,297,-28
BR1_2680803796,4,False,0,1,0,16267,209,76,7.4,False,4,True,0,0,0,16510,227,46,7.2,True,28.2245,-243,0,0,285,273,12
BR1_2669368604,7,False,1,0,0,16139,156,60,6.6,True,6,True,0,0,0,15621,189,68,6.8,False,26.987633333333335,518,1,1,216,257,-41
BR1_2725530219,2,False,0,0,0,13452,183,46,6.6,False,3,True,1,0,0,14796,227,60,6.8,True,26.646933333333333,-1344,-1,-1,229,287,-58
BR1_2712391004,9,True,1,1,0,18271,219,64,7.2,True,1,False,0,0,0,12426,153,50,6.6,False,25.9704,5845,8,1,283,203,80
BR1_2711356114,6,False,0,0,0,15181,158,44,6.4,False,9,True,0,0,0,16698,173,44,6.8,True,25.653133333333333,-1517,-3,0,202,217,-15
BR1_2731428247,10,False,1,0,0,17972,202,52,7.0,True,4,True,0,0,0,15812,188,40,6.8,False,25.966616666666667,2160,6,1,254,228,26
BR1_2730432615,10,False,1,0,0,16585,162,58,6.6,False,7,True,0,0,0,17628,172,39,6.8,True,29.1626,-1043,3,1,220,211,9
BR1_2680598259,8,True,1,0,0,14970,143,60,6.4,True,7,False,0,1,0,15716,165,48,6.8,False,26.192583333333335,-746,1,1,203,213,-10
BR1_2730568066,7,False,0,1,0,18443,208,60,7.6,True,4,True,1,0,0,13700,147,40,6.8,False,29.303733333333334,4743,3,-1,268,187,81
BR1_2681534268,5,True,0,0,0,15982,207,61,7.0,True,3,False,0,0,0,13829,182,44,6.8,False,25.95205,2153,2,0,268,226,42
BR1_2729887315,15,False,0,1,0,20951,169,44,7.0,False,9,True,1,0,0,17772,154,48,6.6,True,29.369533333333333,3179,6,-1,213,202,11
BR1_2729867915,8,False,1,0,0,15763,188,52,6.6,True,8,True,0,1,0,15597,133,40,6.6,False,25.49925,166,0,1,240,173,67
BR1_2731619546,10,True,0,1,1,20062,189,43,7.2,True,4,False,1,0,0,15579,185,56,6.8,False,29.2833,4483,6,-1,232,241,-9
BR1_2731252655,4,False,0,0,0,14108,156,40,6.4,False,10,True,1,1,0,17999,184,60,7.0,True,26.6023,-3891,-6,-1,196,244,-48
BR1_2730958163,4,True,0,0,0,15486,191,38,6.8,False,12,False,1,0,0,18629,203,64,7.6,True,29.19205,-3143,-8,-1,229,267,-38
BR1_2727664762,8,False,0,0,0,15045,142,42,6.4,False,9,True,0,1,0,17374,187,54,6.6,True,25.114266666666666,-2329,-1,0,184,241,-57
BR1_2722001668,12,True,1,0,0,19438,143,44,6.8,False,16,False,0,0,0,20996,217,52,7.2,True,29.600766666666665,-1558,-4,1,187,269,-82
BR1_2689457361,7,True,0,0,0,15893,201,36,6.4,False,7,False,1,1,0,16269,172,50,6.8,True,26.9765,-376,0,-1,237,222,15
BR1_2727892259,7,True,1,1,0,18329,216,36,7.0,True,5,False,0,0,0,17267,207,60,7.0,False,28.9469,1062,2,1,252,267,-15
BR1_2728779775,7,True,0,0,0,16467,219,48,6.8,True,6,False,0,0,0,15992,197,40,6.6,False,26.085233333333335,475,1,0,267,237,30
BR1_2726175928,16,True,1,1,0,19981,149,52,6.6,True,8,False,0,0,0,15676,168,46,6.4,False,27.48035,4305,8,1,201,214,-13
BR1_2726130763,11,True,0,1,1,20628,224,44,7.6,True,9,False,1,0,0,17607,178,60,7.2,False,28.94745,3021,2,-1,268,238,30
BR1_2726076809,15,False,0,0,0,21520,156,64,7.2,False,13,True,1,1,0,21269,192,59,7.0,True,28.068966666666668,251,2,-1,220,251,-31
BR1_2728394163,8,False,0,0,0,18407,197,42,7.2,True,10,True,0,0,0,18565,204,62,7.0,False,27.695483333333332,-158,-2,0,239,266,-27
BR1_2728266750,7,True,0,0,0,15491,155,58,6.4,True,4,False,1,0,0,14209,171,44,6.6,False,26.6016,1282,3,-1,213,215,-2
BR1_2717213324,5,False,0,1,0,15612,171,43,6.6,True,12,True,0,0,0,18576,192,40,7.2,False,27.966866666666668,-2964,-7,0,214,232,-18
BR1_2716339897,8,False,1,0,0,16166,151,63,6.8,True,2,True,0,1,0,14916,178,56,7.2,False,29.788483333333332,1250,6,1,214,234,-20
BR1_2726302907,6,False,0,1,0,16786,207,56,7.0,False,9,True,1,0,0,19745,243,60,7.8,True,28.14615,-2959,-3,-1,263,303,-40
BR1_2720984966,6,False,1,0,0,17403,202,64,7.4,True,13,True,0,1,0,20749,220,60,7.4,False,29.448083333333333,-3346,-7,1,266,280,-14
BR1_2703430158,9,True,0,0,0,16760,175,44,6.8,True,8,False,1,0,0,15688,172,48,6.6,False,26.278416666666665,1072,1,-1,219,220,-1
BR1_2684682077,6,False,0,1,0,16826,186,44,7.2,False,13,True,1,0,0,18772,154,56,7.6,True,28.5697,-1946,-7,-1,230,210,20
BR1_2684270335,5,True,0,0,0,15508,178,48,7.0,False,8,False,1,1,0,16716,151,40,7.2,True,27.915633333333332,-1208,-3,-1,226,191,35
BR1_2730734323,7,False,0,0,0,18665,197,52,7.0,False,11,True,1,0,0,17820,184,44,7.0,True,28.177233333333334,845,-4,-1,249,228,21
BR1_2731227839,14,True,0,0,1,21057,184,39,7.0,False,8,False,0,0,0,16885,133,64,6.8,True,28.787783333333334,4172,6,0,223,197,26
BR1_2688152362,5,False,0,1,0,15918,205,56,7.4,False,5,True,1,0,0,16572,231,56,7.4,True,28.562883333333332,-654,0,-1,261,287,-26
BR1_2722496340,10,False,0,1,0,16251,159,10,6.4,True,4,True,0,0,0,14315,147,52,6.4,False,25.45195,1936,6,0,169,199,-30
BR1_2722456650,6,True,0,0,0,16500,218,42,7.0,False,6,False,1,1,0,16209,181,52,7.0,True,29.004016666666665,291,0,-1,260,233,27
BR1_2731621449,3,False,0,0,0,13412,143,49,6.4,False,12,True,1,0,0,18941,194,54,7.2,True,26.070283333333332,-5529,-9,-1,192,248,-56
BR1_2731406026,3,False,0,0,0,14215,176,52,6.2,False,13,True,1,0,0,19586,170,48,7.2,True,29.3531,-5371,-10,-1,228,218,10
BR1_2669678437,6,False,0,0,0,15078,151,52,6.4,False,9,True,1,0,0,16469,185,52,7.0,True,27.4465,-1391,-3,-1,203,237,-34
BR1_2731677013,11,False,1,0,0,18355,195,64,7.4,True,2,True,0,0,0,13847,161,44,6.4,False,29.006816666666666,4508,9,1,259,205,54
BR1_2728239049,7,False,1,0,0,17103,199,68,7.4,True,6,True,0,0,0,16267,191,48,7.0,False,28.61535,836,1,1,267,239,28
BR1_2731384549,8,False,1,0,0,18570,206,60,7.2,True,9,True,0,0,0,18347,174,60,7.0,False,27.9843,223,-1,1,266,234,32
BR1_2731381709,7,False,0,0,0,18200,218,60,7.0,False,13,True,0,0,0,20680,203,60,7.2,True,28.470833333333335,-2480,-6,0,278,263,15
BR1_2731378305,10,False,1,0,0,17670,195,50,7.0,True,8,True,0,0,0,16361,174,53,6.4,False,26.2054,1309,2,1,245,227,18
BR1_2729867978,12,True,1,0,0,19496,222,52,7.6,True,8,False,0,1,0,17858,207,60,7.2,False,27.61205,1638,4,1,274,267,7
BR1_2731520983,5,False,0,0,0,13369,141,16,5.8,False,12,True,1,0,0,16509,196,51,7.0,True,25.301633333333335,-3140,-7,-1,157,247,-90
BR1_2728673686,17,True,1,0,0,19011,155,36,6.4,True,3,False,0,0,0,13233,137,34,5.8,False,26.15673333333333,5778,14,1,191,171,20
BR1_2731448171,3,True,0,0,0,13771,175,40,7.0,False,10,False,1,0,0,18249,200,52,7.0,True,29.6426,-4478,-7,-1,215,252,-37
BR1_2731283787,7,True,1,1,0,17088,154,48,7.4,True,5,False,0,0,0,16596,195,44,7.0,False,28.2402,492,2,1,202,239,-37
BR1_2730327344,10,True,0,1,0,16974,172,44,6.6,True,7,False,0,0,0,15580,160,40,6.8,False,27.42205,1394,3,0,216,200,16
BR1_2731539686,4,False,1,0,0,13926,161,52,6.4,False,8,True,0,0,0,17288,186,36,6.8,True,26.67031666666667,-3362,-4,1,213,222,-9
BR1_2722719453,8,False,1,0,0,15045,149,40,6.4,False,16,True,0,1,0,19852,151,52,6.8,True,26.2376,-4807,-8,1,189,203,-14
BR1_2677445138,5,False,1,1,0,17244,221,48,7.2,False,8,True,0,0,0,18572,220,72,7.6,True,28.554916666666667,-1328,-3,1,269,292,-23
BR1_2697025496,6,False,1,0,0,16139,189,43,7.0,False,6,True,0,0,0,19043,240,68,7.4,True,28.640116666666668,-2904,0,1,232,308,-76
BR1_2678654429,5,False,0,0,0,14216,121,36,6.4,False,8,True,1,1,0,15405,134,56,6.6,True,26.903066666666668,-1189,-3,-1,157,190,-33
BR1_2678632645,11,True,1,1,1,18209,176,56,7.4,True,4,False,0,0,0,14489,174,56,6.2,False,26.378716666666666,3720,7,1,232,230,2
BR1_2678531817,4,False,0,0,0,15469,182,60,7.6,False,8,True,1,1,0,17156,183,56,7.8,True,29.8546,-1687,-4,-1,242,239,3
BR1_2727391257,10,True,0,1,0,17256,155,60,6.8,True,6,False,1,0,0,13216,122,44,6.2,False,25.12473333333333,4040,4,-1,215,166,49
BR1_2726341064,5,False,0,0,0,16106,197,48,7.2,False,8,True,1,1,0,18642,189,63,7.2,True,29.746416666666665,-2536,-3,-1,245,252,-7
BR1_2726305004,16,True,1,0,0,19119,154,24,6.4,True,12,False,0,0,0,17828,156,32,6.8,False,29.5766,1291,4,1,178,188,-10
BR1_2730953004,1,False,0,0,0,13376,124,60,7.0,False,11,True,1,1,0,19571,207,68,7.6,True,28.373733333333334,-6195,-10,-1,184,275,-91
BR1_2730633241,6,False,0,0,0,14322,179,52,6.8,True,5,True,0,0,0,14795,168,48,6.8,False,26.930083333333332,-473,1,0,231,216,15
BR1_2688946215,6,True,0,0,0,14748,136,33,6.0,False,7,False,0,0,0,15605,185,52,6.6,True,25.561716666666666,-857,-1,0,169,237,-68
BR1_2688918923,2,False,1,0,0,14579,195,61,7.4,True,2,True,0,1,0,15115,199,60,7.4,False,28.929316666666665,-536,0,1,256,259,-3
BR1_2688288408,8,False,0,0,0,16126,177,52,6.8,False,8,True,1,0,0,15411,167,48,6.6,True,26.676083333333334,715,0,-1,229,215,14
BR1_2719261134,4,True,0,0,0,16728,230,64,7.4,True,4,False,1,1,0,15419,163,52,7.0,False,28.747233333333334,1309,0,-1,294,215,79
BR1_2731695649,8,False,0,1,0,17603,155,48,7.0,True,5,True,1,0,0,15119,156,48,6.8,False,27.655733333333334,2484,3,-1,203,204,-1
BR1_2729852824,6,False,0,0,0,17230,215,48,7.4,True,3,True,0,0,0,14474,194,44,7.0,False,29.003566666666668,2756,3,0,263,238,25
BR1_2707587802,7,False,0,0,0,15794,187,56,7.0,True,3,True,0,0,0,13634,175,35,6.4,False,25.9941,2160,4,0,243,210,33
BR1_2722945686,6,False,0,0,0,15787,163,40,6.6,False,9,True,1,0,0,17406,198,40,6.8,True,27.0332,-1619,-3,-1,203,238,-35
BR1_2730377660,9,False,1,1,0,18086,167,55,7.2,True,3,True,0,0,0,15445,191,43,7.2,False,29.187283333333333,2641,6,1,222,234,-12
BR1_2718138108,1,False,1,1,0,13551,181,60,6.6,False,2,True,0,0,0,14040,196,48,6.6,True,26.14475,-489,-1,1,241,244,-3
BR1_2728457047,6,True,1,0,1,18001,187,64,7.4,True,6,False,0,1,0,16686,168,64,6.8,False,28.29105,1315,0,1,251,232,19
BR1_2731272482,17,True,1,0,0,22403,248,60,7.8,True,6,False,0,1,0,16910,176,60,7.0,False,29.542366666666666,5493,11,1,308,236,72
BR1_2730903296,7,True,0,0,0,18939,220,72,7.4,True,3,False,1,1,0,14905,170,60,6.8,False,27.6778,4034,4,-1,292,230,62
BR1_2730897276,9,True,0,0,0,19110,199,44,7.2,False,9,False,1,1,0,18142,200,64,7.2,True,27.997133333333334,968,0,-1,243,264,-21
BR1_2723187550,4,False,0,0,0,14242,146,56,6.4,False,7,True,0,0,0,16631,187,44,7.0,True,25.071483333333333,-2389,-3,0,202,231,-29
BR1_2730635144,12,False,0,0,0,20689,229,60,7.6,False,10,True,1,0,0,19638,211,56,7.2,True,29.595766666666666,1051,2,-1,289,267,22
BR1_2730562709,6,True,1,0,0,16969,220,40,7.0,False,4,False,0,1,0,16649,235,52,6.8,True,29.36306666666667,320,2,1,260,287,-27
BR1_2725090324,6,False,0,0,0,15700,157,48,7.2,False,8,True,1,1,0,17907,171,76,7.0,True,27.574266666666666,-2207,-2,-1,205,247,-42
BR1_2699179093,5,False,0,0,0,16162,202,48,6.8,False,4,True,0,0,0,16144,220,68,7.2,True,28.185683333333333,18,1,0,250,288,-38
BR1_2716053075,6,False,1,0,0,17267,186,68,7.4,True,7,True,0,0,0,17322,211,60,7.0,False,28.309483333333333,-55,-1,1,254,271,-17
BR1_2731540898,9,True,1,0,0,16733,196,60,7.0,True,4,False,0,0,0,13654,166,39,6.0,False,25.184066666666666,3079,5,1,256,205,51
BR1_2731278798,5,True,0,0,0,16641,187,52,7.0,True,5,False,1,0,0,16228,171,53,7.0,False,27.693316666666668,413,0,-1,239,224,15
BR1_2727797119,4,True,1,0,0,15413,195,56,7.0,True,4,False,0,0,0,15196,186,47,7.2,False,29.2226,217,0,1,251,233,18
BR1_2727315538,0,False,1,1,0,12926,182,48,6.4,True,8,True,0,0,0,15960,168,48,6.6,False,25.24635,-3034,-8,1,230,216,14
BR1_2731270121,7,True,0,1,0,18171,234,64,7.8,True,3,False,0,0,0,14772,188,39,7.0,False,28.20916666666667,3399,4,0,298,227,71
BR1_2682839415,0,False,0,0,0,14628,229,64,7.2,False,5,True,1,0,0,17781,251,60,7.6,True,29.80305,-3153,-5,-1,293,311,-18
BR1_2721152861,7,False,0,0,0,17532,219,68,7.6,True,4,True,1,0,0,14916,164,64,7.2,False,28.232666666666667,2616,3,-1,287,228,59
BR1_2689327925,11,True,0,1,0,19185,226,44,6.6,True,5,False,1,0,0,14456,133,44,6.0,False,29.648616666666666,4729,6,-1,270,177,93
BR1_2677770018,9,True,0,1,0,18186,180,47,7.6,True,3,False,1,0,0,15238,188,60,7.0,False,28.790533333333332,2948,6,-1,227,248,-21
BR1_2730839119,3,False,0,0,0,14973,158,60,7.0,False,5,True,1,0,0,17096,223,60,7.6,True,28.687516666666667,-2123,-2,-1,218,283,-65
BR1_2702967942,6,True,0,0,0,17498,203,56,7.4,False,3,False,0,1,0,15005,180,52,7.2,True,28.955733333333335,2493,3,0,259,232,27
BR1_2702944467,3,True,0,0,0,13845,159,44,6.4,False,5,False,1,1,0,14803,163,64,7.0,True,25.111933333333333,-958,-2,-1,203,227,-24
BR1_2731527763,5,False,0,1,0,15446,145,40,6.8,False,8,True,1,0,0,18400,158,72,7.4,True,28.247333333333334,-2954,-3,-1,185,230,-45
BR1_2704804290,3,False,0,0,0,13677,132,40,6.4,False,17,True,1,0,0,19519,199,52,7.4,True,25.084883333333334,-5842,-14,-1,172,251,-79
BR1_2726444615,13,False,1,1,0,18841,175,52,6.8,False,9,True,0,0,0,17143,160,48,6.6,True,27.051866666666665,1698,4,1,227,208,19
BR1_2723095887,6,False,0,1,2,17345,161,44,7.0,False,11,True,1,0,0,20232,158,59,7.2,True,27.52085,-2887,-5,-1,205,217,-12
BR1_2724177449,8,True,1,0,0,16796,166,53,7.6,True,4,False,0,1,0,15549,179,62,7.2,False,27.7613,1247,4,1,219,241,-22
BR1_2710794722,14,True,0,0,0,19278,166,47,6.4,False,10,False,0,0,0,16905,137,52,6.0,True,27.193633333333334,2373,4,0,213,189,24
BR1_2718046370,10,False,1,1,0,18404,223,48,7.6,False,10,True,0,0,0,19481,189,55,6.8,True,29.501683333333332,-1077,0,1,271,244,27
BR1_2664948834,8,True,1,0,0,18092,201,64,7.2,False,7,False,0,1,0,18638,223,52,7.4,True,28.417316666666668,-546,1,1,265,275,-10
BR1_2730634951,9,True,0,0,0,18426,209,24,6.8,False,8,False,1,0,0,18958,218,64,7.4,True,29.96635,-532,1,-1,233,282,-49
BR1_2694360235,6,True,0,1,0,16254,187,61,7.2,False,8,False,1,0,0,18414,237,45,7.4,True,27.785516666666666,-2160,-2,-1,248,282,-34
BR1_2725545901,1,False,0,0,0,13700,179,56,6.0,False,3,True,1,1,0,14216,210,48,6.8,True,27.018983333333335,-516,-2,-1,235,258,-23
BR1_2697984848,12,False,0,0,0,17537,164,43,6.6,False,8,True,1,0,0,16023,161,46,6.6,True,26.388616666666667,1514,4,-1,207,207,0
BR1_2697707680,5,False,1,0,0,16393,203,67,7.2,False,7,True,0,1,0,17337,202,72,7.6,True,28.747033333333334,-944,-2,1,270,274,-4
BR1_2731140345,5,True,1,1,0,16275,192,62,6.8,False,7,False,0,0,0,18990,245,73,7.6,True,29.593183333333332,-2715,-2,1,254,318,-64
BR1_2729933294,5,True,0,0,0,15940,196,52,7.2,False,6,False,1,0,0,15019,155,52,6.8,True,27.21805,921,-1,-1,248,207,41
BR1_2730329257,6,False,0,1,1,18647,224,48,7.2,True,5,True,1,0,0,16580,197,64,6.8,False,29.98455,2067,1,-1,272,261,11
BR1_2729671205,8,False,1,0,0,15681,151,56,6.6,False,10,True,0,1,0,16434,145,44,6.6,True,26.284433333333332,-753,-2,1,207,189,18
BR1_2722475897,6,True,0,0,0,16146,180,48,7.0,True,8,False,1,1,0,17585,178,64,7.4,False,29.253016666666667,-1439,-2,-1,228,242,-14
BR1_2720138658,10,True,0,0,0,18348,176,56,7.2,False,4,False,1,0,0,16193,219,48,6.8,True,29.355333333333334,2155,6,-1,232,267,-35
BR1_2726994088,13,True,1,0,0,19431,177,44,6.6,True,5,False,0,0,0,14643,129,52,5.8,False,29.5687,4788,8,1,221,181,40
BR1_2727898553,9,False,1,1,0,17453,171,60,7.0,True,5,True,0,0,0,14397,160,36,6.2,False,27.04545,3056,4,1,231,196,35
BR1_2720371663,6,False,0,0,0,15771,167,42,6.6,True,7,True,0,0,0,15961,176,54,6.8,False,27.013766666666665,-190,-1,0,209,230,-21
BR1_2719895097,7,False,1,1,0,15999,161,52,7.0,False,13,True,0,0,0,18997,203,24,6.6,True,29.938166666666667,-2998,-6,1,213,227,-14
BR1_2729623200,8,True,0,0,0,18216,202,44,7.0,True,7,False,1,0,0,15483,170,56,7.0,False,29.1928,2733,1,-1,246,226,20
BR1_2731025688,5,True,0,0,0,14794,180,44,6.4,True,2,False,0,0,0,13300,166,52,6.6,False,27.383266666666668,1494,3,0,224,218,6
BR1_2730833869,6,True,1,0,0,17307,221,62,7.0,True,3,False,0,0,0,16798,245,52,7.4,False,29.73196666666667,509,3,1,283,297,-14
BR1_2726327383,2,True,0,1,0,13494,164,40,6.6,False,10,False,1,0,0,17638,218,52,7.0,True,26.194583333333334,-4144,-8,-1,204,270,-66
BR1_2705954207,9,False,0,0,0,17839,192,36,7.2,True,5,True,1,0,0,14891,198,32,6.8,False,29.53285,2948,4,-1,228,230,-2
BR1_2713307922,9,False,0,0,0,18625,211,64,7.2,False,6,True,1,0,0,17216,178,60,7.0,True,29.503133333333334,1409,3,-1,275,238,37
BR1_2709305019,8,True,0,1,0,16245,140,40,6.0,False,11,False,0,0,0,16172,159,27,6.6,True,25.032233333333334,73,-3,0,180,186,-6
BR1_2727924400,6,False,0,0,0,16299,165,50,7.2,True,11,True,1,0,0,19440,210,40,7.4,False,28.457266666666666,-3141,-5,-1,215,250,-35
BR1_2718421760,8,True,0,1,0,17986,179,64,7.4,True,8,False,1,0,0,16628,179,64,7.2,False,29.672466666666665,1358,0,-1,243,243,0
BR1_2716004002,12,False,1,0,0,19251,190,60,6.8,True,12,True,0,0,0,20414,206,52,7.0,False,28.631716666666666,-1163,0,1,250,258,-8
BR1_2716825361,3,True,0,0,0,14551,214,44,6.8,False,8,False,1,0,0,16819,189,58,7.0,True,25.357433333333333,-2268,-5,-1,258,247,11
BR1_2715843078,5,True,0,0,0,14126,177,36,6.8,False,5,False,1,1,0,15621,194,52,6.8,True,25.57295,-1495,0,-1,213,246,-33
BR1_2728618703,7,True,1,1,0,17440,185,48,6.8,True,5,False,0,0,0,14062,136,40,6.6,False,26.395133333333334,3378,2,1,233,176,57
BR1_2727122640,9,True,0,0,2,18861,171,36,6.4,True,4,False,0,0,0,13174,125,48,5.8,False,25.6865,5687,5,0,207,173,34
BR1_2702340389,10,True,1,0,0,18386,173,60,7.0,False,8,False,0,0,0,17913,186,40,6.6,True,28.346983333333334,473,2,1,233,226,7
BR1_2730180433,5,False,1,0,0,16056,171,56,7.0,False,7,True,0,1,0,17884,213,52,7.2,True,28.625716666666666,-1828,-2,1,227,265,-38
BR1_2730046146,11,False,0,1,0,17871,182,28,7.2,False,14,True,1,0,0,21604,211,56,7.6,True,27.891533333333335,-3733,-3,-1,210,267,-57
BR1_2731557096,10,True,1,1,0,18781,224,64,7.6,True,5,False,0,0,0,16424,213,54,7.0,False,27.734566666666666,2357,5,1,288,267,21
BR1_2723427546,5,True,0,0,0,15459,206,39,7.0,False,7,False,0,0,0,16216,178,51,7.0,True,29.629766666666665,-757,-2,0,245,229,16
BR1_2728868248,1,False,0,1,0,16060,247,56,7.6,False,4,True,1,0,0,16256,215,72,7.0,True,27.8947,-196,-3,-1,303,287,16
BR1_2728435669,9,False,0,1,0,18229,187,48,7.2,False,11,True,1,0,0,18204,201,56,7.4,True,29.163133333333334,25,-2,-1,235,257,-22
BR1_2727364833,10,True,0,0,0,15132,167,22,6.2,True,9,False,1,0,0,15801,124,56,6.0,False,26.580666666666666,-669,1,-1,189,180,9
BR1_2728643477,8,True,1,0,0,18180,219,60,7.2,True,5,False,0,0,0,16082,183,72,7.0,False,29.409966666666666,2098,3,1,279,255,24
BR1_2725669920,6,False,0,0,0,15464,136,46,6.8,False,11,True,0,1,0,18441,186,48,7.0,True,29.103916666666667,-2977,-5,0,182,234,-52
BR1_2720206203,5,False,1,0,0,13679,148,44,6.2,False,5,True,0,0,0,15591,173,52,6.6,True,25.66,-1912,0,1,192,225,-33
BR1_2719339375,6,False,0,0,0,15818,164,52,6.8,False,8,True,1,1,0,17170,202,56,7.0,True,28.471033333333335,-1352,-2,-1,216,258,-42
BR1_2715885624,8,False,0,0,0,16627,132,36,6.4,False,13,True,0,0,0,18336,146,52,7.0,True,28.570933333333333,-1709,-5,0,168,198,-30
BR1_2715642417,9,True,0,0,0,15840,124,28,6.0,False,14,False,0,0,0,19217,181,56,6.8,True,27.158883333333332,-3377,-5,0,152,237,-85
BR1_2723390666,1,False,1,0,0,13871,202,64,7.4,False,6,True,0,1,0,16783,208,64,7.4,True,29.4189,-2912,-5,1,266,272,-6
BR1_2721920663,2,True,1,0,0,12908,130,44,6.8,False,2,False,0,0,0,13679,175,44,6.8,True,27.068166666666666,-771,0,1,174,219,-45
BR1_2718500693,12,True,1,0,0,18955,177,52,6.8,True,7,False,0,1,0,15081,125,46,6.2,False,26.919816666666666,3874,5,1,229,171,58
BR1_2717283102,7,True,0,1,0,18149,201,28,6.8,False,14,False,0,0,0,20814,209,44,7.0,True,28.738483333333335,-2665,-7,0,229,253,-24
BR1_2718652653,4,True,1,0,0,14332,203,56,6.8,False,2,False,0,0,0,12730,154,42,6.4,True,25.936633333333333,1602,2,1,259,196,63
BR1_2691905503,5,True,0,0,0,15288,189,44,6.6,True,4,False,0,1,0,14812,199,64,6.8,False,27.068433333333335,476,1,0,233,263,-30
BR1_2729525091,9,True,0,0,0,17730,221,40,6.8,True,2,False,0,0,0,13326,172,60,6.6,False,27.046116666666666,4404,7,0,261,232,29
BR1_2729493920,7,False,1,0,0,16377,193,53,7.0,True,2,True,0,1,0,12426,111,38,5.8,False,26.683683333333335,3951,5,1,246,149,97
BR1_2714467593,8,False,1,0,0,16154,183,52,6.6,True,7,True,0,0,0,14721,154,40,6.4,False,25.327133333333332,1433,1,1,235,194,41
BR1_2713860843,4,False,1,1,0,17039,230,60,7.6,True,2,True,0,0,0,15307,214,60,7.6,False,27.722016666666665,1732,2,1,290,274,16
BR1_2713834924,5,False,0,1,0,15207,191,60,6.8,False,4,True,0,0,0,14515,191,56,6.8,True,25.6626,692,1,0,251,247,4
BR1_2729358806,3,False,0,0,0,14045,146,52,7.0,False,7,True,1,0,0,16837,199,60,7.4,True,27.541483333333332,-2792,-4,-1,198,259,-61
BR1_2726874902,11,True,1,0,0,19032,217,44,7.2,True,6,False,0,1,0,17278,185,56,7.2,False,29.429233333333332,1754,5,1,261,241,20
BR1_2726729423,4,True,1,0,0,13893,167,48,6.6,False,4,False,0,1,0,15766,190,52,7.0,True,27.206716666666665,-1873,0,1,215,242,-27
BR1_2725912958,7,True,1,0,0,16126,198,60,6.8,True,6,False,0,0,0,14919,140,40,6.6,False,25.18495,1207,1,1,258,180,78
BR1_2722215671,5,False,1,1,0,16550,185,68,7.2,True,2,True,0,0,0,15216,184,60,7.2,False,29.386416666666666,1334,3,1,253,244,9
BR1_2715492068,9,True,1,1,0,19119,189,36,6.6,False,14,False,0,0,0,20706,167,60,7.4,True,28.960616666666667,-1587,-5,1,225,227,-2
BR1_2731623772,5,False,0,0,0,13246,174,0,6.2,False,17,True,1,1,0,16502,162,52,6.8,True,25.0086,-3256,-12,-1,174,214,-40
BR1_2726384282,3,True,1,1,0,14701,184,52,6.6,False,2,False,0,0,0,13919,190,44,6.6,True,26.09455,782,1,1,236,234,2
BR1_2724223547,4,False,0,1,0,14658,157,48,7.0,False,12,True,1,0,0,19745,190,60,7.2,True,29.167933333333334,-5087,-8,-1,205,250,-45
BR1_2726250238,6,True,1,1,0,18346,226,52,7.0,True,4,False,0,0,0,14340,150,48,6.6,False,27.076866666666668,4006,2,1,278,198,80
BR1_2726225229,4,False,1,0,0,14020,178,60,6.8,True,4,True,0,0,0,13886,147,47,6.8,False,26.781033333333333,134,0,1,238,194,44
BR1_2726047333,9,True,0,0,0,17204,183,33,7.0,True,6,False,0,0,0,15630,180,58,6.8,False,27.184866666666668,1574,3,0,216,238,-22
BR1_2722812878,10,True,0,0,0,16266,177,32,6.4,True,8,False,0,0,0,16367,149,56,6.8,False,26.059566666666665,-101,2,0,209,205,4
BR1_2699642255,2,True,1,0,0,14825,176,60,7.4,True,0,False,0,0,0,12214,159,60,6.4,False,26.693816666666667,2611,2,1,236,219,17
BR1_2721396339,10,True,0,0,0,17048,179,12,6.8,True,8,False,1,1,0,17927,205,56,7.4,False,29.123383333333333,-879,2,-1,191,261,-70
BR1_2721111185,2,False,0,0,0,14857,199,60,7.0,True,6,True,1,1,0,17333,216,60,7.4,False,28.620783333333332,-2476,-4,-1,259,276,-17
BR1_2730488493,8,True,0,1,0,16772,171,44,6.8,True,7,False,0,0,0,16167,174,48,6.6,False,25.175933333333333,605,1,0,215,222,-7
BR1_2724435174,6,True,0,1,0,15599,167,64,6.6,False,6,False,1,0,0,15746,170,56,6.8,True,26.6161,-147,0,-1,231,226,5
BR1_2730916759,5,False,0,1,0,17243,219,68,7.6,False,5,True,0,0,0,17442,224,64,7.2,True,28.3871,-199,0,0,287,288,-1
BR1_2730841153,6,True,0,0,0,16706,176,51,7.2,False,6,False,1,0,0,18801,242,68,7.6,True,28.130483333333334,-2095,0,-1,227,310,-83
BR1_2725943744,9,False,0,0,0,16881,162,56,7.0,False,11,True,1,1,0,18810,200,48,6.8,True,29.553583333333332,-1929,-2,-1,218,248,-30
BR1_2725911196,5,True,1,0,0,15179,159,56,6.4,False,7,False,0,1,0,15433,158,48,6.6,True,25.968533333333333,-254,-2,1,215,206,9
BR1_2731315979,7,True,0,0,0,17339,205,64,7.6,False,4,False,1,1,0,15786,203,60,7.2,True,29.264133333333334,1553,3,-1,269,263,6
BR1_2682586784,3,False,0,0,0,15411,237,28,7.0,True,8,True,0,1,0,18584,245,76,7.4,False,29.349733333333333,-3173,-5,0,265,321,-56
BR1_2710403005,8,False,0,0,0,17452,186,52,7.2,True,3,True,0,0,0,14022,171,40,6.8,False,28.2204,3430,5,0,238,211,27
BR1_2682159620,4,False,0,0,0,14426,216,36,6.6,False,7,True,1,1,0,16340,194,44,7.0,True,25.799683333333334,-1914,-3,-1,252,238,14
BR1_2731302095,5,False,0,0,0,16356,214,36,7.2,False,5,True,1,1,0,17041,197,48,7.0,True,28.123866666666668,-685,0,-1,250,245,5
BR1_2730704968,5,False,1,0,0,16343,175,60,7.2,True,5,True,0,0,0,14912,155,28,6.4,False,29.21463333333333,1431,0,1,235,183,52
BR1_2730750454,10,False,0,0,0,17690,155,40,7.2,True,11,True,1,0,0,19076,204,36,7.0,False,29.04555,-1386,-1,-1,195,240,-45
BR1_2730369185,7,True,0,0,0,16861,197,48,6.8,True,5,False,1,0,0,14744,166,56,6.8,False,26.53695,2117,2,-1,245,222,23
BR1_2730352846,3,True,0,0,0,14702,189,40,6.8,False,5,False,1,1,0,17775,235,64,7.0,True,29.197116666666666,-3073,-2,-1,229,299,-70
BR1_2730332700,4,False,0,0,0,15277,193,56,7.0,False,8,True,1,0,0,16737,215,48,7.2,True,28.128916666666665,-1460,-4,-1,249,263,-14
BR1_2698937013,7,False,0,0,0,16127,166,52,7.0,True,6,True,0,0,0,16341,194,44,6.8,False,25.317083333333333,-214,1,0,218,238,-20
BR1_2724442284,7,False,0,1,0,16679,194,32,6.8,False,11,True,0,0,0,19407,223,64,7.6,True,28.161,-2728,-4,0,226,287,-61
BR1_2724197813,6,False,1,0,0,15074,126,41,6.0,True,7,True,0,0,0,16230,167,50,6.6,False,26.60935,-1156,-1,1,167,217,-50
BR1_2728529810,6,False,1,0,0,16530,180,65,7.0,False,7,True,0,1,0,16943,198,58,7.0,True,29.047716666666666,-413,-1,1,245,256,-11
BR1_2695798197,8,True,1,1,0,16734,155,60,7.0,True,1,False,0,0,0,12922,157,52,6.6,False,25.18685,3812,7,1,215,209,6
BR1_2726400349,10,True,0,0,0,18487,201,48,7.2,False,8,False,1,1,0,18840,205,56,7.0,True,29.987783333333333,-353,2,-1,249,261,-12
BR1_2728600347,12,True,0,1,0,20477,183,52,7.2,True,5,False,1,0,0,16586,177,52,6.6,False,29.751366666666666,3891,7,-1,235,229,6
BR1_2675976543,8,True,1,0,0,18257,227,68,7.6,True,1,False,0,0,0,14348,193,60,6.8,False,29.56235,3909,7,1,295,253,42
BR1_2675951885,4,False,0,0,0,15895,196,64,6.8,True,7,True,1,1,0,17232,210,56,7.4,False,28.181716666666667,-1337,-3,-1,260,266,-6
BR1_2729979280,12,False,1,0,0,20418,245,56,7.8,False,9,True,0,0,0,17900,226,44,7.4,True,29.528366666666667,2518,3,1,301,270,31
BR1_2730453611,3,False,0,0,0,13539,158,40,6.4,True,7,True,1,0,0,16031,164,60,6.6,False,25.216866666666668,-2492,-4,-1,198,224,-26
BR1_2731635245,12,True,1,0,0,17937,170,52,6.8,False,8,False,0,1,0,18021,174,52,7.4,True,28.729166666666668,-84,4,1,222,226,-4
BR1_2724844146,5,False,1,1,0,15302,176,62,7.4,True,3,True,0,0,0,16056,228,48,7.6,False,28.4988,-754,2,1,238,276,-38
BR1_2728318920,7,False,1,0,0,15552,180,48,6.8,False,12,True,0,1,0,17136,171,56,6.8,True,26.730766666666668,-1584,-5,1,228,227,1
BR1_2728271704,8,True,1,1,0,18053,224,60,7.6,True,6,False,0,0,0,16709,199,60,7.4,False,29.56465,1344,2,1,284,259,25
BR1_2719062029,11,True,1,1,0,19190,190,60,7.4,True,2,False,0,0,0,15037,171,44,6.8,False,27.809433333333335,4153,9,1,250,215,35
BR1_2707495190,2,True,1,0,0,13564,168,45,6.6,False,3,False,0,0,0,15014,226,52,6.8,True,26.051116666666665,-1450,-1,1,213,278,-65
BR1_2707457917,8,True,0,0,0,18219,226,44,7.4,False,12,False,1,1,0,19274,222,60,7.4,True,28.018633333333334,-1055,-4,-1,270,282,-12
BR1_2724901299,5,False,0,0,0,13610,153,28,6.0,False,7,True,1,0,0,16350,203,60,7.0,True,25.434916666666666,-2740,-2,-1,181,263,-82
BR1_2679359404,9,False,0,0,0,17091,192,48,7.0,True,8,True,0,0,0,16385,164,44,6.6,False,25.770583333333335,706,1,0,240,208,32
BR1_2705914755,6,True,0,1,0,16606,196,44,6.8,True,6,False,0,0,0,15929,165,56,7.0,False,27.641733333333335,677,0,0,240,221,19
BR1_2712886353,3,False,0,0,0,13945,155,44,6.6,False,11,True,1,0,0,18179,173,64,7.2,True,25.1824,-4234,-8,-1,199,237,-38
BR1_2721037953,10,False,0,0,0,17195,193,40,7.4,True,8,True,0,1,0,18262,225,44,7.2,False,29.188916666666668,-1067,2,0,233,269,-36
BR1_2731483772,12,True,1,1,0,19019,176,64,7.0,True,3,False,0,0,0,13682,161,56,6.0,False,27.32985,5337,9,1,240,217,23
BR1_2730950307,8,True,1,0,0,16129,162,42,6.2,True,6,False,0,0,0,15124,172,38,6.6,False,25.99245,1005,2,1,204,210,-6
BR1_2729572682,8,True,0,1,0,15372,160,36,6.4,False,7,False,1,0,0,17034,190,64,6.6,True,26.752033333333333,-1662,1,-1,196,254,-58
BR1_2708104470,3,False,1,0,0,14417,203,48,6.8,True,5,True,0,0,0,14573,144,51,6.4,False,26.65845,-156,-2,1,251,195,56
BR1_2717141719,5,True,0,1,0,17311,221,48,7.0,True,9,False,1,0,0,17258,174,60,6.8,False,28.2327,53,-4,-1,269,234,35
BR1_2727792726,6,False,1,0,0,16126,177,36,6.6,False,7,True,0,0,1,17905,173,60,7.0,True,28.41845,-1779,-1,1,213,233,-20
BR1_2727774838,6,True,0,0,0,14439,153,44,7.0,False,3,False,1,0,0,13872,163,48,6.6,True,26.135533333333335,567,3,-1,197,211,-14
BR1_2697641970,12,True,0,1,0,19215,197,67,7.2,False,11,False,1,0,0,19518,195,52,6.6,True,28.000966666666667,-303,1,-1,264,247,17
BR1_2697280411,8,True,1,1,0,18339,177,48,7.2,True,3,False,0,0,0,15118,190,64,7.0,False,28.809116666666668,3221,5,1,225,254,-29
BR1_2697261974,10,True,1,0,0,19637,209,84,7.6,True,6,False,0,1,0,16091,201,40,7.0,False,27.898116666666667,3546,4,1,293,241,52
BR1_2731165833,8,False,1,0,0,18118,220,56,7.2,False,10,True,0,0,0,19026,228,44,7.6,True,27.543333333333333,-908,-2,1,276,272,4
BR1_2730563131,3,False,0,0,1,12950,125,40,6.0,False,3,True,0,0,0,15292,158,40,6.4,True,25.09575,-2342,0,0,165,198,-33
BR1_2724074900,14,False,0,0,0,20847,208,38,7.2,True,9,True,1,0,0,18673,162,62,6.8,False,28.642783333333334,2174,5,-1,246,224,22
BR1_2718618319,7,True,0,0,0,15771,185,44,6.4,False,7,False,0,0,0,15636,147,44,6.4,True,26.027416666666667,135,0,0,229,191,38
BR1_2731621200,5,True,1,0,0,16282,235,56,7.4,True,7,False,0,1,0,18566,203,60,7.2,False,28.0514,-2284,-2,1,291,263,28
BR1_2694795098,6,False,0,0,0,15062,188,48,6.4,False,10,True,1,0,0,16990,177,60,6.8,True,26.31055,-1928,-4,-1,236,237,-1
BR1_2694353694,4,False,0,1,0,14854,173,68,7.0,True,3,True,1,0,0,14905,188,60,6.8,False,25.63693333333333,-51,1,-1,241,248,-7
BR1_2674408171,5,True,0,0,0,16193,163,64,7.0,True,7,False,1,0,0,15901,169,52,7.2,False,29.23005,292,-2,-1,227,221,6
BR1_2673837292,3,False,1,1,0,14276,161,60,7.0,False,7,True,0,0,0,16097,178,52,7.0,True,26.3647,-1821,-4,1,221,230,-9
BR1_2717341096,8,False,0,1,0,18022,194,68,7.4,True,6,True,1,0,0,18415,241,64,7.2,False,27.51685,-393,2,-1,262,305,-43
BR1_2664261303,8,False,0,1,0,17964,206,56,7.4,True,3,True,0,0,0,15151,185,52,7.0,False,29.576383333333332,2813,5,0,262,237,25
BR1_2730239961,3,False,0,0,0,13852,182,52,6.4,False,6,True,0,0,0,15989,219,48,7.0,True,27.259216666666667,-2137,-3,0,234,267,-33
BR1_2727495702,9,True,0,1,0,18726,194,56,7.4,False,10,False,1,0,0,18418,221,56,7.6,True,28.597933333333334,308,-1,-1,250,277,-27
BR1_2730247194,11,True,1,0,0,18290,193,36,7.0,False,10,False,0,0,0,19448,202,32,6.6,True,28.32355,-1158,1,1,229,234,-5
BR1_2731639238,3,True,0,0,0,13196,143,40,6.0,False,7,False,1,1,0,15988,174,56,6.8,True,25.078333333333333,-2792,-4,-1,183,230,-47
BR1_2730745703,4,True,1,1,0,14824,154,80,7.2,False,5,False,0,0,0,15257,182,36,6.6,True,27.1344,-433,-1,1,234,218,16
BR1_2730312166,6,True,0,0,0,16025,170,44,7.0,False,9,False,1,0,0,17439,145,64,6.8,True,27.559316666666668,-1414,-3,-1,214,209,5
BR1_2685819943,8,True,1,0,0,16080,179,52,6.8,True,5,False,0,0,0,14426,163,52,6.6,False,26.285966666666667,1654,3,1,231,215,16
BR1_2685797588,7,True,1,0,0,15834,223,40,7.0,True,1,False,0,0,0,13051,178,52,6.6,False,25.4881,2783,6,1,263,230,33
BR1_2690294343,9,False,0,1,0,17078,196,44,6.6,True,4,True,1,0,0,14051,159,51,6.4,False,25.87745,3027,5,-1,240,210,30
BR1_2726420054,8,True,0,0,0,16752,182,52,6.8,False,7,False,0,0,0,15755,205,40,6.8,True,26.609266666666667,997,1,0,234,245,-11
BR1_2700111435,8,True,1,0,0,17947,174,52,7.2,False,2,False,0,0,0,14333,201,32,6.6,True,28.4572,3614,6,1,226,233,-7
BR1_2692814335,5,False,0,0,0,14916,184,48,6.4,False,10,True,1,0,0,15920,151,48,6.6,True,25.69395,-1004,-5,-1,232,199,33
BR1_2730321920,4,False,1,0,0,17373,224,52,7.4,False,7,True,0,0,0,18567,238,56,7.4,True,28.07075,-1194,-3,1,276,294,-18
BR1_2730292286,6,False,0,1,0,18484,240,51,7.8,True,8,True,0,0,0,17528,170,48,7.2,False,28.689916666666665,956,-2,0,291,218,73
BR1_2729128456,4,False,0,0,0,14432,158,48,6.6,False,12,True,1,0,0,17443,157,44,6.6,True,25.621416666666665,-3011,-8,-1,206,201,5
BR1_2728087724,6,False,0,0,0,17567,206,48,7.2,False,8,True,0,0,0,18250,212,60,7.4,True,27.74651666666667,-683,-2,0,254,272,-18
BR1_2731415170,6,False,0,0,0,16821,190,58,7.4,True,7,True,1,0,0,16811,187,44,7.0,False,27.797016666666668,10,-1,-1,248,231,17
BR1_2731561502,2,False,0,0,0,13951,203,39,6.6,False,5,True,0,0,0,16131,184,40,6.8,True,25.851183333333335,-2180,-3,0,242,224,18
BR1_2731700915,6,True,1,0,0,15325,146,44,6.6,False,11,False,0,0,0,17883,212,48,7.0,True,25.11795,-2558,-5,1,190,260,-70
BR1_2731580465,7,True,0,0,0,15792,153,48,6.4,False,9,False,1,0,0,16649,161,52,6.6,True,27.18545,-857,-2,-1,201,213,-12
BR1_2685586931,7,False,1,1,0,18387,237,52,7.6,True,6,True,0,0,0,17563,244,35,7.4,False,28.387633333333333,824,1,1,289,279,10
BR1_2685573035,5,False,0,0,0,14104,155,37,6.4,False,5,True,0,0,0,16375,213,40,7.0,True,27.117083333333333,-2271,0,0,192,253,-61
BR1_2728725000,8,False,1,0,0,17697,205,60,7.2,True,9,True,0,0,0,18980,235,60,7.2,False,27.8553,-1283,-1,1,265,295,-30
BR1_2723156670,4,False,0,0,0,14949,200,52,6.8,True,2,True,0,0,0,15018,207,60,7.2,False,29.82075,-69,2,0,252,267,-15
BR1_2723081598,15,True,1,0,0,19028,188,44,7.0,True,4,False,0,1,0,16449,176,52,7.0,False,29.110566666666667,2579,11,1,232,228,4
BR1_2723434700,5,False,0,0,0,14518,176,46,6.8,False,4,True,1,0,0,13802,144,56,6.4,True,26.702633333333335,716,1,-1,222,200,22
BR1_2716849861,7,True,0,1,0,17266,179,44,7.0,False,8,False,1,0,0,17241,225,52,7.2,True,29.526783333333334,25,-1,-1,223,277,-54
BR1_2731368388,3,False,1,0,0,14765,185,48,6.6,True,3,True,0,0,0,14449,173,55,6.8,False,27.1227,316,0,1,233,228,5
BR1_2725788308,6,False,0,1,0,18293,208,72,7.2,True,9,True,1,0,0,18289,197,60,7.0,False,28.7086,4,-3,-1,280,257,23
BR1_2725756247,9,True,0,1,0,17915,203,44,7.2,False,9,False,1,0,0,19175,208,52,7.2,True,29.245183333333333,-1260,0,-1,247,260,-13
BR1_2670805272,3,True,0,0,0,14840,199,60,6.8,False,6,False,1,0,0,16314,196,40,7.0,True,25.793783333333334,-1474,-3,-1,259,236,23
BR1_2670265271,9,False,0,1,1,19333,200,52,7.4,False,9,True,1,0,0,17851,169,52,7.6,True,29.90075,1482,0,-1,252,221,31
BR1_2715159947,2,False,0,0,0,13114,164,37,6.6,False,7,True,0,0,0,16759,206,62,7.2,True,26.4282,-3645,-5,0,201,268,-67
BR1_2715113199,4,True,0,1,0,14620,160,55,6.4,True,4,False,1,0,0,14618,175,52,6.8,False,26.689666666666668,2,0,-1,215,227,-12
BR1_2689686537,6,False,0,0,0,16628,190,56,7.4,False,7,True,1,1,0,17438,183,60,7.4,True,28.500233333333334,-810,-1,-1,246,243,3
BR1_2689665671,8,False,0,0,0,18208,204,50,7.4,False,3,True,1,0,0,14780,190,38,7.2,True,29.9838,3428,5,-1,254,228,26
BR1_2696358538,12,False,0,0,0,16961,109,48,6.6,False,8,True,1,0,0,18081,198,52,6.8,True,25.443683333333333,-1120,4,-1,157,250,-93
BR1_2724599804,4,True,1,0,0,14285,167,52,6.4,False,8,False,0,0,0,17389,158,68,7.0,True,26.427016666666667,-3104,-4,1,219,226,-7
BR1_2724083098,3,False,0,0,0,13073,134,36,6.4,False,9,True,1,0,0,17757,172,68,6.8,True,26.0431,-4684,-6,-1,170,240,-70
BR1_2730733830,3,False,0,0,0,15523,214,48,7.2,False,9,True,0,1,0,19027,186,52,7.2,True,27.6521,-3504,-6,0,262,238,24
BR1_2730708053,4,True,0,0,0,15298,191,52,6.8,False,10,False,1,0,0,18800,223,48,7.4,True,28.715833333333332,-3502,-6,-1,243,271,-28
BR1_2730679410,8,False,1,0,0,17733,194,45,7.0,True,8,True,0,1,0,19479,238,58,7.4,False,29.594616666666667,-1746,0,1,239,296,-57
BR1_2726710327,10,True,1,0,0,18263,189,56,6.8,True,8,False,0,1,0,17181,191,44,7.0,False,28.250083333333333,1082,2,1,245,235,10
BR1_2708329045,8,False,1,0,0,17632,202,48,7.0,False,11,True,0,0,0,17437,174,58,7.2,True,29.49575,195,-3,1,250,232,18
BR1_2705016922,14,True,1,1,0,20547,173,56,7.4,True,4,False,0,0,0,14665,159,32,6.2,False,29.089016666666666,5882,10,1,229,191,38
BR1_2731271716,7,False,1,0,0,16103,209,44,7.0,True,5,True,0,0,0,14548,180,44,6.4,False,26.766466666666666,1555,2,1,253,224,29
BR1_2712721123,6,False,0,0,0,15912,171,48,6.6,False,8,True,1,0,0,19026,237,60,7.6,True,29.14415,-3114,-2,-1,219,297,-78
BR1_2684235106,6,True,0,0,0,14919,188,30,6.8,True,1,False,0,0,0,13211,184,49,6.6,False,27.40865,1708,5,0,218,233,-15
BR1_2712214941,10,True,1,1,0,19054,218,67,7.2,True,5,False,0,0,0,15317,177,40,6.8,False,27.7691,3737,5,1,285,217,68
BR1_2731012271,7,True,1,0,0,16734,152,56,7.0,True,10,False,0,1,0,19028,169,64,7.6,False,29.4697,-2294,-3,1,208,233,-25
BR1_2728812600,11,True,1,0,0,18664,170,44,7.0,False,6,False,0,1,0,16428,176,60,7.0,True,29.816283333333335,2236,5,1,214,236,-22
BR1_2702243697,3,False,0,0,0,14408,163,32,6.6,False,17,True,1,1,0,18945,165,60,7.4,True,28.689233333333334,-4537,-14,-1,195,225,-30
BR1_2716653043,9,False,0,0,0,16823,162,56,6.8,False,8,True,1,0,0,16266,168,52,6.6,True,26.979633333333332,557,1,-1,218,220,-2
BR1_2724088137,1,False,0,0,0,13056,174,44,6.6,False,5,True,1,0,0,14790,184,48,6.6,True,26.300366666666665,-1734,-4,-1,218,232,-14
BR1_2724061535,14,True,1,1,0,19661,182,51,7.0,True,7,False,0,0,0,16805,166,43,6.6,False,27.56795,2856,7,1,233,209,24
BR1_2710663915,6,False,0,0,0,16793,162,52,7.2,False,14,True,0,1,0,20454,217,56,7.4,True,27.762166666666666,-3661,-8,0,214,273,-59
BR1_2731715768,7,False,1,0,0,18353,233,68,7.8,True,4,True,0,0,0,15373,185,60,7.6,False,29.590966666666667,2980,3,1,301,245,56
BR1_2731374395,11,False,0,0,0,17589,163,36,6.2,False,15,True,1,0,0,20222,211,44,6.8,True,26.9819,-2633,-4,-1,199,255,-56
BR1_2726426664,11,True,1,1,0,18714,196,44,6.8,True,6,False,0,0,0,14910,172,48,6.4,False,26.891783333333333,3804,5,1,240,220,20
BR1_2671752203,5,False,0,0,0,15065,169,54,7.4,False,3,True,0,0,0,14702,195,48,7.0,True,26.194366666666667,363,2,0,223,243,-20
BR1_2671689722,7,True,0,1,0,17265,190,48,7.4,False,11,False,1,0,0,18529,200,60,7.4,True,29.544616666666666,-1264,-4,-1,238,260,-22
BR1_2730167185,3,False,1,1,0,15170,179,56,6.6,False,8,True,0,0,0,17442,164,76,7.2,True,28.462866666666667,-2272,-5,1,235,240,-5
BR1_2725686674,4,False,1,0,0,13712,155,48,6.2,False,3,True,0,1,0,16830,245,44,7.4,True,26.899233333333335,-3118,1,1,203,289,-86
BR1_2725426507,10,True,0,0,0,21145,245,65,7.6,False,9,False,0,0,0,17593,161,50,6.8,True,28.68375,3552,1,0,310,211,99
BR1_2716226808,12,True,2,0,0,18006,177,52,7.2,True,4,False,0,0,0,15713,201,48,6.8,False,28.16871666666667,2293,8,2,229,249,-20
BR1_2714602925,11,False,0,0,0,16702,143,52,6.4,False,13,True,0,0,0,18602,162,52,7.0,True,26.99975,-1900,-2,0,195,214,-19
BR1_2720976740,7,True,0,0,0,15908,184,51,7.0,True,7,False,1,0,0,17359,202,48,7.0,False,29.001583333333333,-1451,0,-1,235,250,-15
BR1_2731478046,4,True,1,0,0,14468,176,39,6.2,False,6,False,0,1,0,14103,121,44,6.4,True,26.408783333333332,365,-2,1,215,165,50
BR1_2728024592,6,False,0,0,0,15110,155,58,6.6,True,7,True,0,1,0,16504,179,40,6.6,False,25.542266666666666,-1394,-1,0,213,219,-6
BR1_2727952000,7,False,1,0,0,15636,139,40,6.8,False,5,True,0,0,0,14642,186,59,6.4,True,26.6057,994,2,1,179,245,-66
BR1_2719342520,7,True,0,0,0,15963,178,44,6.6,True,7,False,1,0,0,13905,125,40,6.2,False,25.676316666666665,2058,0,-1,222,165,57
BR1_2731719166,6,False,1,0,0,15536,141,60,7.0,False,7,True,0,1,0,16691,192,44,7.2,True,28.508916666666668,-1155,-1,1,201,236,-35
BR1_2730746810,6,False,0,0,0,15531,173,48,6.8,False,10,True,1,0,0,17266,189,56,7.0,True,25.10696666666667,-1735,-4,-1,221,245,-24
BR1_2729490776,7,False,0,1,0,16631,193,52,6.8,False,9,True,1,0,0,16963,161,68,6.8,True,25.999366666666667,-332,-2,-1,245,229,16
BR1_2719362452,7,False,0,0,0,15456,142,52,6.6,False,5,True,1,0,0,14801,205,48,6.6,True,27.112466666666666,655,2,-1,194,253,-59
BR1_2719330023,4,False,0,0,0,14695,135,52,7.0,False,4,True,1,0,0,17778,230,72,7.6,True,29.5333,-3083,0,-1,187,302,-115
BR1_2730470282,10,True,0,0,0,17452,189,28,7.0,False,6,False,0,0,0,16217,198,52,6.8,True,28.833866666666665,1235,4,0,217,250,-33
BR1_2730020864,12,True,1,0,0,19119,201,60,7.6,True,7,False,0,1,0,18045,208,56,7.4,False,28.864566666666665,1074,5,1,261,264,-3
BR1_2729978597,9,True,1,0,0,19987,214,48,7.4,True,3,False,0,0,0,14412,195,32,6.8,False,29.92525,5575,6,1,262,227,35
BR1_2730239274,5,True,1,1,0,14425,160,40,6.4,False,9,False,0,0,0,17212,167,61,7.0,True,26.4164,-2787,-4,1,200,228,-28
BR1_2720968987,6,True,0,0,0,16521,201,52,7.2,False,10,False,1,0,0,19516,227,80,7.8,True,29.96515,-2995,-4,-1,253,307,-54
BR1_2726578552,11,False,1,0,0,16588,168,46,6.6,True,5,True,0,1,0,13980,122,56,6.4,False,26.7897,2608,6,1,214,178,36
BR1_2729989964,10,True,1,0,0,16593,146,48,6.4,False,7,False,0,0,0,16299,186,53,6.8,True,25.9711,294,3,1,194,239,-45
BR1_2718770536,7,True,1,0,0,15082,154,40,6.2,False,7,False,0,1,0,15609,174,44,6.2,True,27.478016666666665,-527,0,1,194,218,-24
BR1_2718707124,13,True,0,0,0,19290,167,44,7.2,True,4,False,1,1,0,15733,193,60,7.0,False,29.751683333333332,3557,9,-1,211,253,-42
BR1_2718454017,7,False,0,0,0,17132,210,48,7.0,False,10,True,1,1,0,19104,228,56,7.4,True,28.448933333333333,-1972,-3,-1,258,284,-26
BR1_2673680867,3,True,1,0,0,12049,140,40,6.6,True,6,False,0,1,0,16580,219,48,7.2,False,25.378283333333332,-4531,-3,1,180,267,-87
BR1_2713722266,5,True,1,0,0,16083,198,56,6.8,True,5,False,0,1,0,14354,157,52,6.8,False,27.40955,1729,0,1,254,209,45
BR1_2729750182,4,True,0,0,0,17022,212,45,7.0,False,7,False,0,0,0,17465,194,75,7.4,True,27.67645,-443,-3,0,257,269,-12
BR1_2713329459,8,True,1,1,0,17888,220,52,7.4,True,5,False,0,0,0,14552,154,48,6.8,False,29.88285,3336,3,1,272,202,70
BR1_2731194333,8,False,0,0,0,16659,158,52,7.2,False,9,True,1,0,0,17990,197,56,7.4,True,29.53525,-1331,-1,-1,210,253,-43
BR1_2728880538,10,True,0,0,0,17391,172,52,6.8,False,12,False,0,0,0,17766,172,40,6.8,True,26.659583333333334,-375,-2,0,224,212,12
BR1_2687446286,1,False,0,1,0,15042,207,60,7.2,False,6,True,1,0,0,18586,251,64,7.6,True,28.225283333333334,-3544,-5,-1,267,315,-48
BR1_2697437168,15,False,1,0,0,19813,179,48,7.0,True,12,True,0,1,0,20144,195,60,7.4,False,28.46535,-331,3,1,227,255,-28
BR1_2724432034,10,True,0,0,0,18450,195,60,7.0,False,16,False,1,1,0,20416,169,47,7.0,True,27.715333333333334,-1966,-6,-1,255,216,39
BR1_2724385272,3,True,0,0,0,16377,232,56,7.4,False,11,False,1,1,0,18703,206,71,7.6,True,28.5693,-2326,-8,-1,288,277,11
BR1_2701856838,6,False,0,1,0,16597,166,68,7.2,True,9,True,1,0,0,16770,163,60,7.2,False,27.9884,-173,-3,-1,234,223,11
BR1_2688749278,8,True,0,0,0,17640,209,52,7.2,False,6,False,1,1,0,16581,183,56,7.2,True,29.05245,1059,2,-1,261,239,22
BR1_2731062392,10,True,1,0,0,18575,208,44,7.2,True,6,False,0,0,0,16141,193,36,6.8,False,29.175683333333332,2434,4,1,252,229,23
BR1_2728790946,5,False,0,1,0,14639,122,52,6.0,False,10,True,1,0,0,18165,176,60,6.6,True,26.688,-3526,-5,-1,174,236,-62
BR1_2731315107,11,False,0,0,0,20605,180,64,7.0,True,10,True,0,1,0,18410,202,60,7.0,False,27.863533333333333,2195,1,0,244,262,-18
BR1_2731214793,4,False,0,0,0,13083,161,52,6.2,False,13,True,1,0,0,18540,194,36,6.8,True,26.425133333333335,-5457,-9,-1,213,230,-17
BR1_2730604745,15,True,1,1,0,21197,176,48,7.4,True,6,False,0,0,0,16371,174,52,6.4,False,29.68626666666667,4826,9,1,224,226,-2
BR1_2731265498,9,True,0,0,0,17087,179,51,7.2,True,8,False,0,0,0,14716,138,40,6.4,False,27.434,2371,1,0,230,178,52
BR1_2731226595,9,True,0,0,0,17421,134,44,6.8,True,8,False,0,0,0,17234,177,44,6.6,False,29.94255,187,1,0,178,221,-43
BR1_2713184911,8,True,1,1,0,17147,174,53,6.8,True,6,False,0,0,0,14847,176,36,6.8,False,25.6325,2300,2,1,227,212,15
BR1_2713166304,3,False,0,0,0,13504,146,48,6.4,False,8,True,1,0,0,15555,182,44,6.8,True,26.988033333333334,-2051,-5,-1,194,226,-32
BR1_2728019718,5,True,0,0,0,16666,227,49,7.0,True,8,False,1,0,0,17171,204,64,7.2,False,28.785033333333335,-505,-3,-1,276,268,8
BR1_2727996516,8,True,1,0,0,18508,196,76,7.2,True,4,False,0,0,0,15572,198,48,7.0,False,27.515533333333334,2936,4,1,272,246,26
BR1_2727223424,9,True,1,1,0,19627,222,72,7.6,True,3,False,0,0,0,14020,173,40,6.8,False,29.545033333333333,5607,6,1,294,213,81
BR1_2727170872,7,True,0,0,0,15903,191,48,6.8,False,6,False,0,0,0,15692,158,48,6.6,True,26.308633333333333,211,1,0,239,206,33
BR1_2727196784,9,True,0,0,0,14907,145,40,6.2,False,5,False,1,1,0,14927,155,53,6.6,True,26.91946666666667,-20,4,-1,185,208,-23
BR1_2689222808,4,False,0,1,0,15066,206,60,6.8,False,4,True,1,0,0,14081,190,56,6.6,True,27.201933333333333,985,0,-1,266,246,20
BR1_2731472104,6,True,1,1,0,17029,197,51,7.4,True,1,False,0,0,0,13210,146,56,6.8,False,28.025766666666666,3819,5,1,248,202,46
BR1_2703898395,0,False,0,0,0,13944,194,52,7.0,False,5,True,1,0,0,16538,210,68,7.4,True,29.610683333333334,-2594,-5,-1,246,278,-32
BR1_2727726829,4,False,0,0,0,14007,132,40,6.0,False,15,True,1,0,0,19397,153,64,7.0,True,29.678333333333335,-5390,-11,-1,172,217,-45
BR1_2731264701,6,True,1,0,0,14492,153,56,6.8,False,9,False,0,0,0,17362,193,52,6.8,True,27.05675,-2870,-3,1,209,245,-36
BR1_2728269125,10,True,1,0,0,17046,210,48,6.8,True,2,False,0,1,0,13556,170,44,6.4,False,25.755016666666666,3490,8,1,258,214,44
BR1_2728057085,11,False,1,1,0,18584,147,52,7.0,True,7,True,0,0,0,18150,224,52,7.0,False,29.778933333333335,434,4,1,199,276,-77
BR1_2689860716,10,True,1,0,0,17193,185,55,6.6,True,5,False,0,0,0,13827,139,44,6.6,False,25.140766666666668,3366,5,1,240,183,57
BR1_2689849171,7,True,1,0,0,18404,219,59,7.6,True,2,False,0,1,0,17236,257,60,7.4,False,28.512966666666667,1168,5,1,278,317,-39
BR1_2712332104,6,False,1,0,0,15426,151,36,6.4,False,8,True,0,1,0,19580,225,55,7.4,True,29.49345,-4154,-2,1,187,280,-93
BR1_2692081606,11,False,0,0,0,18166,189,52,7.0,False,9,True,0,0,0,18852,213,56,7.0,True,29.384233333333334,-686,2,0,241,269,-28
BR1_2714599073,5,False,0,0,0,15260,162,39,6.8,False,8,True,1,1,0,17957,196,64,7.4,True,28.184316666666668,-2697,-3,-1,201,260,-59
BR1_2695862503,4,True,0,0,0,15325,177,43,6.4,False,12,False,0,0,0,20273,229,60,7.6,True,29.077283333333334,-4948,-8,0,220,289,-69
BR1_2711263056,8,True,1,0,0,17424,159,52,7.0,True,7,False,0,0,0,16321,180,52,7.0,False,29.5981,1103,1,1,211,232,-21
BR1_2729997849,5,True,0,0,0,14988,158,42,6.8,False,6,False,1,0,0,16658,178,56,7.2,True,27.55785,-1670,-1,-1,200,234,-34
BR1_2731135303,7,True,0,0,0,16582,171,40,6.6,True,8,False,1,0,0,17674,175,56,7.0,False,29.83053333333333,-1092,-1,-1,211,231,-20
BR1_2731320759,11,True,0,0,0,18027,200,48,7.0,True,4,False,0,0,0,14435,147,48,6.4,False,26.259366666666665,3592,7,0,248,195,53
BR1_2661421114,9,True,0,1,0,16986,168,60,7.0,True,6,False,0,0,0,15305,165,64,6.8,False,25.8438,1681,3,0,228,229,-1
BR1_2712281316,6,True,0,1,0,17126,199,48,7.2,False,9,False,1,0,0,19412,206,68,7.2,True,29.254816666666667,-2286,-3,-1,247,274,-27
BR1_2711907694,9,True,1,1,0,18074,184,52,7.0,True,3,False,0,0,0,13003,136,34,6.2,False,27.069966666666666,5071,6,1,236,170,66
BR1_2694681933,8,False,1,0,0,16908,195,48,6.6,True,5,True,0,1,0,15566,165,52,6.6,False,25.207766666666668,1342,3,1,243,217,26
BR1_2731710905,3,False,1,1,0,15416,182,64,7.0,False,8,True,0,0,0,17960,189,40,7.2,True,29.966316666666668,-2544,-5,1,246,229,17
BR1_2716968529,8,True,1,0,0,18217,215,60,7.4,True,3,False,0,1,0,16187,198,56,7.2,False,28.425283333333333,2030,5,1,275,254,21
BR1_2730301430,6,True,0,0,0,13993,175,36,6.4,False,10,False,1,0,0,16222,162,35,6.4,True,26.6029,-2229,-4,-1,211,197,14
BR1_2731316152,3,False,0,0,0,15021,198,63,7.0,True,3,True,0,0,0,15539,205,60,6.8,False,26.446733333333334,-518,0,0,261,265,-4
BR1_2731204405,15,True,1,0,0,20835,198,50,7.6,True,8,False,0,0,0,18396,192,40,7.0,False,27.604683333333334,2439,7,1,248,232,16
BR1_2731414436,7,True,0,1,0,17330,218,64,7.2,True,4,False,0,0,0,15083,172,44,6.8,False,26.660083333333333,2247,3,0,282,216,66
BR1_2731403847,12,True,1,0,1,19948,186,55,6.8,True,5,False,0,0,0,15404,187,48,6.6,False,26.2872,4544,7,1,241,235,6
BR1_2692768743,6,True,0,0,0,15693,202,36,6.8,False,8,False,1,0,0,16101,206,40,6.8,True,27.455766666666666,-408,-2,-1,238,246,-8
BR1_2713512850,12,True,1,1,0,20442,254,60,7.8,True,3,False,0,0,0,16770,221,68,7.2,False,29.449533333333335,3672,9,1,314,289,25
BR1_2730201071,10,True,1,0,0,17467,191,64,7.0,True,5,False,0,0,0,16171,218,58,6.6,False,27.2765,1296,5,1,255,276,-21
BR1_2730142583,4,False,0,1,0,15414,214,56,7.0,True,4,True,1,0,0,15519,198,48,6.8,False,25.8171,-105,0,-1,270,246,24
BR1_2723893381,6,False,0,0,0,16452,195,52,7.2,False,12,True,1,0,0,21621,259,63,7.6,True,27.980033333333335,-5169,-6,-1,247,322,-75
BR1_2729524749,7,False,0,0,0,16861,191,68,6.8,True,7,True,0,1,0,16530,203,44,6.6,False,27.077066666666667,331,0,0,259,247,12
BR1_2728954208,10,False,1,1,0,19745,239,51,7.4,True,6,True,0,0,0,16189,183,52,6.6,False,29.85635,3556,4,1,290,235,55
BR1_2731749841,6,False,1,1,0,15808,179,68,7.2,True,5,True,0,0,0,15494,188,55,6.8,False,27.226783333333334,314,1,1,247,243,4
BR1_2729725425,4,False,0,0,0,13767,162,44,6.4,False,6,True,1,0,0,15628,204,52,6.8,True,26.2588,-1861,-2,-1,206,256,-50
BR1_2731622231,7,False,0,1,0,20108,265,76,7.4,True,5,True,1,0,0,16800,223,52,7.2,False,28.223533333333332,3308,2,-1,341,275,66
BR1_2724018170,4,False,0,0,0,14697,149,54,6.6,False,8,True,0,0,0,17148,216,58,7.2,True,25.094366666666666,-2451,-4,0,203,274,-71
BR1_2718219178,6,False,0,0,0,15768,199,64,7.0,False,7,True,0,0,0,16488,203,44,6.8,True,25.7521,-720,-1,0,263,247,16
BR1_2731049174,5,True,1,0,0,15253,194,60,6.8,False,3,False,0,1,0,15137,197,60,6.8,True,27.163933333333333,116,2,1,254,257,-3
BR1_2730752057,3,True,0,0,0,15337,194,52,7.0,False,10,False,1,0,0,19346,222,72,7.4,True,29.10445,-4009,-7,-1,246,294,-48
BR1_2730230659,8,True,0,0,0,17564,167,62,7.0,False,10,False,0,1,0,20181,226,68,7.6,True,27.930466666666668,-2617,-2,0,229,294,-65
BR1_2711330378,4,False,0,0,0,15391,176,65,6.8,False,10,True,0,0,0,16959,179,44,6.6,True,27.11085,-1568,-6,0,241,223,18
BR1_2709528542,5,False,0,0,0,18140,233,64,7.4,False,8,True,1,0,0,18147,237,56,7.4,True,28.670083333333334,-7,-3,-1,297,293,4
BR1_2731235089,6,False,0,1,0,17763,228,55,7.6,False,9,True,0,0,0,18802,218,59,7.2,True,29.9195,-1039,-3,0,283,277,6
BR1_2730314036,5,False,1,0,0,15988,213,60,7.6,False,5,True,0,0,0,17373,233,76,7.4,True,29.372466666666668,-1385,0,1,273,309,-36
BR1_2730162158,5,True,0,0,0,16711,222,48,7.0,True,4,False,0,1,0,16302,181,48,6.8,False,27.6452,409,1,0,270,229,41
BR1_2731587601,3,False,0,0,0,14176,181,56,6.4,True,6,True,0,0,0,15722,206,48,6.8,False,27.197133333333333,-1546,-3,0,237,254,-17
BR1_2731554480,7,False,0,0,0,18179,225,60,7.2,False,10,True,1,1,0,19544,221,56,7.2,True,29.8409,-1365,-3,-1,285,277,8
BR1_2731532852,7,True,1,1,0,17614,229,51,7.4,True,5,False,0,0,0,17505,261,64,7.6,False,28.357783333333334,109,2,1,280,325,-45
BR1_2731517533,2,False,0,1,0,15878,223,70,7.2,False,8,True,1,0,0,18520,259,52,7.6,True,29.764366666666668,-2642,-6,-1,293,311,-18
BR1_2731299664,8,True,0,1,0,18733,236,44,7.6,True,5,False,0,0,0,17688,217,62,7.6,False,29.861,1045,3,0,280,279,1
BR1_2731276442,10,False,0,0,0,16268,173,36,6.4,False,8,True,0,0,0,17302,227,48,7.0,True,25.203883333333334,-1034,2,0,209,275,-66
BR1_2731248823,6,False,0,0,0,16704,211,40,7.0,False,9,True,1,1,0,18521,222,52,7.2,True,27.6306,-1817,-3,-1,251,274,-23
BR1_2731204411,12,False,0,0,0,21789,237,68,7.6,True,5,True,1,0,0,16013,170,64,7.0,False,29.893733333333333,5776,7,-1,305,234,71
BR1_2731151266,6,True,0,0,0,15662,183,48,6.4,False,4,False,1,0,0,15470,207,60,7.0,True,25.727566666666668,192,2,-1,231,267,-36
BR1_2722991618,6,True,1,0,0,17246,187,46,7.4,False,13,False,0,0,0,20289,204,74,7.6,True,28.901466666666668,-3043,-7,1,233,278,-45
BR1_2731752491,6,False,0,1,0,15991,197,56,7.0,False,9,True,0,0,0,16981,197,44,6.4,True,25.454316666666667,-990,-3,0,253,241,12
BR1_2731728243,4,False,0,0,0,13981,164,44,6.4,False,9,True,1,0,0,18229,247,60,7.2,True,25.837316666666666,-4248,-5,-1,208,307,-99
BR1_2731676079,3,False,0,0,0,14119,187,48,6.6,True,7,True,1,1,0,16827,216,56,7.0,False,25.9665,-2708,-4,-1,235,272,-37
BR1_2728083820,8,True,0,0,0,16934,206,50,6.8,True,5,False,0,1,0,15990,217,66,7.2,False,26.319866666666666,944,3,0,256,283,-27
BR1_2687548269,6,False,0,1,0,16287,172,44,7.2,False,10,True,0,0,0,19014,212,60,7.2,True,29.067,-2727,-4,0,216,272,-56
BR1_2687493655,8,True,1,0,0,18539,245,50,7.2,True,6,False,0,1,0,17628,232,62,7.4,False,28.554466666666666,911,2,1,295,294,1
BR1_2687464819,6,True,0,1,0,16061,193,48,6.6,True,8,False,0,0,0,16152,193,52,6.8,False,26.572066666666668,-91,-2,0,241,245,-4
BR1_2731684033,6,False,0,0,0,17429,204,52,7.2,False,9,True,1,0,0,18033,202,52,7.0,True,27.979316666666666,-604,-3,-1,256,254,2
BR1_2731493059,9,True,1,1,0,18111,197,52,7.2,True,7,False,0,0,0,16741,200,44,6.8,False,27.216366666666666,1370,2,1,249,244,5
BR1_2731478325,13,False,1,0,1,22679,245,56,7.8,True,7,True,0,0,0,16347,167,44,6.8,False,28.514233333333333,6332,6,1,301,211,90
BR1_2722126696,4,False,0,0,0,14185,179,46,6.6,False,8,True,0,0,0,17022,207,62,7.2,True,25.7634,-2837,-4,0,225,269,-44
BR1_2731112610,4,False,0,0,0,15457,190,50,7.0,False,10,True,1,1,0,20134,233,76,7.2,True,28.64335,-4677,-6,-1,240,309,-69
BR1_2731577464,5,False,0,0,0,14494,171,48,6.4,True,8,True,1,0,0,16614,190,52,6.8,False,26.258916666666668,-2120,-3,-1,219,242,-23
BR1_2731562211,15,True,1,0,0,18674,170,48,7.2,True,5,False,0,0,0,15601,206,44,6.8,False,26.820633333333333,3073,10,1,218,250,-32
BR1_2706894208,8,True,1,0,0,15481,123,60,6.6,False,5,False,0,0,0,16351,203,48,6.8,True,26.9014,-870,3,1,183,251,-68
BR1_2726439142,6,True,0,1,0,17965,258,48,7.2,True,9,False,1,0,0,18102,208,76,7.4,False,28.591833333333334,-137,-3,-1,306,284,22
BR1_2725656158,4,True,0,0,0,16134,206,64,7.4,False,8,False,1,1,0,19252,244,76,7.6,True,29.0442,-3118,-4,-1,270,320,-50
BR1_2730692265,0,False,0,1,0,14983,232,60,7.2,False,5,True,0,0,0,16503,244,40,7.2,True,27.578566666666667,-1520,-5,0,292,284,8
BR1_2731196347,3,False,0,0,0,15123,233,40,7.4,True,7,True,1,1,0,17659,224,66,7.2,False,29.119366666666668,-2536,-4,-1,273,290,-17
BR1_2731163519,7,False,0,1,0,17347,228,56,7.0,True,5,True,1,0,0,15460,204,52,6.8,False,25.412916666666668,1887,2,-1,284,256,28
BR1_2729400119,6,True,1,0,0,16815,220,45,7.4,True,2,False,0,1,0,15242,189,58,7.2,False,29.256716666666666,1573,4,1,265,247,18
BR1_2726474477,9,False,1,1,0,15946,163,56,6.8,True,5,True,0,0,0,15158,162,56,6.4,False,27.125666666666667,788,4,1,219,218,1
BR1_2695392156,5,False,0,0,0,14708,198,35,6.0,False,8,True,0,0,0,17020,224,48,6.8,True,25.765766666666668,-2312,-3,0,233,272,-39
BR1_2731313658,8,True,0,0,0,17369,202,64,6.8,True,12,False,0,0,0,17565,172,32,6.6,False,26.658433333333335,-196,-4,0,266,204,62
BR1_2731546260,9,False,1,0,0,17852,205,59,7.4,False,10,True,0,1,0,19001,197,76,7.4,True,29.131433333333334,-1149,-1,1,264,273,-9
BR1_2731515261,10,False,0,0,1,21293,229,44,7.2,True,9,True,1,1,0,18176,195,60,7.2,False,28.782633333333333,3117,1,-1,273,255,18
BR1_2731464399,2,False,0,0,0,14561,211,52,7.0,False,7,True,1,0,0,17029,187,56,7.0,True,27.6311,-2468,-5,-1,263,243,20
BR1_2731382183,7,False,0,0,0,17751,211,52,6.8,True,6,True,0,0,0,15890,200,55,6.8,False,26.286433333333335,1861,1,0,263,255,8
BR1_2722312030,15,True,1,0,0,20183,159,60,7.0,False,11,False,0,0,1,20827,232,44,7.0,True,29.33805,-644,4,1,219,276,-57
BR1_2727590370,3,False,0,0,0,14910,222,52,7.0,False,7,True,0,0,0,16135,182,64,7.0,True,26.3384,-1225,-4,0,274,246,28
BR1_2731736951,5,True,0,1,0,15295,143,51,6.6,False,7,False,1,0,0,17881,194,72,7.2,True,27.654733333333333,-2586,-2,-1,194,266,-72
BR1_2731516857,15,True,1,0,1,20392,194,52,6.8,True,5,False,0,0,0,16047,176,44,6.6,False,25.375283333333332,4345,10,1,246,220,26
BR1_2696088901,8,False,1,0,0,17404,207,48,6.8,False,10,True,0,0,0,17240,180,64,7.0,True,27.027816666666666,164,-2,1,255,244,11
BR1_2696051240,6,True,0,0,0,18135,233,56,7.6,True,5,False,0,1,0,16282,204,52,7.4,False,28.317783333333335,1853,1,0,289,256,33
BR1_2731631260,7,False,1,0,0,16079,198,64,6.8,False,10,True,0,0,0,18729,218,48,6.6,True,27.411933333333334,-2650,-3,1,262,266,-4
BR1_2731378193,10,True,0,0,0,16882,164,47,6.4,False,10,False,0,0,0,18376,187,56,6.8,True,25.02135,-1494,0,0,211,243,-32
BR1_2731711823,4,True,0,0,0,16193,253,52,7.6,False,4,False,1,0,0,17042,257,70,7.6,True,29.157916666666665,-849,0,-1,305,327,-22
BR1_2725178754,4,True,1,0,0,14873,189,56,6.8,True,2,False,0,0,0,13751,185,48,6.8,False,25.921866666666666,1122,2,1,245,233,12
BR1_2712365074,14,True,1,1,0,20250,192,72,7.6,True,4,False,0,0,0,17331,225,56,7.0,False,28.11655,2919,10,1,264,281,-17
BR1_2731359604,8,False,0,0,0,16070,211,60,7.0,True,7,True,1,1,0,18474,233,64,7.6,False,27.6952,-2404,1,-1,271,297,-26
BR1_2714872902,1,False,0,0,0,13690,205,44,6.8,False,3,True,1,0,0,15158,221,52,6.8,True,27.110716666666665,-1468,-2,-1,249,273,-24
BR1_2700049161,7,False,0,1,0,18416,235,71,7.2,False,9,True,1,0,0,19945,271,63,7.6,True,28.278833333333335,-1529,-2,-1,306,334,-28
BR1_2685564260,5,True,0,1,0,15483,174,56,6.8,False,7,False,1,0,1,17343,211,50,7.4,True,27.339916666666667,-1860,-2,-1,230,261,-31
BR1_2723254190,7,False,0,1,0,18330,239,75,7.8,True,4,True,0,0,0,16533,235,52,7.4,False,28.76385,1797,3,0,314,287,27
BR1_2731238536,6,False,0,0,0,15854,207,56,6.8,True,9,True,1,0,0,16211,180,44,6.6,False,26.616833333333332,-357,-3,-1,263,224,39
BR1_2728620078,10,True,1,0,0,19987,268,44,7.2,False,5,False,0,1,0,17807,200,64,7.2,True,27.626783333333332,2180,5,1,312,264,48
BR1_2731331579,5,False,1,0,0,16008,193,60,6.4,False,9,True,0,0,0,17164,222,52,7.0,True,27.088916666666666,-1156,-4,1,253,274,-21
BR1_2723524606,5,True,0,1,0,16811,221,56,7.0,True,2,False,0,0,0,14731,236,47,6.8,False,25.8191,2080,3,0,277,283,-6
BR1_2731430392,3,True,0,0,0,15528,191,52,7.2,False,6,False,1,0,0,17839,219,76,7.2,True,27.983116666666668,-2311,-3,-1,243,295,-52
BR1_2731094919,8,False,0,1,0,17360,181,52,6.6,False,15,True,1,0,0,20008,189,52,7.0,True,27.287216666666666,-2648,-7,-1,233,241,-8
BR1_2722887564,4,False,0,0,0,15776,220,56,7.0,False,10,True,0,1,0,19307,225,52,7.4,True,27.888866666666665,-3531,-6,0,276,277,-1
BR1_2722602086,8,True,0,0,0,17191,224,50,7.0,False,7,False,0,0,0,16747,192,45,6.8,True,26.103466666666666,444,1,0,274,237,37
BR1_2730694005,8,True,1,0,0,17881,231,48,7.0,True,6,False,0,0,0,16510,208,56,7.0,False,27.147516666666668,1371,2,1,279,264,15
BR1_2697895515,3,True,0,0,0,16589,236,54,7.2,True,2,False,1,0,0,14933,179,52,6.6,False,27.922866666666668,1656,1,-1,290,231,59
BR1_2729883496,6,True,1,0,0,16139,205,68,7.2,True,5,False,0,1,0,15629,202,52,6.8,False,25.68648333333333,510,1,1,273,254,19
BR1_2729864836,3,False,0,0,0,14379,200,48,6.4,False,6,True,1,0,0,15706,197,52,6.4,True,25.1456,-1327,-3,-1,248,249,-1
BR1_2731393161,6,False,1,0,0,17699,214,56,7.0,True,7,True,0,1,0,17894,236,56,7.8,False,28.709566666666667,-195,-1,1,270,292,-22
BR1_2708411537,5,False,0,1,0,17471,223,64,7.4,False,6,True,1,0,0,17265,223,68,7.2,True,29.016983333333332,206,-1,-1,287,291,-4
BR1_2708385509,6,False,0,0,0,15606,209,56,7.0,True,4,True,0,0,0,14387,176,52,6.8,False,27.1654,1219,2,0,265,228,37
BR1_2701849174,6,False,0,0,0,17461,182,56,7.0,False,8,True,1,0,0,18866,252,43,7.0,True,29.895116666666667,-1405,-2,-1,238,295,-57
BR1_2731012790,7,False,0,0,0,16605,185,44,7.2,False,11,True,1,0,0,19781,233,63,7.2,True,29.618783333333333,-3176,-4,-1,229,296,-67
BR1_2729924792,5,True,0,0,0,15555,200,54,6.6,False,4,False,1,1,0,15340,195,53,6.8,True,25.91675,215,1,-1,254,248,6
BR1_2731483542,14,True,1,0,0,20406,235,64,7.4,True,5,False,0,0,0,17305,192,68,6.8,False,28.5336,3101,9,1,299,260,39
BR1_2727755921,7,True,1,0,0,19204,242,53,7.4,True,6,False,0,1,0,18600,250,46,7.6,False,29.03635,604,1,1,295,296,-1
BR1_2729478173,7,True,1,1,0,18130,215,60,7.0,True,1,False,0,0,0,13739,203,48,6.2,False,26.375983333333334,4391,6,1,275,251,24
BR1_2729427908,7,False,0,1,0,17204,216,64,7.0,False,5,True,1,0,0,15191,183,31,6.4,True,25.40595,2013,2,-1,280,214,66
BR1_2731709174,8,True,0,0,0,16983,225,48,7.2,False,4,False,0,0,0,17144,218,53,7.2,True,27.50005,-161,4,0,273,271,2
BR1_2731355331,9,False,0,0,0,18774,221,43,7.2,False,6,True,1,0,0,18235,212,64,7.0,True,27.5248,539,3,-1,264,276,-12
BR1_2731340971,11,False,0,0,0,19223,244,56,7.6,False,5,True,1,1,0,19248,266,72,7.6,True,28.998233333333335,-25,6,-1,300,338,-38
BR1_2730347919,8,True,0,0,0,17199,182,48,6.6,False,4,False,0,0,0,14636,173,40,6.2,True,25.719566666666665,2563,4,0,230,213,17
BR1_2725923016,8,True,0,0,0,18909,234,62,7.6,False,3,False,0,0,0,15159,179,54,7.2,True,28.377033333333333,3750,5,0,296,233,63
BR1_2725861908,10,True,1,1,0,17763,199,60,7.0,True,5,False,0,0,0,15410,196,47,6.8,False,26.140466666666665,2353,5,1,259,243,16
BR1_2699598174,6,False,0,0,0,15951,174,36,6.4,False,14,True,1,0,0,18461,201,44,6.6,True,25.988183333333332,-2510,-8,-1,210,245,-35
BR1_2710089159,4,True,1,1,0,16707,210,56,7.0,True,6,False,0,0,0,15504,184,60,7.0,False,26.285316666666667,1203,-2,1,266,244,22
BR1_2731620777,10,True,0,1,0,18844,192,60,7.0,True,13,False,1,0,0,20386,198,56,7.2,False,29.96405,-1542,-3,-1,252,254,-2
BR1_2730519123,2,True,1,1,0,14693,192,64,6.8,False,1,False,0,0,0,13832,190,58,6.6,True,27.344816666666667,861,1,1,256,248,8
BR1_2730346845,5,True,0,0,0,16361,224,64,7.6,True,5,False,0,0,0,15987,208,44,7.0,False,29.0373,374,0,0,288,252,36
BR1_2730330798,7,False,0,1,0,18352,214,63,7.6,False,9,True,1,0,0,18751,222,64,7.2,True,27.770033333333334,-399,-2,-1,277,286,-9
BR1_2724611912,9,True,0,1,0,18097,197,56,7.4,True,3,False,0,0,0,15656,225,48,7.0,False,29.99935,2441,6,0,253,273,-20
BR1_2731725112,6,True,1,0,0,16859,220,72,7.2,True,4,False,0,0,0,15448,185,68,7.0,False,26.4959,1411,2,1,292,253,39
BR1_2730439110,5,False,0,0,0,16816,215,42,6.8,False,12,True,0,0,0,19907,197,52,7.2,True,28.106766666666665,-3091,-7,0,257,249,8
BR1_2730368577,7,True,0,0,0,18765,255,43,7.2,True,3,False,0,0,0,14621,181,48,6.8,False,29.495366666666666,4144,4,0,298,229,69
BR1_2731018251,9,True,0,1,0,18394,216,54,7.4,True,8,False,1,0,0,18758,220,50,7.6,False,29.486133333333335,-364,1,-1,270,270,0
BR1_2730630729,6,False,0,0,0,17246,216,68,7.2,False,7,True,1,0,1,19738,255,68,7.4,True,28.011216666666666,-2492,-1,-1,284,323,-39
BR1_2698532999,7,False,1,0,0,17101,199,52,6.8,True,9,True,0,0,0,18403,221,48,7.0,False,29.534566666666667,-1302,-2,1,251,269,-18
BR1_2731312889,4,False,0,0,0,14585,193,48,6.6,False,9,True,1,0,0,18069,221,52,7.2,True,26.737616666666668,-3484,-5,-1,241,273,-32
BR1_2731526631,7,False,0,0,0,15452,161,44,6.4,False,10,True,1,0,0,18108,215,56,6.6,True,25.388516666666668,-2656,-3,-1,205,271,-66
BR1_2731200514,5,True,1,0,0,16705,194,52,7.0,True,5,False,0,0,0,16862,202,56,7.4,False,28.138583333333333,-157,0,1,246,258,-12
BR1_2730126316,4,True,0,0,0,16473,242,43,7.2,True,5,False,0,0,0,17010,240,56,7.4,False,29.42305,-537,-1,0,285,296,-11
BR1_2722322727,11,False,1,0,0,19366,213,64,7.6,True,3,True,0,1,0,15712,165,56,7.2,False,29.25505,3654,8,1,277,221,56
BR1_2722006888,3,False,0,0,0,16780,241,60,7.4,False,4,True,0,1,0,17658,242,69,7.8,True,28.667466666666666,-878,-1,0,301,311,-10
BR1_2731274315,1,True,0,1,0,15285,230,56,7.2,False,5,False,1,0,0,16667,242,60,7.2,True,28.4963,-1382,-4,-1,286,302,-16
BR1_2716081463,4,False,0,1,0,15618,187,60,6.8,True,6,True,0,0,0,16206,200,36,6.6,False,26.717533333333332,-588,-2,0,247,236,11
BR1_2730514799,10,False,0,0,0,17850,197,64,6.8,False,10,True,0,0,0,18163,217,60,6.8,True,25.91695,-313,0,0,261,277,-16
BR1_2725230286,6,False,1,0,0,17216,227,48,7.4,True,7,True,0,0,0,17963,248,47,7.0,False,27.649916666666666,-747,-1,1,275,295,-20
BR1_2731119939,11,False,0,1,0,18176,188,52,6.8,True,7,True,0,0,0,15893,173,56,6.6,False,27.36915,2283,4,0,240,229,11
BR1_2731106111,9,True,1,0,0,17547,170,51,6.4,False,10,False,0,0,0,18133,208,44,6.6,True,25.009483333333332,-586,-1,1,221,252,-31
BR1_2731668626,8,False,0,1,0,18784,213,64,7.6,True,6,True,0,0,0,16478,226,56,7.2,False,28.148666666666667,2306,2,0,277,282,-5
BR1_2716356208,12,True,0,0,0,19253,198,28,6.6,True,7,False,1,0,0,17112,212,56,7.2,False,29.0558,2141,5,-1,226,268,-42
BR1_2688047209,7,True,1,0,0,16246,182,52,6.8,True,7,False,0,0,0,16067,184,54,6.8,False,27.233,179,0,1,234,238,-4
BR1_2728187478,10,True,0,0,0,17185,174,48,6.8,False,10,False,0,0,0,18068,212,55,6.8,True,26.527516666666667,-883,0,0,222,267,-45
BR1_2727178593,5,True,0,1,1,16861,175,56,7.0,True,2,False,0,0,0,14370,202,47,6.4,False,26.440616666666667,2491,3,0,231,249,-18
BR1_2731732122,3,False,1,0,0,13226,158,43,6.2,False,13,True,0,0,0,19589,229,40,7.2,True,27.261666666666667,-6363,-10,1,201,269,-68
BR1_2679745026,10,True,1,1,0,18069,214,48,7.4,True,6,False,0,0,0,15442,205,56,7.2,False,26.143516666666667,2627,4,1,262,261,1
BR1_2729150032,7,True,1,0,0,17684,210,56,7.4,False,8,False,0,1,0,18892,240,48,7.4,True,27.831,-1208,-1,1,266,288,-22
BR1_2730665953,7,False,0,0,0,16320,165,44,6.6,False,8,True,1,0,0,17177,207,56,6.6,True,27.183116666666667,-857,-1,-1,209,263,-54
BR1_2730594020,6,False,1,0,0,15730,182,64,6.6,True,8,True,0,0,0,15687,166,52,6.4,False,27.188716666666668,43,-2,1,246,218,28
BR1_2692583372,5,False,0,1,0,16694,228,48,7.2,False,5,True,1,0,0,17731,223,68,7.4,True,28.127466666666667,-1037,0,-1,276,291,-15
BR1_2731530960,3,False,0,1,0,14043,151,48,6.4,False,7,True,1,0,0,17249,198,64,7.0,True,26.1569,-3206,-4,-1,199,262,-63
BR1_2703884493,5,False,1,0,0,16280,205,68,7.0,True,3,True,0,0,0,15027,205,56,6.8,False,25.592416666666665,1253,2,1,273,261,12
BR1_2703526295,10,False,0,0,0,15764,199,16,6.2,True,7,True,1,0,0,16167,156,56,6.2,False,25.574116666666665,-403,3,-1,215,212,3
BR1_2699874079,10,True,0,0,0,20729,268,72,7.6,True,8,False,0,0,0,17641,193,40,7.0,False,29.467566666666666,3088,2,0,340,233,107
BR1_2731325470,4,False,1,0,0,15418,249,49,7.0,True,8,True,0,1,0,17302,188,64,7.0,False,26.482633333333332,-1884,-4,1,298,252,46
BR1_2730005533,9,True,0,0,0,16661,167,48,6.4,False,12,False,1,1,0,18865,221,52,6.8,True,26.10015,-2204,-3,-1,215,273,-58
BR1_2730247987,8,False,0,0,0,16088,190,48,6.8,False,10,True,1,0,0,17959,210,68,7.0,True,26.88825,-1871,-2,-1,238,278,-40
BR1_2731435067,6,True,1,0,0,16465,198,60,6.6,False,10,False,0,1,0,19734,214,56,7.4,True,29.677833333333332,-3269,-4,1,258,270,-12
BR1_2731419851,11,False,1,1,1,20549,216,60,7.8,True,7,True,0,0,0,17415,221,40,7.4,False,29.62301666666667,3134,4,1,276,261,15
BR1_2731200855,13,True,0,0,0,18691,156,44,6.6,False,9,False,1,0,0,17323,182,60,6.8,True,27.051233333333332,1368,4,-1,200,242,-42
BR1_2716053886,7,True,1,0,0,16687,212,56,6.8,True,5,False,0,1,0,14791,162,54,6.6,False,25.52035,1896,2,1,268,216,52
BR1_2731303153,8,False,0,0,0,18126,206,64,7.2,True,12,True,0,0,0,20196,222,48,7.4,False,29.787116666666666,-2070,-4,0,270,270,0
BR1_2716242141,10,True,0,0,0,19562,227,64,7.2,True,1,False,1,1,0,14167,152,52,6.4,False,29.119783333333334,5395,9,-1,291,204,87
BR1_2721978943,4,True,1,0,0,15536,228,40,6.8,True,5,False,0,0,0,15573,218,56,7.0,False,27.0452,-37,-1,1,268,274,-6
BR1_2677947486,4,False,0,1,0,16988,236,72,7.4,False,5,True,1,0,0,17570,205,64,7.6,True,28.107516666666665,-582,-1,-1,308,269,39
BR1_2728581317,7,False,0,0,0,17908,232,56,6.8,True,6,True,1,0,0,14790,178,48,6.6,False,27.4852,3118,1,-1,288,226,62
BR1_2728556487,12,True,1,0,0,19773,214,60,7.0,True,4,False,0,1,0,14849,189,43,6.6,False,29.130983333333333,4924,8,1,274,232,42
BR1_2731562917,5,False,0,1,0,15935,202,48,6.8,False,5,True,1,0,0,15194,176,56,6.8,True,27.222066666666667,741,0,-1,250,232,18
BR1_2731057438,8,False,0,1,0,18417,234,68,7.4,False,6,True,1,0,0,16752,215,40,7.0,True,29.155866666666668,1665,2,-1,302,255,47
BR1_2722125569,14,True,0,1,0,20723,201,68,7.2,True,8,False,1,0,0,16108,158,52,6.8,False,29.482283333333335,4615,6,-1,269,210,59
BR1_2724989296,9,True,0,1,0,19103,226,60,7.4,True,2,False,0,0,0,16468,253,48,7.2,False,29.319316666666666,2635,7,0,286,301,-15
BR1_2724966438,6,False,0,0,0,14745,163,52,6.2,False,8,True,1,0,0,16418,190,56,6.4,True,27.09395,-1673,-2,-1,215,246,-31
BR1_2724929904,11,False,1,0,0,19279,187,76,7.0,True,14,True,1,0,0,21640,210,60,7.2,False,29.66475,-2361,-3,0,263,270,-7
BR1_2729430135,9,False,1,0,0,17778,202,52,7.4,False,9,True,0,0,0,19189,186,68,7.0,True,28.806583333333332,-1411,0,1,254,254,0
BR1_2729367994,9,False,1,0,0,18567,239,44,7.2,True,11,True,0,0,0,19508,217,72,7.2,False,29.995016666666668,-941,-2,1,283,289,-6
BR1_2731536529,3,True,0,0,0,15267,191,47,6.6,False,5,False,1,1,0,18140,237,55,7.4,True,27.960466666666665,-2873,-2,-1,238,292,-54
BR1_2730523864,12,True,1,0,0,18913,182,44,7.2,False,6,False,0,0,0,16860,199,52,7.0,True,27.652,2053,6,1,226,251,-25
BR1_2729996525,8,False,1,0,0,16746,186,59,6.8,False,6,True,0,0,0,16967,198,56,7.0,True,27.219266666666666,-221,2,1,245,254,-9
BR1_2729976671,9,False,1,0,0,17338,193,56,6.6,False,11,True,0,1,0,18255,218,60,6.6,True,26.667466666666666,-917,-2,1,249,278,-29
BR1_2729906623,4,True,1,0,0,14453,200,44,6.4,False,5,False,0,0,0,15995,197,52,6.6,True,26.123816666666666,-1542,-1,1,244,249,-5
BR1_2731175952,5,True,1,0,0,14934,183,56,6.4,True,0,False,0,0,0,13116,197,48,6.6,False,26.7144,1818,5,1,239,245,-6
BR1_2731152510,9,False,0,1,0,18610,216,53,7.0,False,7,True,1,0,0,18274,248,44,7.4,True,29.54855,336,2,-1,269,292,-23
BR1_2729860169,5,True,1,0,0,15288,169,48,6.6,False,6,False,0,0,0,15560,188,64,6.8,True,26.699316666666668,-272,-1,1,217,252,-35
BR1_2729752350,6,False,1,0,0,16708,218,52,6.8,False,8,True,0,0,0,16116,191,44,6.8,True,26.414533333333335,592,-2,1,270,235,35
BR1_2729668466,7,False,1,0,0,17317,196,53,7.2,False,11,True,0,0,0,19863,222,61,7.4,True,29.099933333333333,-2546,-4,1,249,283,-34
BR1_2668487254,6,False,0,0,0,15660,203,48,6.8,False,6,True,1,0,0,14946,153,80,7.2,True,26.938016666666666,714,0,-1,251,233,18
BR1_2668294203,9,True,1,0,0,18546,210,56,7.4,True,8,False,0,0,0,17343,184,40,7.2,False,29.530666666666665,1203,1,1,266,224,42
BR1_2718587326,13,False,0,1,0,20200,199,52,7.4,True,8,True,0,0,0,18395,201,44,7.0,False,27.617133333333335,1805,5,0,251,245,6
BR1_2685988438,4,True,1,0,0,17068,240,56,7.8,True,2,False,0,1,0,15349,216,64,7.2,False,29.856833333333334,1719,2,1,296,280,16
BR1_2684797875,10,False,1,0,0,19505,232,52,7.8,True,7,True,0,0,0,17929,192,52,7.2,False,28.152466666666665,1576,3,1,284,244,40
BR1_2684289218,16,False,0,1,0,20238,146,52,7.0,False,11,True,0,0,0,19612,197,50,7.2,True,27.737916666666667,626,5,0,198,247,-49
BR1_2731204779,5,False,1,0,0,17712,241,64,7.2,True,7,True,0,1,0,17610,221,55,7.4,False,29.370333333333335,102,-2,1,305,276,29
BR1_2725806193,5,False,1,0,0,15266,197,44,6.6,False,10,True,0,1,0,17978,176,64,6.8,True,25.222883333333332,-2712,-5,1,241,240,1
BR1_2731535027,4,False,1,0,0,14642,204,42,6.6,True,4,True,0,0,0,14557,180,44,6.8,False,27.072866666666666,85,0,1,246,224,22
BR1_2731524054,7,False,1,0,0,17825,217,64,7.2,True,6,True,0,1,0,14829,177,44,6.4,False,25.152433333333335,2996,1,1,281,221,60
BR1_2730827074,10,True,1,0,0,19855,234,54,7.2,True,6,False,0,0,0,17576,221,44,7.0,False,29.6348,2279,4,1,288,265,23
BR1_2724018090,5,False,1,0,0,17491,261,48,7.4,False,5,True,0,1,0,16524,220,56,7.6,True,29.85975,967,0,1,309,276,33
BR1_2706755746,11,True,0,0,0,16868,143,56,6.6,True,7,False,0,0,0,14995,175,36,6.8,False,25.673366666666666,1873,4,0,199,211,-12
BR1_2706739217,4,True,0,0,0,15570,180,56,7.2,False,7,False,0,0,0,18884,227,60,7.2,True,28.409633333333332,-3314,-3,0,236,287,-51
BR1_2680056471,6,False,0,0,0,18778,250,60,7.8,False,5,True,0,1,0,17232,208,62,7.6,True,29.81605,1546,1,0,310,270,40
BR1_2679819804,6,False,0,0,0,17680,198,56,7.4,False,9,True,0,1,0,18116,196,60,7.0,True,27.717933333333335,-436,-3,0,254,256,-2
BR1_2727774750,9,True,0,1,0,20083,236,40,7.0,True,9,False,1,0,0,18383,208,68,7.2,False,28.863583333333334,1700,0,-1,276,276,0
BR1_2727761613,16,False,1,0,0,20371,187,48,7.0,False,7,True,0,0,0,16268,162,36,6.2,True,26.9035,4103,9,1,235,198,37
BR1_2716641485,3,False,0,1,0,14427,188,44,6.6,True,3,True,1,0,0,14475,191,56,6.6,False,26.665966666666666,-48,0,-1,232,247,-15
BR1_2729811070,5,False,0,0,0,14416,169,44,6.8,False,8,True,1,0,0,17302,177,72,6.8,True,25.89603333333333,-2886,-3,-1,213,249,-36
BR1_2687006073,10,True,0,0,0,19218,217,58,7.2,True,6,False,0,1,0,18562,226,61,7.4,False,28.05075,656,4,0,275,287,-12
BR1_2676755130,4,True,0,0,0,17124,236,56,7.6,True,5,False,1,1,0,16318,200,56,7.2,False,29.666183333333333,806,-1,-1,292,256,36
BR1_2727771516,8,True,0,0,0,17690,210,44,6.8,True,6,False,0,0,0,15326,184,47,6.6,False,26.530883333333332,2364,2,0,254,231,23
BR1_2727573608,10,False,0,0,1,20347,231,44,7.2,True,10,True,1,1,0,19279,197,56,7.4,False,27.858766666666668,1068,0,-1,275,253,22
BR1_2727551698,13,False,0,0,0,20245,200,48,7.2,False,16,True,0,1,0,22385,206,56,7.4,True,28.986033333333335,-2140,-3,0,248,262,-14
BR1_2727529591,5,True,1,0,0,16578,193,56,7.0,True,6,False,0,0,0,14383,169,44,6.0,False,26.144033333333333,2195,-1,1,249,213,36
BR1_2730097087,14,True,1,0,0,19612,208,63,6.8,True,10,False,0,0,0,17618,187,44,6.6,False,26.603766666666665,1994,4,1,271,231,40
BR1_2729992090,7,False,1,1,1,19955,256,56,7.6,True,1,True,0,0,0,14521,197,68,6.8,False,29.060566666666666,5434,6,1,312,265,47
BR1_2675669563,4,False,0,1,0,15628,168,56,7.0,False,8,True,0,0,0,19405,240,72,7.6,True,29.551,-3777,-4,0,224,312,-88
BR1_2687549402,7,True,1,1,0,17607,169,72,7.6,True,6,False,0,0,0,18410,215,52,7.2,False,27.62805,-803,1,1,241,267,-26
BR1_2687521670,3,True,1,1,0,16093,219,64,7.0,False,8,False,0,0,0,18124,220,68,7.6,True,28.202683333333333,-2031,-5,1,283,288,-5
BR1_2687286511,4,True,0,1,0,15775,219,64,7.2,True,3,False,0,0,0,15135,215,60,6.6,False,26.444666666666667,640,1,0,283,275,8
BR1_2687259943,12,False,1,1,0,20733,201,60,7.4,True,9,True,0,0,0,18108,174,56,7.0,False,29.79595,2625,3,1,261,230,31
BR1_2703494265,9,True,1,0,0,18789,207,44,7.4,True,4,False,0,1,0,15901,170,60,7.0,False,27.696383333333333,2888,5,1,251,230,21
BR1_2711715190,5,False,0,0,0,16295,246,48,6.8,True,4,True,1,0,0,15253,203,52,6.8,False,26.504066666666667,1042,1,-1,294,255,39
BR1_2711681854,8,True,1,1,0,19417,216,64,7.4,True,6,False,0,0,0,18000,227,52,7.4,False,28.886733333333332,1417,2,1,280,279,1
BR1_2711657382,8,True,0,0,0,17828,206,48,7.2,False,12,False,1,1,0,21008,246,70,7.8,True,28.926633333333335,-3180,-4,-1,254,316,-62
BR1_2684463264,11,True,0,0,0,18825,221,44,7.2,False,6,False,1,0,0,17352,230,62,7.2,True,28.53023333333333,1473,5,-1,265,292,-27
BR1_2730208454,5,False,0,0,0,17126,196,52,7.0,True,7,True,1,0,0,17582,201,60,7.2,False,29.3962,-456,-2,-1,248,261,-13
BR1_2724125157,14,False,0,1,0,20919,203,52,7.4,True,9,True,1,0,0,17952,188,57,6.8,False,29.562933333333334,2967,5,-1,255,245,10
BR1_2724065063,4,False,1,0,0,15973,198,64,7.6,True,6,True,0,1,0,17578,243,64,7.6,False,29.417283333333334,-1605,-2,1,262,307,-45
BR1_2731441579,7,True,0,0,0,17124,192,47,6.8,True,8,False,1,0,0,16534,185,52,6.8,False,25.2319,590,-1,-1,239,237,2
BR1_2730105099,10,True,1,0,0,19473,233,60,7.6,True,2,False,0,1,0,15610,226,47,7.0,False,28.698766666666668,3863,8,1,293,273,20
BR1_2727347339,10,True,1,0,0,18085,215,52,7.0,True,6,False,0,0,0,15644,166,44,6.2,False,25.9398,2441,4,1,267,210,57
BR1_2731013469,6,True,1,0,0,15827,195,48,6.8,True,3,False,0,0,0,15306,210,52,6.6,False,27.155883333333332,521,3,1,243,262,-19
BR1_2673408080,1,False,0,0,0,13480,189,48,6.8,False,12,True,1,0,0,18000,194,48,7.4,True,27.270233333333334,-4520,-11,-1,237,242,-5
BR1_2672775731,6,False,0,1,1,17971,227,52,7.2,True,4,True,1,0,0,15159,200,52,7.0,False,26.9374,2812,2,-1,279,252,27
BR1_2731085105,9,True,0,1,0,18072,209,44,6.8,True,8,False,1,0,0,15828,188,48,6.8,False,27.47995,2244,1,-1,253,236,17
BR1_2728238241,10,True,0,0,0,18679,220,60,7.2,True,14,False,1,0,0,21208,213,56,7.4,False,29.4915,-2529,-4,-1,280,269,11
BR1_2728768590,6,True,0,1,0,17151,217,54,7.0,True,1,False,0,0,0,14376,208,56,7.0,False,28.405566666666665,2775,5,0,271,264,7
BR1_2729404752,11,False,0,0,0,17051,181,44,6.6,False,4,True,0,0,0,15318,184,28,6.4,True,26.947133333333333,1733,7,0,225,212,13
BR1_2728772348,5,True,1,0,0,14999,170,52,6.4,False,8,False,0,1,0,17556,193,54,6.6,True,26.209816666666665,-2557,-3,1,222,247,-25
BR1_2729190531,6,False,0,0,0,16815,195,48,7.2,False,11,True,0,1,0,21187,238,68,7.6,True,28.574766666666665,-4372,-5,0,243,306,-63
BR1_2695005940,6,False,0,0,0,15522,169,52,6.6,False,10,True,0,0,0,16866,189,36,6.6,True,25.167,-1344,-4,0,221,225,-4
BR1_2663212710,9,False,0,0,0,17589,213,52,7.0,True,5,True,0,0,0,15310,153,58,6.6,False,25.461333333333332,2279,4,0,265,211,54
BR1_2730036612,4,False,0,1,0,16234,216,46,7.0,True,8,True,1,0,0,18589,198,57,7.4,False,27.566883333333333,-2355,-4,-1,262,255,7
BR1_2729961391,6,True,0,0,0,17803,234,48,7.4,False,14,False,1,0,0,21327,214,60,7.6,True,29.547183333333333,-3524,-8,-1,282,274,8
BR1_2712083176,6,False,0,1,0,17047,212,60,7.2,False,9,True,1,0,0,18207,207,56,7.2,True,29.224716666666666,-1160,-3,-1,272,263,9
BR1_2707491631,10,False,1,1,0,19614,209,64,7.6,True,8,True,0,0,0,16590,180,36,7.2,False,28.719383333333333,3024,2,1,273,216,57
BR1_2704920201,6,True,0,0,0,17510,205,56,7.2,False,8,False,1,1,0,19099,248,63,7.6,True,29.530683333333332,-1589,-2,-1,261,311,-50
BR1_2703376900,8,True,0,1,0,19398,219,60,7.0,True,6,False,1,0,0,17927,235,60,7.4,False,28.256966666666667,1471,2,-1,279,295,-16
BR1_2715776486,10,False,0,0,0,18745,218,48,7.2,False,11,True,1,1,0,19513,188,60,7.0,True,29.18495,-768,-1,-1,266,248,18
BR1_2715588757,14,True,1,0,0,19451,208,58,7.2,True,3,False,0,0,0,13761,150,40,6.6,False,26.810533333333332,5690,11,1,266,190,76
BR1_2731440611,7,True,1,1,0,17847,234,56,7.2,True,5,False,0,0,0,15870,174,44,7.0,False,28.757,1977,2,1,290,218,72
BR1_2730719584,6,True,0,1,0,18194,233,63,7.4,True,3,False,1,0,0,16310,243,66,7.2,False,29.033,1884,3,-1,296,309,-13
BR1_2729983184,5,False,0,0,0,16224,181,52,7.0,False,11,True,0,0,0,19212,207,44,7.6,True,28.54531666666667,-2988,-6,0,233,251,-18
BR1_2729958873,6,False,1,0,0,16061,200,41,7.0,True,8,True,0,0,0,17862,186,75,7.2,False,29.42193333333333,-1801,-2,1,241,261,-20
BR1_2725842063,10,False,0,0,0,18792,196,48,7.2,True,10,True,1,0,0,19197,192,80,7.4,False,28.278533333333332,-405,0,-1,244,272,-28
BR1_2722845014,8,True,0,0,0,17661,222,47,6.8,True,3,False,1,0,0,15360,214,60,6.8,False,25.455266666666667,2301,5,-1,269,274,-5
BR1_2731498030,4,False,1,0,0,14900,192,34,6.4,False,9,True,0,0,0,17594,193,49,6.6,True,27.1246,-2694,-5,1,226,242,-16
BR1_2695768380,4,False,0,0,0,14716,208,55,6.4,False,7,True,0,0,0,15639,180,40,7.0,True,27.32315,-923,-3,0,263,220,43
BR1_2731168736,3,False,0,0,0,14466,204,60,6.6,False,10,True,1,0,0,18056,232,44,6.8,True,25.787233333333333,-3590,-7,-1,264,276,-12
BR1_2731136866,12,True,0,0,0,20611,250,60,7.6,True,3,False,1,0,0,16909,255,64,7.4,False,29.15385,3702,9,-1,310,319,-9
BR1_2731114587,13,True,1,0,0,20873,245,64,7.6,True,3,False,0,0,0,16745,231,52,7.0,False,29.732166666666668,4128,10,1,309,283,26
BR1_2725513037,4,True,1,0,0,15523,237,48,7.0,True,2,False,0,1,0,14629,205,52,6.8,False,26.7897,894,2,1,285,257,28
BR1_2724952275,12,False,1,0,0,19442,223,60,7.6,True,7,True,0,0,0,18181,228,60,6.8,False,29.07995,1261,5,1,283,288,-5
BR1_2731663284,5,False,0,0,0,15877,210,56,6.8,False,11,True,1,1,0,18737,232,60,7.6,True,28.51705,-2860,-6,-1,266,292,-26
BR1_2731245755,18,True,1,1,1,23181,241,56,7.4,True,6,False,0,0,0,16275,141,51,6.8,False,28.332466666666665,6906,12,1,297,192,105
BR1_2731212326,6,True,0,0,0,17434,223,55,7.4,False,5,False,0,1,0,19331,242,64,7.4,True,28.669533333333334,-1897,1,0,278,306,-28
BR1_2726503368,6,True,1,1,0,16714,201,52,6.8,True,3,False,0,0,0,14636,208,47,6.8,False,25.2206,2078,3,1,253,255,-2
BR1_2705340758,7,True,1,0,0,17730,231,62,7.2,True,7,False,0,0,0,16872,193,52,7.2,False,27.812383333333333,858,0,1,293,245,48
BR1_2728287256,9,True,0,0,0,17674,193,52,6.8,True,6,False,0,0,0,15494,173,48,6.6,False,27.41505,2180,3,0,245,221,24
BR1_2728334790,3,True,0,0,0,14237,206,41,6.4,False,7,False,1,1,0,16437,173,60,6.8,True,27.475266666666666,-2200,-4,-1,247,233,14
BR1_2731689761,9,True,1,0,0,16725,188,64,6.8,True,3,False,0,0,0,13689,163,44,6.2,False,26.170916666666667,3036,6,1,252,207,45
BR1_2731709294,3,True,0,0,0,14622,195,56,6.8,False,8,False,1,1,0,16293,193,43,6.6,True,27.096883333333334,-1671,-5,-1,251,236,15
BR1_2731657631,7,True,0,0,0,17252,219,67,7.2,False,8,False,1,0,0,18214,218,48,7.4,True,28.963266666666666,-962,-1,-1,286,266,20
BR1_2723870788,11,True,0,1,0,20342,230,58,7.4,True,7,False,1,0,0,17187,213,52,7.0,False,28.062683333333332,3155,4,-1,288,265,23
BR1_2730446808,9,True,1,0,0,19569,247,48,7.2,True,10,False,0,1,0,19287,206,55,7.4,False,28.314266666666665,282,-1,1,295,261,34
BR1_2730000125,8,False,0,0,0,16416,202,36,7.0,False,9,True,0,0,0,18743,219,64,7.2,True,26.902433333333335,-2327,-1,0,238,283,-45
BR1_2729975853,1,False,0,0,0,14080,190,60,6.6,False,9,True,1,0,0,17487,245,56,6.8,True,25.4083,-3407,-8,-1,250,301,-51
BR1_2724652712,4,False,0,1,0,15957,173,64,7.2,False,6,True,1,0,0,17252,231,52,7.4,True,29.486533333333334,-1295,-2,-1,237,283,-46
BR1_2724605400,6,False,0,0,0,15558,178,52,6.6,True,9,True,1,0,0,17271,176,44,6.4,False,25.199133333333332,-1713,-3,-1,230,220,10
BR1_2731611919,5,False,0,0,0,14891,189,48,6.6,False,9,True,0,0,0,17633,211,56,6.8,True,26.1664,-2742,-4,0,237,267,-30
BR1_2730661556,14,False,0,0,0,19895,206,52,7.4,False,9,True,1,0,0,18505,188,64,7.4,True,27.991333333333333,1390,5,-1,258,252,6
BR1_2731364158,9,True,0,0,0,18425,232,66,7.4,True,2,False,1,1,0,15057,179,64,7.0,False,28.7647,3368,7,-1,298,243,55
BR1_2731576178,4,False,0,0,0,15731,216,55,7.2,False,11,True,1,0,0,18601,208,64,7.4,True,28.51718333333333,-2870,-7,-1,271,272,-1
BR1_2731299250,4,False,0,0,0,15075,208,51,6.8,False,5,True,0,0,0,15654,192,48,6.8,True,27.021183333333333,-579,-1,0,259,240,19
BR1_2731509633,9,True,0,0,0,16065,157,56,6.6,True,4,False,1,0,0,14922,190,48,6.4,False,25.77125,1143,5,-1,213,238,-25
BR1_2731497165,6,True,1,0,0,17097,228,40,7.4,True,2,False,0,0,0,15363,241,20,6.8,False,28.769566666666666,1734,4,1,268,261,7
BR1_2715037037,3,False,0,0,0,14182,185,48,6.8,False,2,True,1,0,0,14351,190,60,6.6,True,26.181633333333334,-169,1,-1,233,250,-17
BR1_2715004011,3,False,1,0,0,13857,138,52,6.4,False,3,True,0,0,0,16595,238,50,6.8,True,27.117116666666668,-2738,0,1,190,288,-98
BR1_2722323048,3,False,1,0,0,15378,196,52,7.0,False,6,True,0,0,0,18268,223,72,7.6,True,27.74145,-2890,-3,1,248,295,-47
BR1_2728868660,9,False,0,0,0,18298,204,60,7.6,True,6,True,1,1,0,17177,204,56,7.4,False,29.259383333333332,1121,3,-1,264,260,4
BR1_2703561901,7,False,1,0,0,16597,192,36,6.8,False,11,True,0,1,0,19696,233,56,7.4,True,28.9292,-3099,-4,1,228,289,-61
BR1_2705226887,7,True,0,0,0,17806,186,56,7.2,False,9,False,0,1,0,18634,221,48,7.4,True,29.998916666666666,-828,-2,0,242,269,-27
BR1_2704711801,12,True,0,0,0,18928,196,44,6.4,False,7,False,1,0,0,17166,218,52,7.2,True,27.288283333333332,1762,5,-1,240,270,-30
BR1_2728542211,6,False,0,0,0,17074,216,68,7.2,False,5,True,0,0,0,15959,198,56,7.2,True,29.34645,1115,1,0,284,254,30
BR1_2730182761,12,False,0,1,0,18185,191,52,7.4,True,5,True,0,0,0,15267,185,48,7.2,False,28.110766666666667,2918,7,0,243,233,10
BR1_2731302052,7,True,1,0,0,16818,224,52,6.8,True,4,False,0,1,0,15658,236,43,6.8,False,26.707233333333335,1160,3,1,276,279,-3
BR1_2731667603,5,True,0,0,0,17378,210,62,7.2,True,7,False,0,1,0,18356,255,82,7.6,False,28.0047,-978,-2,0,272,337,-65
BR1_2731646556,7,True,0,0,0,17554,212,40,7.4,False,10,False,1,0,0,20021,264,68,7.8,True,29.493433333333332,-2467,-3,-1,252,332,-80
BR1_2727544256,8,True,0,0,0,17717,207,48,6.8,True,10,False,1,0,0,19399,209,56,7.4,False,28.960966666666668,-1682,-2,-1,255,265,-10
BR1_2701964881,6,False,0,0,0,16712,207,56,6.6,False,7,True,1,0,0,16486,206,55,7.0,True,25.571166666666667,226,-1,-1,263,261,2
BR1_2701944770,7,False,1,0,0,17800,199,68,7.0,True,9,True,0,0,0,19188,199,40,7.2,False,29.066183333333335,-1388,-2,1,267,239,28
BR1_2730292293,5,True,1,0,0,16844,235,52,7.2,False,5,False,0,1,0,17660,210,72,7.4,True,29.7017,-816,0,1,287,282,5
BR1_2730270558,5,True,0,0,0,17677,226,56,7.0,False,14,False,0,0,0,20435,193,68,7.6,True,28.144283333333334,-2758,-9,0,282,261,21
BR1_2730624594,7,True,1,0,0,18440,219,56,7.0,True,6,False,0,0,0,15653,189,56,6.8,False,25.706433333333333,2787,1,1,275,245,30
BR1_2731727283,2,False,0,0,0,13942,149,52,6.4,False,9,True,1,1,0,16436,168,52,6.8,True,27.115616666666668,-2494,-7,-1,201,220,-19
BR1_2711158130,7,False,0,1,0,15832,200,44,6.6,False,8,True,1,0,0,15481,170,55,6.8,True,26.243233333333333,351,-1,-1,244,225,19
BR1_2731174666,12,False,0,0,0,19306,197,60,7.0,True,9,True,1,1,0,16838,167,52,6.6,False,27.1426,2468,3,-1,257,219,38
BR1_2731180040,12,True,1,0,0,19040,210,64,7.2,True,2,False,0,0,0,14955,203,60,6.8,False,29.108766666666668,4085,10,1,274,263,11
BR1_2731520048,1,False,1,1,0,15219,217,52,7.0,False,12,True,0,0,0,19624,260,52,7.8,True,28.114133333333335,-4405,-11,1,269,312,-43
BR1_2731441640,12,True,1,0,0,18997,197,47,6.8,True,9,False,0,0,0,17353,213,36,6.8,False,27.491616666666665,1644,3,1,244,249,-5
BR1_2713068140,6,False,0,1,0,17502,227,65,7.4,True,6,True,1,0,0,16507,201,62,7.2,False,27.977216666666667,995,0,-1,292,263,29
BR1_2713045275,2,False,0,1,0,14875,198,56,7.0,True,6,True,0,0,0,16307,188,60,7.2,False,26.916016666666668,-1432,-4,0,254,248,6
BR1_2713026110,6,False,0,1,0,15379,198,56,6.6,False,6,True,1,0,0,15317,172,48,6.6,True,25.807516666666668,62,0,-1,254,220,34
BR1_2703541057,4,False,0,1,0,14006,149,44,6.2,False,6,True,1,0,0,15954,192,52,6.8,True,26.701283333333333,-1948,-2,-1,193,244,-51
BR1_2680552720,12,False,0,0,0,19317,172,44,7.2,False,12,True,0,0,0,20764,228,56,7.4,True,28.01725,-1447,0,0,216,284,-68
BR1_2725262577,8,False,0,0,0,17525,189,44,7.0,False,8,True,1,0,0,19496,226,56,7.4,True,29.910283333333332,-1971,0,-1,233,282,-49
BR1_2721375364,11,True,0,0,0,18017,200,44,6.6,False,7,False,1,0,0,16600,166,60,6.8,True,27.414083333333334,1417,4,-1,244,226,18
BR1_2730874741,4,True,0,0,0,16837,205,56,6.8,False,8,False,0,0,0,18528,205,48,7.0,True,29.620966666666668,-1691,-4,0,261,253,8
BR1_2724067817,4,True,0,0,0,14923,207,44,6.6,False,4,False,0,0,0,15200,205,48,6.8,True,27.322333333333333,-277,0,0,251,253,-2
BR1_2725715612,12,True,0,1,0,17800,166,40,6.6,True,3,False,0,0,0,14594,204,44,6.6,False,27.06373333333333,3206,9,0,206,248,-42
BR1_2725664151,10,True,0,0,0,18108,227,66,7.2,True,1,False,0,0,0,14394,221,62,6.8,False,27.0383,3714,9,0,293,283,10
BR1_2730265038,12,True,1,0,0,19502,244,44,7.4,False,2,False,0,1,0,15201,210,60,7.0,True,29.382933333333334,4301,10,1,288,270,18
BR1_2728773515,8,False,0,0,0,17672,195,60,7.4,False,9,True,1,0,0,18479,223,60,7.2,True,29.404666666666667,-807,-1,-1,255,283,-28
BR1_2726751473,8,False,0,0,0,17619,186,40,7.2,False,6,True,1,1,0,17632,252,68,7.4,True,27.944983333333333,-13,2,-1,226,320,-94
BR1_2729704530,5,False,0,0,0,15698,158,48,6.6,False,15,True,0,0,0,19160,182,44,6.8,True,27.188533333333332,-3462,-10,0,206,226,-20
BR1_2731525439,7,True,0,0,0,16694,211,0,6.6,False,15,False,1,0,0,20182,207,52,7.4,True,28.3539,-3488,-8,-1,211,259,-48
BR1_2731491558,6,False,0,0,0,18083,225,64,7.2,False,10,True,0,1,1,20721,218,56,7.2,True,28.954,-2638,-4,0,289,274,15
BR1_2730237007,3,True,1,0,0,14254,183,44,6.6,False,5,False,0,0,0,15291,179,48,6.8,True,26.32005,-1037,-2,1,227,227,0
BR1_2729608692,6,False,1,0,0,16747,184,40,7.0,False,9,True,0,1,0,20289,213,84,7.8,True,29.619316666666666,-3542,-3,1,224,297,-73
BR1_2731443517,9,True,0,1,0,17623,204,47,7.0,True,7,False,0,0,0,15448,157,40,6.2,False,27.211616666666668,2175,2,0,251,197,54
BR1_2730016401,6,False,0,0,0,17012,195,56,6.8,False,11,True,1,0,0,18605,182,44,6.8,True,28.446816666666667,-1593,-5,-1,251,226,25
BR1_2729845605,6,False,0,1,0,18264,241,56,7.2,False,6,True,1,0,0,17749,234,56,7.4,True,27.684783333333332,515,0,-1,297,290,7
BR1_2729605275,7,False,0,0,0,16174,193,52,6.6,True,4,True,0,0,0,15668,200,68,7.0,False,27.0957,506,3,0,245,268,-23
BR1_2729890575,1,False,0,1,0,15436,227,64,7.0,True,5,True,1,0,1,18347,190,60,7.0,False,27.847166666666666,-2911,-4,-1,291,250,41
BR1_2731736556,8,False,0,0,0,16720,165,40,6.8,False,14,True,1,0,0,19230,177,56,7.0,True,25.057983333333333,-2510,-6,-1,205,233,-28
BR1_2731571864,10,True,1,0,0,18104,171,52,6.8,True,4,False,0,0,0,15445,180,48,6.4,False,25.923466666666666,2659,6,1,223,228,-5
BR1_2682483610,11,True,0,0,0,19163,193,56,7.4,False,13,False,0,0,0,20034,220,48,7.8,True,29.048266666666667,-871,-2,0,249,268,-19
BR1_2681318343,6,False,1,0,0,15370,186,48,6.8,True,6,True,0,1,0,16440,208,52,7.0,False,26.3623,-1070,0,1,234,260,-26
BR1_2730805260,6,True,1,1,0,15849,182,44,6.6,False,6,False,0,0,0,16194,188,48,6.6,True,26.847566666666665,-345,0,1,226,236,-10
BR1_2731269339,10,True,1,1,0,18443,188,48,6.8,True,6,False,0,0,0,16077,182,44,6.4,False,27.395516666666666,2366,4,1,236,226,10
BR1_2731126522,9,False,0,1,0,17478,195,36,6.6,False,9,True,1,0,0,16864,171,56,6.6,True,27.29245,614,0,-1,231,227,4
BR1_2731108479,7,True,1,1,0,16968,185,48,6.8,True,4,False,0,0,0,14807,224,43,6.6,False,27.2495,2161,3,1,233,267,-34
BR1_2691129274,9,False,0,1,0,17894,202,64,7.0,True,1,True,0,0,0,13059,192,44,6.6,False,26.244366666666668,4835,8,0,266,236,30
BR1_2686883411,10,True,0,0,0,19341,221,56,7.4,False,8,False,0,1,0,19637,203,52,7.4,True,28.97655,-296,2,0,277,255,22
BR1_2686376016,7,False,1,1,0,18771,214,52,7.6,True,14,True,0,0,0,20668,203,64,7.2,False,29.7966,-1897,-7,1,266,267,-1
BR1_2720419986,3,False,1,1,0,17131,248,72,7.6,False,10,True,0,0,0,19438,220,60,7.2,True,28.6627,-2307,-7,1,320,280,40
BR1_2727781250,10,True,1,1,1,20030,208,59,7.2,False,10,False,0,0,0,18334,194,48,7.4,True,29.673116666666665,1696,0,1,267,242,25
BR1_2727742158,4,False,0,0,0,14055,188,48,6.6,False,7,True,1,0,0,16469,202,56,7.2,True,25.487333333333332,-2414,-3,-1,236,258,-22
BR1_2727245496,5,False,0,0,0,15522,211,44,6.8,False,12,True,0,0,0,17205,157,60,6.8,True,25.913383333333332,-1683,-7,0,255,217,38
BR1_2731258995,6,False,0,1,1,17590,196,47,6.6,False,8,True,1,0,0,17002,191,68,7.2,True,26.213266666666666,588,-2,-1,243,259,-16
BR1_2731233983,10,False,1,1,0,20404,217,76,7.6,True,7,True,0,0,0,17167,205,48,7.2,False,28.582566666666665,3237,3,1,293,253,40
BR1_2731678984,10,True,1,0,1,20784,251,48,7.4,True,3,False,0,0,0,15844,217,52,7.0,False,27.818216666666668,4940,7,1,299,269,30
BR1_2731213549,5,False,0,0,0,16401,209,53,7.4,False,11,True,1,1,0,19677,199,59,7.2,True,29.6209,-3276,-6,-1,262,258,4
BR1_2730892097,4,False,0,0,0,16861,212,52,6.8,False,14,True,1,0,0,21280,222,52,7.4,True,28.262983333333334,-4419,-10,-1,264,274,-10
BR1_2730624868,9,False,1,0,0,18104,193,52,6.8,False,7,True,0,1,0,18153,182,56,7.0,True,28.626216666666668,-49,2,1,245,238,7
BR1_2731432262,7,True,0,1,0,19120,226,60,7.2,True,9,False,1,0,0,18014,221,60,7.2,False,28.32745,1106,-2,-1,286,281,5
BR1_2708843362,11,True,1,0,0,18215,177,41,7.0,False,7,False,0,0,0,18955,226,62,7.4,True,27.6625,-740,4,1,218,288,-70
BR1_2728274935,10,True,0,1,0,20418,223,54,7.4,True,2,False,1,0,0,15279,230,64,7.2,False,29.09265,5139,8,-1,277,294,-17
BR1_2722807933,6,True,1,0,0,17104,204,56,7.2,True,4,False,0,0,0,16714,241,60,7.4,False,27.955783333333333,390,2,1,260,301,-41
BR1_2722797423,9,False,1,1,0,17217,174,48,6.4,True,11,True,0,0,0,17621,171,64,7.0,False,26.3069,-404,-2,1,222,235,-13
BR1_2731570709,8,True,0,0,0,19571,259,63,7.4,True,3,False,0,0,0,15910,218,60,7.6,False,28.497783333333334,3661,5,0,322,278,44
BR1_2731557726,15,True,0,0,0,20870,228,44,7.4,True,9,False,1,0,0,18264,219,47,7.0,False,28.26,2606,6,-1,272,266,6
BR1_2687845675,7,False,0,1,0,15893,188,30,6.6,False,14,True,1,0,0,19641,185,49,6.8,True,26.618733333333335,-3748,-7,-1,218,234,-16
BR1_2687744056,9,True,0,0,0,16598,197,39,7.0,True,7,False,0,0,0,16556,202,48,6.6,False,26.135,42,2,0,236,250,-14
BR1_2729119682,7,False,0,0,0,17138,239,64,7.2,True,3,True,1,0,0,13997,166,60,6.8,False,25.238366666666668,3141,4,-1,303,226,77
BR1_2725552743,9,False,0,0,0,17834,190,76,6.6,True,9,True,0,0,0,17371,211,44,7.0,False,27.26345,463,0,0,266,255,11
BR1_2725532281,5,False,0,0,0,15092,171,48,7.0,False,14,True,0,0,0,20201,226,52,7.0,True,26.955233333333332,-5109,-9,0,219,278,-59
BR1_2731468427,9,False,1,0,0,19672,242,77,8.0,True,7,True,0,0,0,17777,230,43,7.2,False,28.89265,1895,2,1,319,273,46
BR1_2731539540,9,False,1,0,0,18444,219,68,7.4,True,6,True,0,0,0,16096,203,44,7.0,False,28.10845,2348,3,1,287,247,40
BR1_2729329826,9,True,1,0,0,18647,237,52,7.8,True,7,False,0,1,0,17258,223,68,7.0,False,29.138016666666665,1389,2,1,289,291,-2
BR1_2731465144,4,True,1,1,0,15241,198,58,6.6,True,6,False,0,0,0,16449,202,44,6.8,False,25.656833333333335,-1208,-2,1,256,246,10
BR1_2731490468,9,True,1,0,0,16547,199,48,6.6,True,5,False,0,0,0,14159,142,48,6.4,False,26.701783333333335,2388,4,1,247,190,57
BR1_2713084361,5,True,1,0,0,16272,213,44,6.8,True,4,False,0,0,0,15088,188,56,6.4,False,26.69236666666667,1184,1,1,257,244,13
BR1_2713018000,9,False,1,1,0,17894,202,54,6.8,False,11,True,0,0,0,18686,179,53,6.6,True,27.189083333333333,-792,-2,1,256,232,24
BR1_2731730578,6,True,0,1,0,17377,241,47,7.2,True,5,False,0,0,0,16412,205,57,7.0,False,28.0496,965,1,0,288,262,26
BR1_2731572672,8,False,0,0,0,17412,199,59,7.2,False,12,True,1,0,0,20132,231,56,7.2,True,28.6663,-2720,-4,-1,258,287,-29
BR1_2731553717,9,True,1,0,0,17139,209,46,7.0,True,6,False,0,0,0,16918,225,50,7.0,False,29.67505,221,3,1,255,275,-20
BR1_2730256219,4,True,0,1,0,17296,237,68,7.4,False,13,False,1,0,0,21391,235,63,7.4,True,29.117566666666665,-4095,-9,-1,305,298,7
BR1_2731362646,4,False,0,0,0,16405,222,40,6.8,False,5,True,1,0,0,16515,236,76,7.0,True,25.007816666666667,-110,-1,-1,262,312,-50
BR1_2730877661,7,True,1,0,0,17624,248,47,7.4,True,8,False,0,0,0,18135,230,44,7.4,False,29.010683333333333,-511,-1,1,295,274,21
BR1_2731667225,3,False,0,1,0,13854,156,64,6.6,False,6,True,1,0,0,15798,178,59,7.0,True,25.811716666666666,-1944,-3,-1,220,237,-17
BR1_2731252726,14,True,1,1,0,19031,207,44,6.8,True,2,False,0,0,0,15188,195,52,6.6,False,26.633816666666668,3843,12,1,251,247,4
BR1_2731563401,8,False,0,1,0,17305,173,72,7.4,True,3,True,0,0,0,14846,190,44,6.8,False,28.649266666666666,2459,5,0,245,234,11
BR1_2731550368,7,True,1,0,0,16978,200,52,6.6,True,1,False,0,1,0,13705,193,52,6.4,False,25.392366666666668,3273,6,1,252,245,7
BR1_2731387647,3,True,0,1,0,17396,270,68,7.6,True,4,False,1,0,0,18589,282,80,7.6,False,27.59251666666667,-1193,-1,-1,338,362,-24
BR1_2731381287,10,True,0,0,0,18209,211,53,7.0,False,8,False,1,0,0,18475,190,68,7.0,True,29.16595,-266,2,-1,264,258,6
BR1_2731350202,3,True,0,0,0,13837,161,48,6.2,False,6,False,1,0,0,16479,225,54,6.8,True,25.9679,-2642,-3,-1,209,279,-70
BR1_2701983502,10,True,1,0,0,18023,192,44,7.4,True,4,False,0,0,0,16857,223,60,7.4,False,27.704483333333332,1166,6,1,236,283,-47
BR1_2697805330,5,True,1,1,0,16041,235,52,7.0,True,6,False,0,0,0,15280,172,48,6.8,False,25.539633333333335,761,-1,1,287,220,67
BR1_2696932867,10,True,0,0,0,17861,221,36,7.0,True,5,False,0,0,0,15166,156,56,6.6,False,27.4411,2695,5,0,257,212,45
BR1_2730045422,12,False,1,0,0,18420,171,40,7.2,False,14,True,0,0,0,21225,208,76,7.4,True,29.9321,-2805,-2,1,211,284,-73
BR1_2728574292,10,True,0,0,0,18251,198,56,7.0,True,7,False,0,0,0,17081,222,44,7.0,False,29.205566666666666,1170,3,0,254,266,-12
BR1_2731739958,10,False,0,0,0,18982,201,60,7.4,False,8,True,1,1,0,19252,224,55,7.4,True,28.813133333333333,-270,2,-1,261,279,-18
BR1_2728387397,7,False,0,0,0,16319,192,62,6.6,False,9,True,1,0,0,16944,180,56,7.0,True,26.041933333333333,-625,-2,-1,254,236,18
BR1_2730179232,9,False,0,1,0,18683,189,65,7.2,True,6,True,0,0,0,15937,185,42,6.6,False,26.6103,2746,3,0,254,227,27
BR1_2730135113,8,True,0,0,0,17393,155,52,6.8,False,7,False,1,1,0,16966,181,59,7.0,True,26.18785,427,1,-1,207,240,-33
BR1_2727147319,4,True,1,0,0,15993,205,52,7.0,True,1,False,0,0,0,13847,199,52,6.4,False,26.47105,2146,3,1,257,251,6
BR1_2731656913,3,False,0,0,0,15076,200,52,7.0,True,6,True,1,0,1,19110,218,60,7.4,False,28.846766666666667,-4034,-3,-1,252,278,-26
BR1_2727057959,13,True,1,0,0,21299,233,52,7.4,True,4,False,0,1,0,15907,186,48,6.6,False,28.445833333333333,5392,9,1,285,234,51
BR1_2731725975,4,False,0,1,0,16811,224,60,7.4,True,5,True,1,0,0,17302,249,47,7.4,False,29.053116666666668,-491,-1,-1,284,296,-12
BR1_2731227646,9,False,1,1,0,18146,211,48,6.8,True,3,True,0,0,0,15514,189,52,6.4,False,26.477516666666666,2632,6,1,259,241,18
BR1_2730836862,4,False,1,0,0,16511,212,56,7.0,False,10,True,0,1,0,19895,231,52,7.6,True,29.7078,-3384,-6,1,268,283,-15
BR1_2722158713,2,False,0,0,0,12844,168,44,6.4,False,9,True,0,0,0,18229,199,60,7.0,True,27.030383333333333,-5385,-7,0,212,259,-47
BR1_2722108234,3,False,1,0,0,13769,175,48,6.8,True,3,True,0,0,0,14332,190,42,6.6,False,27.4453,-563,0,1,223,232,-9
BR1_2722000905,15,False,1,0,0,20369,208,60,7.0,True,10,True,0,1,0,17494,181,48,6.6,False,25.25845,2875,5,1,268,229,39
BR1_2721951979,13,True,1,0,0,20247,211,60,7.6,False,7,False,0,1,0,17198,193,56,7.0,True,29.418033333333334,3049,6,1,271,249,22
BR1_2697562595,6,True,1,0,0,17986,246,56,7.2,False,7,False,0,1,0,18191,240,48,7.6,True,28.4714,-205,-1,1,302,288,14
BR1_2697484163,10,False,1,0,0,18398,218,49,7.2,True,8,True,0,1,0,18396,187,60,7.2,False,29.477483333333332,2,2,1,267,247,20
BR1_2730458820,8,False,1,0,0,18238,227,56,7.6,False,9,True,0,1,0,18632,210,61,7.8,True,29.097133333333332,-394,-1,1,283,271,12
BR1_2729464013,8,True,1,1,0,18667,234,64,7.6,True,9,False,0,0,0,19554,266,62,7.6,False,29.11615,-887,-1,1,298,328,-30
BR1_2731487955,7,True,0,1,0,16743,208,44,6.8,True,7,False,1,0,0,16628,215,72,7.0,False,26.95325,115,0,-1,252,287,-35
BR1_2722232520,6,True,1,0,0,16597,204,62,7.2,True,1,False,0,0,0,12077,135,45,6.2,False,25.282433333333334,4520,5,1,266,180,86
BR1_2722215074,3,False,0,1,0,13960,195,54,6.6,True,6,True,1,0,0,17023,220,56,7.0,False,26.401783333333334,-3063,-3,-1,249,276,-27
BR1_2731325905,4,False,0,0,0,14860,182,60,6.8,True,6,True,1,1,0,15025,176,60,6.6,False,27.47125,-165,-2,-1,242,236,6
BR1_2721837242,6,True,1,0,0,16419,208,56,7.0,True,4,False,0,0,0,15328,197,52,6.6,False,26.511016666666666,1091,2,1,264,249,15
BR1_2731528792,6,True,1,0,0,19556,247,59,7.6,False,7,False,0,1,1,18643,217,40,7.2,True,27.603016666666665,913,-1,1,306,257,49
BR1_2731499958,2,False,0,0,0,15497,222,52,7.6,False,2,True,1,0,0,16252,260,65,7.4,True,28.11875,-755,0,-1,274,325,-51
BR1_2731480198,11,True,0,1,0,18749,241,33,6.8,True,4,False,1,0,0,15233,176,47,6.6,False,26.224383333333332,3516,7,-1,274,223,51
BR1_2722999665,10,False,1,0,0,17775,195,44,7.0,False,11,True,0,0,0,20210,204,60,7.4,True,29.335233333333335,-2435,-1,1,239,264,-25
BR1_2729773931,6,True,1,1,0,17894,226,65,7.6,False,9,False,0,0,0,19301,258,60,7.8,True,28.18625,-1407,-3,1,291,318,-27
BR1_2729133479,4,True,0,0,0,16718,241,48,7.2,False,6,False,1,0,0,17289,241,52,7.2,True,27.510666666666665,-571,-2,-1,289,293,-4
BR1_2729112905,10,True,1,0,0,17546,173,58,6.4,True,5,False,0,1,0,15656,184,64,6.6,False,25.928633333333334,1890,5,1,231,248,-17
BR1_2727885959,6,False,1,0,0,17164,239,52,7.2,False,9,True,0,1,0,18796,222,52,7.4,True,27.66815,-1632,-3,1,291,274,17
BR1_2731214862,9,False,0,0,0,17575,208,52,6.8,False,4,True,1,0,0,15469,200,68,6.8,True,26.976683333333334,2106,5,-1,260,268,-8
BR1_2731352572,10,True,1,0,0,17959,196,61,6.8,True,4,False,0,0,0,15837,191,48,6.8,False,27.178883333333335,2122,6,1,257,239,18
BR1_2731348025,7,True,1,0,0,16066,194,56,6.8,True,8,False,0,0,0,17575,174,60,6.8,False,26.20585,-1509,-1,1,250,234,16
BR1_2726554966,10,False,1,0,0,18392,204,48,7.2,False,10,True,0,0,0,20396,248,60,7.6,True,29.079233333333335,-2004,0,1,252,308,-56
BR1_2724803256,7,True,1,0,0,18525,224,64,7.2,True,2,False,0,0,0,15724,248,51,7.4,False,28.622233333333334,2801,5,1,288,299,-11
BR1_2724788989,14,True,0,1,0,20786,205,80,7.4,True,6,False,1,0,0,16391,172,60,6.8,False,28.962633333333333,4395,8,-1,285,232,53
BR1_2731366490,7,True,0,0,0,15489,130,48,6.0,False,12,False,0,1,0,20122,190,56,7.0,True,27.31735,-4633,-5,0,178,246,-68
BR1_2731339912,8,False,0,0,0,15924,183,52,6.8,False,7,True,0,0,0,16221,178,44,6.4,True,26.584883333333334,-297,1,0,235,222,13
BR1_2731302748,6,False,0,0,0,17218,197,51,7.2,False,10,True,0,1,0,19128,235,54,7.8,True,27.701433333333334,-1910,-4,0,248,289,-41
BR1_2726983731,18,True,0,0,1,23871,262,60,8.0,True,9,False,1,0,0,17210,191,60,7.2,False,28.586183333333334,6661,9,-1,322,251,71
BR1_2731227975,10,False,0,0,0,19739,195,68,7.2,True,5,True,0,0,0,16521,225,52,6.8,False,29.496933333333335,3218,5,0,263,277,-14
BR1_2731199483,10,True,0,0,0,17853,196,64,7.0,True,6,False,0,0,0,15824,210,40,6.8,False,27.353883333333332,2029,4,0,260,250,10
BR1_2731052243,9,False,0,0,0,19273,245,60,7.4,False,3,True,0,0,0,16002,201,64,6.8,True,29.015866666666668,3271,6,0,305,265,40
BR1_2730797081,6,False,0,0,0,14631,174,44,6.4,False,9,True,0,0,0,17406,179,60,6.8,True,25.9968,-2775,-3,0,218,239,-21
BR1_2728582144,7,False,0,1,0,17911,232,60,7.6,False,8,True,1,0,0,17933,224,56,7.8,True,27.847083333333334,-22,-1,-1,292,280,12
BR1_2728369851,8,True,1,0,0,18618,230,56,7.0,False,7,False,0,1,0,17531,190,42,7.0,True,28.177233333333334,1087,1,1,286,232,54
BR1_2729405024,6,False,1,0,0,17521,224,60,7.6,True,10,True,0,0,0,17842,203,52,7.4,False,28.544083333333333,-321,-4,1,284,255,29
BR1_2727690588,6,True,0,1,0,15999,186,48,6.8,True,3,False,0,0,0,14419,211,44,6.4,False,26.297,1580,3,0,234,255,-21
BR1_2714473813,4,True,1,0,0,15119,208,64,7.0,True,4,False,0,0,0,15437,218,56,7.0,False,27.374816666666668,-318,0,1,272,274,-2
BR1_2728324497,6,False,0,0,0,15721,177,52,6.6,False,14,True,0,0,0,19483,197,40,6.8,True,26.57785,-3762,-8,0,229,237,-8
BR1_2731108972,5,True,0,1,0,17050,201,50,7.0,False,15,False,1,0,0,20295,226,64,7.8,True,28.193183333333334,-3245,-10,-1,251,290,-39
BR1_2726447131,7,True,0,0,0,16274,175,56,6.8,False,7,False,0,0,0,16005,193,52,7.0,True,27.060116666666666,269,0,0,231,245,-14
BR1_2724629020,6,False,0,0,0,17028,216,44,7.0,True,4,True,0,0,0,16968,239,64,7.0,False,28.662166666666668,60,2,0,260,303,-43
BR1_2722692562,4,True,0,0,1,18798,239,56,7.4,True,6,False,1,0,0,16192,187,48,7.4,False,29.879833333333334,2606,-2,-1,295,235,60
BR1_2721307519,4,False,0,0,0,14347,172,40,6.6,False,7,True,1,0,0,16802,194,52,7.0,True,27.0737,-2455,-3,-1,212,246,-34
BR1_2700414012,13,False,1,0,0,18091,192,60,6.8,True,7,True,0,0,0,16224,192,28,6.4,False,26.715916666666665,1867,6,1,252,220,32
BR1_2700380550,7,False,0,1,0,17621,178,64,7.2,False,7,True,1,0,0,16940,212,56,7.0,True,27.85868333333333,681,0,-1,242,268,-26
BR1_2730166066,9,False,1,0,0,18579,261,52,7.4,True,4,True,0,0,0,16604,229,48,7.0,False,29.594633333333334,1975,5,1,313,277,36
BR1_2725560553,5,False,1,0,0,16714,196,66,7.0,True,8,True,0,0,0,17034,217,51,7.0,False,27.00395,-320,-3,1,262,268,-6
BR1_2729681687,3,False,0,0,0,14749,187,47,6.6,False,13,True,1,0,0,18727,198,56,7.0,True,25.385166666666667,-3978,-10,-1,234,254,-20
BR1_2729596054,3,True,0,0,0,13804,167,44,6.4,False,7,False,1,0,0,17355,205,52,7.2,True,25.838216666666668,-3551,-4,-1,211,257,-46
BR1_2730406162,2,False,0,0,0,15779,225,64,7.2,False,6,True,0,1,0,18862,279,44,7.6,True,27.534333333333333,-3083,-4,0,289,323,-34
BR1_2731102021,2,False,1,1,0,15925,227,68,7.4,True,5,True,0,0,0,17722,226,60,7.2,False,29.699116666666665,-1797,-3,1,295,286,9
BR1_2730426867,8,True,0,0,0,16503,169,32,6.6,False,10,False,0,0,0,18083,206,40,6.6,True,25.731733333333334,-1580,-2,0,201,246,-45
BR1_2728779717,5,True,0,0,0,16678,200,64,7.2,False,8,False,1,0,0,17580,207,52,7.2,True,28.823783333333335,-902,-3,-1,264,259,5
BR1_2727489503,9,True,0,0,0,17800,217,48,6.8,True,5,False,0,0,0,15888,233,40,6.6,False,25.2399,1912,4,0,265,273,-8
BR1_2731707697,12,True,1,0,0,19793,246,60,7.6,True,4,False,0,0,0,16804,220,76,7.4,False,28.225933333333334,2989,8,1,306,296,10
BR1_2731652398,10,True,0,0,0,19487,240,64,7.6,True,8,False,1,1,0,18587,222,60,7.2,False,29.10755,900,2,-1,304,282,22
BR1_2692513723,6,False,0,0,0,17243,208,56,6.8,False,9,True,1,0,0,18891,213,64,7.0,True,29.420616666666668,-1648,-3,-1,264,277,-13
BR1_2730138016,13,True,1,0,0,18804,182,64,7.2,True,5,False,0,0,0,15887,199,44,7.0,False,29.678983333333335,2917,8,1,246,243,3
BR1_2731652217,5,True,1,0,0,16991,225,62,7.2,False,6,False,0,0,0,17751,228,68,7.4,True,29.968733333333333,-760,-1,1,287,296,-9
BR1_2730066841,8,False,0,0,0,16099,160,54,6.4,True,9,True,0,0,0,17874,220,54,7.0,False,25.563466666666667,-1775,-1,0,214,274,-60
BR1_2700815170,10,False,1,0,0,17703,207,56,6.8,True,3,True,0,1,0,14510,182,40,6.2,False,25.8079,3193,7,1,263,222,41
BR1_2700199038,10,True,1,1,0,17023,202,60,7.0,False,9,False,0,0,0,16497,207,40,6.4,True,26.55845,526,1,1,262,247,15
BR1_2699223663,5,True,1,0,0,15022,175,44,6.4,False,8,False,0,0,0,18125,207,76,7.0,True,25.33675,-3103,-3,1,219,283,-64
BR1_2731200997,3,True,0,1,0,15837,235,50,7.4,False,4,False,1,0,0,16327,214,64,7.4,True,28.496983333333333,-490,-1,-1,285,278,7
BR1_2729729274,8,True,0,1,0,18191,198,56,7.4,False,5,False,1,0,0,17096,240,52,7.2,True,29.593916666666665,1095,3,-1,254,292,-38
BR1_2731004854,9,False,0,0,0,17880,211,60,7.0,True,7,True,0,0,0,17242,203,48,7.0,False,29.6329,638,2,0,271,251,20
BR1_2731276898,7,True,1,0,0,18169,192,68,7.0,True,16,False,0,0,0,20070,152,56,7.4,False,29.985166666666668,-1901,-9,1,260,208,52
BR1_2731530890,7,True,1,0,0,17716,227,60,7.2,True,3,False,0,1,0,17026,230,60,7.4,False,28.32968333333333,690,4,1,287,290,-3
BR1_2731517737,9,False,0,0,0,18381,194,52,7.0,True,11,True,0,0,0,19433,175,48,7.0,False,27.958083333333335,-1052,-2,0,246,223,23
BR1_2731436929,4,True,1,0,0,16806,227,52,7.2,False,8,False,0,1,0,19590,249,64,7.4,True,29.434166666666666,-2784,-4,1,279,313,-34
BR1_2731431152,11,True,0,1,0,19951,245,48,7.6,False,9,False,0,0,0,19091,203,64,7.4,True,27.725533333333335,860,2,0,293,267,26
BR1_2731417933,10,True,1,1,0,19739,225,66,7.4,True,6,False,0,0,0,15971,190,48,6.8,False,28.972416666666668,3768,4,1,291,238,53
BR1_2731346160,5,False,0,0,0,17406,236,62,7.4,True,4,True,0,0,0,15837,196,52,6.8,False,27.96385,1569,1,0,298,248,50
BR1_2730817057,14,False,1,0,0,21163,214,48,7.2,True,8,True,0,0,0,18474,214,44,6.8,False,27.645266666666668,2689,6,1,262,258,4
BR1_2708059586,3,True,1,0,0,15342,198,68,7.2,False,6,False,0,1,0,17377,205,56,7.2,True,29.062316666666668,-2035,-3,1,266,261,5
BR1_2731185925,3,False,0,0,0,14351,183,56,6.4,False,9,True,1,0,0,17630,196,72,7.0,True,26.802666666666667,-3279,-6,-1,239,268,-29
BR1_2727719422,3,False,0,0,0,14307,206,44,6.8,True,6,True,0,0,0,16602,193,60,7.0,False,25.0068,-2295,-3,0,250,253,-3
BR1_2719564711,7,False,1,1,0,18918,227,60,7.6,True,9,True,0,0,0,18580,229,67,7.6,False,28.033316666666668,338,-2,1,287,296,-9
BR1_2708955931,6,False,0,0,0,14841,188,40,6.4,False,10,True,0,0,0,18338,209,52,7.2,True,25.0713,-3497,-4,0,228,261,-33
BR1_2729818796,8,True,0,0,0,16897,214,36,6.8,False,9,False,1,0,0,17780,195,56,6.6,True,25.234816666666667,-883,-1,-1,250,251,-1
BR1_2731594877,2,False,0,0,0,15474,234,52,7.2,False,8,True,1,0,0,18140,255,63,7.6,True,29.68455,-2666,-6,-1,286,318,-32
BR1_2725863792,7,False,0,0,0,15810,147,56,6.6,True,4,True,1,0,0,14530,185,56,6.8,False,26.548483333333333,1280,3,-1,203,241,-38
BR1_2728672053,8,True,1,1,0,19156,251,54,7.4,False,8,False,0,0,0,17854,229,47,7.0,True,29.0948,1302,0,1,305,276,29
BR1_2729442118,13,True,0,1,0,20321,205,44,6.8,True,6,False,0,0,0,15403,179,40,6.8,False,25.635583333333333,4918,7,0,249,219,30
BR1_2729745373,7,True,1,0,0,18828,236,60,7.4,True,4,False,0,0,0,16524,202,68,7.0,False,29.62845,2304,3,1,296,270,26
BR1_2729371483,2,False,0,0,0,13681,188,52,6.6,False,12,True,1,0,0,19548,240,68,7.4,True,25.611133333333335,-5867,-10,-1,240,308,-68
BR1_2731761066,2,False,0,0,0,14238,190,38,6.8,False,13,True,0,1,0,20406,223,58,7.6,True,29.750783333333334,-6168,-11,0,228,281,-53
BR1_2730774439,5,True,0,1,0,17232,227,56,7.6,False,4,False,1,0,0,15846,188,64,7.2,True,29.649733333333334,1386,1,-1,283,252,31
BR1_2729314588,7,False,1,0,0,16627,232,52,6.8,True,3,True,0,0,0,14052,190,36,6.6,False,26.25775,2575,4,1,284,226,58
BR1_2722633415,9,True,0,0,0,19178,213,54,7.4,False,5,False,1,0,0,17398,203,68,7.2,True,29.927516666666666,1780,4,-1,267,271,-4
BR1_2721246887,4,False,0,0,0,16436,205,64,7.4,False,9,True,1,0,0,19513,261,75,7.6,True,27.58695,-3077,-5,-1,269,336,-67
BR1_2731194560,4,False,0,0,0,13812,154,36,6.4,False,11,True,1,0,0,19430,231,64,7.0,True,26.265633333333334,-5618,-7,-1,190,295,-105
BR1_2731163961,7,False,0,0,0,16183,192,52,6.8,False,9,True,0,0,0,16965,198,48,6.6,True,26.696866666666665,-782,-2,0,244,246,-2
BR1_2723041168,8,False,0,0,0,17373,160,52,6.6,False,8,True,1,0,0,17005,199,48,6.6,True,26.159316666666665,368,0,-1,212,247,-35
BR1_2722940043,7,True,0,1,0,16506,172,51,6.6,False,12,False,1,0,0,17827,197,56,7.0,True,27.00725,-1321,-5,-1,223,253,-30
BR1_2730346494,5,True,1,1,0,15589,179,62,7.0,False,4,False,0,0,0,15212,181,56,6.8,True,26.672383333333332,377,1,1,241,237,4
BR1_2731147573,13,False,1,0,0,18643,182,40,6.8,True,11,True,0,0,0,18200,163,44,6.4,False,25.397866666666665,443,2,1,222,207,15
BR1_2731096564,4,False,0,0,0,17127,240,64,7.2,False,4,True,1,0,0,18549,261,68,7.6,True,27.730583333333332,-1422,0,-1,304,329,-25
BR1_2730783973,5,False,1,1,0,17491,228,56,7.4,True,6,True,0,0,0,17727,230,52,7.0,False,28.8543,-236,-1,1,284,282,2
BR1_2729336992,10,True,0,0,0,19447,226,60,7.4,True,9,False,1,0,0,17794,151,52,7.0,False,29.973383333333334,1653,1,-1,286,203,83
BR1_2730261554,3,True,1,0,0,16983,251,56,7.2,True,5,False,0,0,0,17518,246,60,7.4,False,29.310416666666665,-535,-2,1,307,306,1
BR1_2731727837,6,False,1,1,0,17843,199,64,7.2,True,9,True,0,0,0,19566,234,68,7.6,False,27.605116666666667,-1723,-3,1,263,302,-39
BR1_2731317144,1,False,0,0,0,13652,212,45,6.8,False,4,True,0,0,0,16159,258,71,7.2,True,25.6619,-2507,-3,0,257,329,-72
BR1_2712164560,9,True,1,1,0,17563,201,56,7.0,True,4,False,0,0,0,15620,205,64,7.0,False,26.093983333333334,1943,5,1,257,269,-12
BR1_2731508731,12,False,1,0,0,18178,215,64,7.0,True,6,True,0,0,0,15576,169,48,7.0,False,26.07995,2602,6,1,279,217,62
BR1_2696472435,8,False,0,1,1,19228,219,42,7.2,True,12,True,1,0,0,19794,220,68,7.6,False,27.771416666666667,-566,-4,-1,261,288,-27
BR1_2696452805,10,False,0,1,0,18906,178,58,7.2,False,14,True,1,0,0,20430,217,44,7.6,True,29.88865,-1524,-4,-1,236,261,-25
BR1_2724534311,10,True,1,1,0,17682,174,46,6.8,True,15,False,0,0,0,20027,202,61,7.0,False,27.207083333333333,-2345,-5,1,220,263,-43
BR1_2724485393,9,True,0,1,0,19341,215,55,7.2,False,4,False,0,0,0,17889,257,56,7.2,True,28.9558,1452,5,0,270,313,-43
BR1_2721605801,9,False,0,0,0,17404,241,44,7.2,True,7,True,0,1,0,17768,201,48,7.4,False,28.5964,-364,2,0,285,249,36
BR1_2721823224,5,False,0,0,0,17143,226,76,7.4,False,6,True,1,0,0,16794,213,40,6.8,True,28.94605,349,-1,-1,302,253,49
BR1_2717391372,10,True,0,0,0,18710,186,40,7.0,False,15,False,1,0,0,20862,199,44,7.2,True,29.62923333333333,-2152,-5,-1,226,243,-17
BR1_2717364487,10,True,0,0,0,18613,199,52,6.8,True,6,False,0,0,0,15915,193,72,6.8,False,27.483733333333333,2698,4,0,251,265,-14
BR1_2731326898,0,False,0,0,0,14527,236,52,7.2,False,4,True,0,1,0,17486,280,69,7.4,True,29.070783333333335,-2959,-4,0,288,349,-61
BR1_2725541372,9,False,0,0,0,16012,171,64,7.0,False,5,True,1,0,0,15817,190,72,6.8,True,26.476016666666666,195,4,-1,235,262,-27
BR1_2725480195,7,False,0,0,0,17721,217,72,7.6,False,8,True,1,0,0,17732,220,72,7.4,True,28.467983333333333,-11,-1,-1,289,292,-3
BR1_2727847374,3,False,0,1,0,16421,211,64,7.2,False,6,True,1,0,0,17330,221,56,7.2,True,28.81448333333333,-909,-3,-1,275,277,-2
BR1_2724118717,8,True,0,1,0,18628,203,54,7.4,False,10,False,1,0,0,20510,235,58,7.2,True,29.0111,-1882,-2,-1,257,293,-36
BR1_2731453160,4,True,0,0,0,16113,192,60,7.2,False,11,False,1,0,0,19338,210,72,7.6,True,29.70475,-3225,-7,-1,252,282,-30
BR1_2730478646,5,False,0,1,0,17628,248,62,7.6,True,5,True,0,0,0,16890,214,57,7.2,False,28.187966666666668,738,0,0,310,271,39
BR1_2730233122,6,False,0,0,0,16463,190,52,6.6,False,15,True,0,0,0,20295,217,48,7.6,True,29.802316666666666,-3832,-9,0,242,265,-23
BR1_2729796942,5,False,0,1,0,16802,157,65,7.0,True,10,True,1,0,0,18889,233,58,7.6,False,29.861966666666667,-2087,-5,-1,222,291,-69
BR1_2729764396,4,True,0,0,0,16044,248,48,7.4,True,1,False,0,1,0,15529,233,56,7.4,False,28.415933333333335,515,3,0,296,289,7
BR1_2731648786,8,False,0,0,0,18883,207,53,7.2,False,9,True,1,1,0,19325,221,67,7.2,True,29.00945,-442,-1,-1,260,288,-28
BR1_2731104567,1,False,1,0,0,14541,214,68,6.6,True,3,True,0,0,0,14173,189,28,6.2,False,27.138683333333333,368,-2,1,282,217,65
BR1_2730957502,11,False,1,0,0,18797,161,66,7.0,True,12,True,0,0,0,19693,230,54,7.2,False,28.321666666666665,-896,-1,1,227,284,-57
BR1_2712161899,4,False,1,0,1,12900,148,52,6.2,False,9,True,0,1,0,18657,196,60,6.6,True,26.94386666666667,-5757,-5,1,200,256,-56
BR1_2729174626,7,True,0,0,0,16785,218,56,7.2,True,4,False,0,0,0,14331,161,48,6.6,False,26.879716666666667,2454,3,0,274,209,65
BR1_2726963700,7,False,1,0,0,18059,231,44,7.4,False,8,True,0,1,0,19102,228,68,7.4,True,27.699716666666667,-1043,-1,1,275,296,-21
BR1_2731689378,13,True,1,1,0,21611,222,48,7.4,True,5,False,0,0,0,16423,208,42,7.0,False,27.69975,5188,8,1,270,250,20
BR1_2731284261,10,False,0,0,0,16692,190,32,6.2,False,10,True,1,0,0,18063,187,60,6.8,True,26.279666666666667,-1371,0,-1,222,247,-25
BR1_2711586431,4,False,0,0,0,14372,146,36,6.2,False,12,True,1,0,0,18782,191,67,7.2,True,26.54385,-4410,-8,-1,182,258,-76
BR1_2730725154,13,False,1,0,0,19562,177,51,7.6,True,8,True,0,0,0,17454,175,44,7.0,False,28.476333333333333,2108,5,1,228,219,9
BR1_2730688938,11,True,0,0,0,17617,212,45,7.2,True,5,False,1,0,0,15269,181,51,6.6,False,26.943966666666668,2348,6,-1,257,232,25
BR1_2729734098,8,False,1,0,1,17591,175,56,6.8,False,8,True,0,0,0,17716,192,40,6.2,True,26.2661,-125,0,1,231,232,-1
BR1_2729709613,6,False,1,0,0,14848,172,52,6.8,True,2,True,0,1,0,13970,188,56,6.8,False,25.60335,878,4,1,224,244,-20
BR1_2691675430,5,False,0,0,0,16032,210,68,7.0,False,9,True,1,0,0,18756,245,48,7.4,True,27.947933333333335,-2724,-4,-1,278,293,-15
BR1_2717937944,11,True,0,0,0,17667,175,60,6.6,True,6,False,0,0,0,17110,198,56,6.8,False,26.238716666666665,557,5,0,235,254,-19
BR1_2706927355,5,False,0,0,0,15919,207,32,6.6,False,11,True,1,0,0,19381,227,48,6.8,True,25.31448333333333,-3462,-6,-1,239,275,-36
BR1_2731280083,9,False,1,1,0,17655,189,56,6.6,True,4,True,0,0,0,14497,186,56,6.4,False,26.1755,3158,5,1,245,242,3
BR1_2730027826,6,False,0,0,0,15883,212,44,6.8,True,4,True,1,0,0,15008,212,52,6.6,False,26.568216666666668,875,2,-1,256,264,-8
BR1_2722444622,9,False,0,0,0,18753,190,52,7.4,False,16,True,1,0,0,20435,190,56,7.4,True,28.63665,-1682,-7,-1,242,246,-4
BR1_2731708930,14,True,1,0,0,20000,224,44,7.2,True,5,False,0,0,0,17212,199,52,7.0,False,29.543333333333333,2788,9,1,268,251,17
BR1_2731205176,8,False,0,0,0,19583,243,60,7.6,True,4,True,1,0,0,15836,206,54,6.8,False,27.578433333333333,3747,4,-1,303,260,43
BR1_2715490382,4,False,0,0,0,14017,168,24,6.8,True,8,True,0,0,0,17425,197,60,7.0,False,26.724866666666667,-3408,-4,0,192,257,-65
BR1_2731658692,12,True,1,0,0,19414,205,72,7.2,False,8,False,0,1,1,19576,223,52,7.2,True,27.578833333333332,-162,4,1,277,275,2
BR1_2730490038,6,True,0,0,0,16385,194,63,6.8,True,6,False,1,0,0,15158,187,48,6.6,False,25.15165,1227,0,-1,257,235,22
BR1_2728475675,15,True,1,0,0,22558,221,61,7.8,True,4,False,0,1,0,15971,161,51,6.8,False,29.556933333333333,6587,11,1,282,212,70
BR1_2731259435,2,True,0,0,0,13551,180,50,6.6,False,4,False,1,0,0,15588,222,53,7.0,True,26.169533333333334,-2037,-2,-1,230,275,-45
BR1_2730713070,4,False,0,1,0,16646,223,56,7.0,False,11,True,1,0,0,19689,211,64,7.4,True,29.0154,-3043,-7,-1,279,275,4
BR1_2729347960,6,False,0,0,0,15794,208,51,6.6,False,6,True,1,0,0,16374,220,52,6.6,True,26.7282,-580,0,-1,259,272,-13
BR1_2728227549,9,False,1,0,0,19898,251,80,7.8,True,8,True,0,1,0,19458,215,64,7.4,False,29.3962,440,1,1,331,279,52
BR1_2729991239,6,True,0,0,0,16566,221,68,7.0,True,4,False,0,1,0,15400,210,60,7.0,False,25.04095,1166,2,0,289,270,19
BR1_2729695538,7,False,1,1,0,15369,151,52,6.6,False,9,True,0,0,0,18110,174,43,6.6,True,27.471766666666667,-2741,-2,1,203,217,-14
BR1_2730193879,10,False,1,0,0,18064,194,40,6.4,True,11,True,0,1,1,19045,168,47,7.0,False,25.593466666666668,-981,-1,1,234,215,19
BR1_2713686703,11,True,1,0,0,19050,191,48,7.0,False,12,False,0,0,0,20178,212,60,7.0,True,29.485233333333333,-1128,-1,1,239,272,-33
BR1_2727811512,9,True,0,0,0,16743,171,56,7.0,True,5,False,0,0,0,16983,210,40,7.0,False,28.27515,-240,4,0,227,250,-23
BR1_2715194706,6,False,1,1,0,16589,226,56,7.2,True,5,True,0,0,0,15247,203,48,7.0,False,27.204133333333335,1342,1,1,282,251,31
BR1_2730140101,5,True,0,1,0,16267,168,50,6.6,False,8,False,1,0,0,16974,199,69,7.0,True,26.035283333333332,-707,-3,-1,218,268,-50
BR1_2710249656,8,True,0,0,0,17918,232,32,7.0,False,5,False,1,1,0,17572,208,80,7.2,True,29.991316666666666,346,3,-1,264,288,-24
BR1_2730061347,7,True,1,0,0,18126,224,68,7.6,True,3,False,0,0,0,15793,222,60,7.2,False,27.566966666666666,2333,4,1,292,282,10
BR1_2730034933,10,False,0,0,0,18301,177,47,6.8,False,11,True,0,0,0,19542,235,48,6.8,True,29.036283333333333,-1241,-1,0,224,283,-59
BR1_2729594176,9,True,0,0,0,16070,163,44,6.2,False,7,False,1,0,0,16136,186,48,6.2,True,26.375466666666668,-66,2,-1,207,234,-27
BR1_2731097011,7,True,0,0,0,16471,208,52,6.8,True,2,False,0,0,0,13855,181,48,6.4,False,26.267766666666667,2616,5,0,260,229,31
BR1_2708979104,3,False,0,0,0,13418,165,48,6.6,False,5,True,1,0,0,16178,195,68,6.6,True,27.127083333333335,-2760,-2,-1,213,263,-50
BR1_2730691045,6,False,0,0,0,16620,177,48,6.8,False,10,True,1,0,0,19767,245,64,7.6,True,28.61095,-3147,-4,-1,225,309,-84
BR1_2729777442,19,True,1,1,0,23997,200,71,7.4,False,7,False,0,0,0,16548,184,44,6.8,True,29.905433333333335,7449,12,1,271,228,43
BR1_2704128545,8,True,1,0,0,18233,183,64,7.2,True,4,False,0,1,0,15191,171,40,6.6,False,27.702616666666668,3042,4,1,247,211,36
BR1_2731615697,8,True,1,1,0,16645,176,59,7.2,False,4,False,0,0,0,15353,209,52,6.6,True,26.4567,1292,4,1,235,261,-26
BR1_2704549176,8,True,0,0,1,19313,205,44,7.2,False,5,False,1,1,0,18015,200,68,7.4,True,29.0189,1298,3,-1,249,268,-19
BR1_2704436813,10,True,0,0,0,18862,199,52,7.2,True,8,False,1,0,0,19176,204,64,7.0,False,29.19295,-314,2,-1,251,268,-17
BR1_2730958175,10,True,0,0,0,17043,188,36,6.8,False,10,False,1,0,0,17632,181,44,6.8,True,26.161916666666666,-589,0,-1,224,225,-1
BR1_2718337971,6,False,1,0,0,16260,188,60,7.2,True,5,True,0,1,0,15251,189,48,6.6,False,27.341483333333333,1009,1,1,248,237,11
BR1_2718321515,7,True,1,0,0,18195,223,64,7.0,True,7,False,0,1,0,18377,189,72,7.2,False,29.241216666666666,-182,0,1,287,261,26
BR1_2731641913,4,False,1,0,0,16709,239,68,7.6,True,4,True,0,1,0,15986,195,60,7.2,False,28.62836666666667,723,0,1,307,255,52
BR1_2731628099,15,True,0,0,0,20568,210,52,7.4,True,9,False,1,1,0,18985,179,79,6.8,False,27.89255,1583,6,-1,262,258,4
BR1_2730646369,6,False,0,1,0,14759,148,56,6.4,False,6,True,1,0,0,15652,165,48,6.6,True,26.1999,-893,0,-1,204,213,-9
BR1_2731352529,7,True,1,0,0,16490,199,68,7.2,False,6,False,0,1,0,17970,225,52,7.2,True,27.525283333333334,-1480,1,1,267,277,-10
BR1_2731587859,8,False,0,1,0,18338,242,51,7.8,True,7,True,1,0,0,16782,174,68,7.4,False,28.715966666666667,1556,1,-1,293,242,51
BR1_2731467909,7,False,1,0,0,17471,218,52,7.0,True,7,True,0,0,0,18567,221,60,7.2,False,28.3058,-1096,0,1,270,281,-11
BR1_2718128729,4,False,0,1,0,14736,166,64,6.8,True,7,True,0,0,0,16307,209,40,7.0,False,26.5219,-1571,-3,0,230,249,-19
BR1_2708735401,9,False,0,0,0,18589,202,52,7.6,False,6,True,0,1,0,16865,203,48,7.2,True,28.9983,1724,3,0,254,251,3
BR1_2730246150,5,False,0,0,0,15921,171,56,6.8,True,10,True,1,0,0,21393,269,68,7.6,False,29.182066666666667,-5472,-5,-1,227,337,-110
BR1_2730002340,6,False,0,1,0,16156,197,48,6.6,False,11,True,1,0,0,17365,192,49,6.4,True,26.22555,-1209,-5,-1,245,241,4
BR1_2715297815,6,False,0,0,0,15940,200,66,6.8,False,7,True,1,1,0,17260,204,61,7.0,True,25.07025,-1320,-1,-1,266,265,1
BR1_2726833976,13,False,0,1,0,19847,178,40,6.8,False,9,True,1,0,0,20377,245,52,7.2,True,27.928166666666666,-530,4,-1,218,297,-79
BR1_2730341497,8,False,0,0,0,17091,193,48,6.8,True,8,True,1,0,0,16984,199,56,7.0,False,27.118766666666666,107,0,-1,241,255,-14
BR1_2730327113,12,True,0,0,0,18292,222,44,7.0,True,9,False,0,0,0,16655,191,40,6.6,False,26.67878333333333,1637,3,0,266,231,35
BR1_2730299122,8,True,0,1,0,17300,186,52,6.4,True,10,False,0,0,0,17074,182,36,6.4,False,26.19425,226,-2,0,238,218,20
BR1_2728263043,9,False,0,1,0,19122,228,69,7.6,True,9,True,1,0,0,17860,236,56,7.4,False,28.60305,1262,0,-1,297,292,5
BR1_2727207372,8,False,0,0,0,19335,237,48,7.4,False,5,True,1,0,0,16763,220,62,7.2,True,29.0535,2572,3,-1,285,282,3
BR1_2727033972,6,False,0,0,0,15481,165,52,6.6,False,12,True,1,0,0,18277,181,60,6.8,True,25.4862,-2796,-6,-1,217,241,-24
BR1_2722376738,6,True,1,0,0,17385,221,60,7.4,False,6,False,0,1,0,17725,245,56,7.6,True,29.635016666666665,-340,0,1,281,301,-20
BR1_2668907556,9,False,0,0,0,17546,181,64,7.2,False,14,True,1,0,0,20325,226,54,7.6,True,28.925766666666668,-2779,-5,-1,245,280,-35
BR1_2668894290,8,True,0,0,0,17934,198,60,7.2,True,9,False,0,0,0,17831,178,52,7.2,False,26.6109,103,-1,0,258,230,28
BR1_2730102671,2,False,0,0,0,14934,206,68,7.4,False,6,True,1,0,0,18138,261,52,7.4,True,28.350833333333334,-3204,-4,-1,274,313,-39
BR1_2731156792,7,False,0,0,0,17948,214,56,7.4,True,5,True,1,1,1,17632,187,55,7.0,False,29.30845,316,2,-1,270,242,28
BR1_2727552040,10,False,0,0,0,18742,208,68,7.4,False,6,True,1,0,0,17175,255,48,7.2,True,28.176766666666666,1567,4,-1,276,303,-27
BR1_2720260096,5,True,1,0,0,15845,206,48,6.8,True,7,False,0,1,0,15877,164,48,6.4,False,26.163983333333334,-32,-2,1,254,212,42
BR1_2719400494,8,True,0,0,0,17453,202,44,6.6,False,10,False,1,0,0,17444,191,63,7.2,True,25.44135,9,-2,-1,246,254,-8
BR1_2671722746,9,False,0,0,0,17270,189,48,7.2,True,14,True,1,1,0,22120,227,56,7.8,False,29.606666666666666,-4850,-5,-1,237,283,-46
BR1_2671705156,8,True,0,0,0,18970,257,56,7.6,True,5,False,1,1,0,16731,198,52,7.2,False,29.212283333333332,2239,3,-1,313,250,63
BR1_2671679281,6,False,0,1,0,17097,219,56,7.2,False,11,True,0,0,0,19521,215,72,7.8,True,27.9066,-2424,-5,0,275,287,-12
BR1_2669329631,7,True,0,0,0,17423,211,48,7.0,False,12,False,1,1,0,20373,201,60,7.6,True,27.90065,-2950,-5,-1,259,261,-2
BR1_2730852381,5,True,0,1,0,17405,217,64,7.4,False,4,False,1,0,0,16793,225,56,7.2,True,28.6277,612,1,-1,281,281,0
BR1_2730841304,2,False,1,0,0,15344,204,56,7.4,False,5,True,0,1,0,17478,216,60,7.2,True,29.0304,-2134,-3,1,260,276,-16
BR1_2730379520,7,False,0,0,0,16905,203,60,7.2,False,7,True,1,0,0,18403,233,59,7.6,True,28.5976,-1498,0,-1,263,292,-29
BR1_2726060637,8,True,1,0,0,18190,191,60,7.6,True,5,False,0,1,0,17084,226,47,7.4,False,29.552833333333332,1106,3,1,251,273,-22
BR1_2727687014,11,False,0,1,0,19435,212,44,7.6,False,11,True,1,0,0,19477,199,52,7.6,True,28.265833333333333,-42,0,-1,256,251,5
BR1_2726029302,6,True,1,0,0,17673,208,64,7.4,True,8,False,0,1,0,18023,194,60,7.2,False,28.6523,-350,-2,1,272,254,18
BR1_2713509530,7,False,0,1,0,17979,241,56,7.4,True,4,True,1,0,0,16840,253,52,7.4,False,28.318733333333334,1139,3,-1,297,305,-8
BR1_2713139545,6,True,1,0,0,17074,200,48,6.6,True,4,False,0,0,0,14194,176,47,6.4,False,25.6366,2880,2,1,248,223,25
BR1_2728833433,9,False,0,0,0,17050,178,36,6.6,False,9,True,1,0,0,17770,194,76,6.8,True,25.712483333333335,-720,0,-1,214,270,-56
BR1_2730281400,5,False,1,0,0,17261,234,68,7.2,True,8,True,0,0,0,18131,211,52,7.2,False,27.513983333333332,-870,-3,1,302,263,39
BR1_2725474717,9,True,0,0,0,18670,214,52,7.2,True,5,False,1,1,0,17124,206,51,7.0,False,28.033383333333333,1546,4,-1,266,257,9
BR1_2715377021,4,True,1,0,0,16388,221,52,7.0,True,4,False,0,0,0,14754,168,49,6.6,False,25.402816666666666,1634,0,1,273,217,56
BR1_2730296264,12,True,0,0,0,21376,275,48,7.6,False,6,False,1,0,0,18678,240,52,7.6,True,28.532316666666667,2698,6,-1,323,292,31
BR1_2729962819,12,True,0,0,0,19791,208,79,7.6,True,5,False,0,0,0,15478,183,32,6.6,False,29.959633333333333,4313,7,0,287,215,72
BR1_2729732653,10,True,1,0,0,18375,217,60,7.0,True,8,False,0,0,0,16554,175,44,6.8,False,25.188833333333335,1821,2,1,277,219,58
BR1_2729708820,15,True,0,1,1,22015,185,72,7.6,True,3,False,1,0,0,15305,216,52,7.0,False,28.232216666666666,6710,12,-1,257,268,-11
BR1_2729899479,2,False,0,0,0,16543,250,68,7.0,True,9,True,1,1,0,18708,171,60,7.0,False,27.5179,-2165,-7,-1,318,231,87
BR1_2723374863,5,False,1,0,0,15874,209,56,6.8,False,13,True,0,1,0,19636,217,44,7.2,True,27.61075,-3762,-8,1,265,261,4
BR1_2731751948,9,True,0,0,0,19989,229,68,7.4,True,6,False,1,0,0,17074,230,72,7.2,False,29.077983333333332,2915,3,-1,297,302,-5
BR1_2731169475,8,False,0,1,0,18514,188,56,7.4,True,12,True,0,0,0,19540,215,52,7.2,False,27.711016666666666,-1026,-4,0,244,267,-23
BR1_2692171646,4,False,1,1,0,17933,252,68,7.6,True,10,True,0,0,0,19231,253,56,7.4,False,28.3486,-1298,-6,1,320,309,11
BR1_2692148755,4,True,0,0,0,13651,157,52,6.4,False,5,False,1,1,0,15830,211,62,7.0,True,25.866866666666667,-2179,-1,-1,209,273,-64
BR1_2675929061,6,False,1,0,0,15547,193,48,7.0,False,5,True,0,0,0,15178,195,52,6.8,True,27.195616666666666,369,1,1,241,247,-6
BR1_2675880357,7,True,0,0,0,17744,204,52,7.2,True,5,False,0,0,0,15247,182,56,7.2,False,28.004383333333333,2497,2,0,256,238,18
BR1_2718570453,8,True,0,1,0,16836,168,56,7.0,False,7,False,1,0,0,17805,210,60,7.2,True,29.285983333333334,-969,1,-1,224,270,-46
BR1_2697334296,4,True,0,0,0,14117,188,44,6.2,False,6,False,1,1,0,16206,218,48,7.0,True,27.127633333333332,-2089,-2,-1,232,266,-34
BR1_2722396565,3,False,0,1,0,14981,180,56,6.6,False,7,True,1,0,0,16156,149,60,6.4,True,29.59885,-1175,-4,-1,236,209,27
BR1_2699751626,5,False,0,0,0,14936,146,56,6.4,False,9,True,0,0,0,18432,212,46,7.0,True,25.98155,-3496,-4,0,202,258,-56
BR1_2729159912,3,True,0,1,0,15061,165,68,7.2,False,3,False,1,0,0,14853,231,52,6.8,True,25.471466666666668,208,0,-1,233,283,-50
BR1_2726567947,1,False,0,1,0,15237,224,36,7.2,False,4,True,0,0,0,16045,210,48,7.2,True,28.346716666666666,-808,-3,0,260,258,2
BR1_2731079442,14,True,1,0,0,21315,244,76,7.4,True,6,False,0,0,0,17849,208,56,7.0,False,28.3572,3466,8,1,320,264,56
BR1_2731716296,7,False,0,0,0,16750,226,61,7.4,True,5,True,1,0,0,15409,188,44,6.6,False,26.201633333333334,1341,2,-1,287,232,55
BR1_2731693067,6,False,1,1,0,17392,231,56,7.6,True,5,True,0,0,0,17084,225,55,7.2,False,27.956116666666667,308,1,1,287,280,7
BR1_2731663434,5,True,0,0,0,16123,183,45,6.6,False,8,False,1,1,1,18619,239,60,7.0,True,26.953783333333334,-2496,-3,-1,228,299,-71
BR1_2721817243,9,True,1,0,0,18685,252,64,7.8,False,4,False,0,0,0,17141,257,52,7.2,True,29.480266666666665,1544,5,1,316,309,7
BR1_2731640269,7,False,1,0,0,15173,153,48,6.6,False,8,True,0,1,0,18204,208,42,7.0,True,27.157916666666665,-3031,-1,1,201,250,-49
BR1_2730773542,12,False,0,0,0,20104,179,56,7.2,True,16,True,1,0,0,20752,198,52,7.2,False,28.293483333333334,-648,-4,-1,235,250,-15
BR1_2714906726,10,False,0,1,0,19687,201,64,7.0,False,18,True,0,0,0,22521,258,0,7.2,True,29.58615,-2834,-8,0,265,258,7
BR1_2724872710,7,False,1,1,0,18998,249,64,7.6,True,6,True,0,0,0,18239,242,60,7.6,False,29.859066666666667,759,1,1,313,302,11
BR1_2724070333,6,False,1,0,0,16871,201,64,7.4,False,4,True,0,0,0,17447,236,64,7.4,True,29.72005,-576,2,1,265,300,-35
BR1_2724046152,13,False,0,0,0,20528,205,74,7.6,True,10,True,1,0,0,19500,233,58,7.6,False,28.5646,1028,3,-1,279,291,-12
BR1_2723107701,9,True,0,0,0,18228,200,48,7.0,False,12,False,1,0,0,21074,259,55,7.4,True,28.067383333333332,-2846,-3,-1,248,314,-66
BR1_2731163795,8,True,0,1,0,19318,216,60,6.8,False,9,False,0,0,0,17145,153,60,7.2,True,29.92045,2173,-1,0,276,213,63
BR1_2724835201,7,True,0,1,0,16352,146,46,6.2,False,21,False,1,0,1,24607,215,56,7.0,True,27.553083333333333,-8255,-14,-1,192,271,-79
BR1_2730947345,10,True,1,0,0,19427,245,56,7.6,True,1,False,0,0,0,14851,220,52,6.8,False,27.5888,4576,9,1,301,272,29
BR1_2731591626,4,False,1,1,0,17675,244,58,7.6,True,5,True,0,0,0,15568,192,50,7.2,False,29.25615,2107,-1,1,302,242,60
BR1_2731358295,5,False,0,0,0,15574,205,42,7.0,True,6,True,0,0,0,15929,196,38,6.6,False,27.170783333333333,-355,-1,0,247,234,13
BR1_2729988500,2,True,0,0,0,14138,172,44,6.2,False,9,False,1,0,0,16990,195,63,7.0,True,25.4536,-2852,-7,-1,216,258,-42
BR1_2730528094,16,True,1,0,0,22600,203,56,7.2,False,14,False,0,1,0,22412,173,68,7.2,True,27.747216666666667,188,2,1,259,241,18
BR1_2730362436,7,True,0,0,0,17248,210,52,7.0,False,7,False,0,0,1,17882,229,51,7.4,True,29.634133333333335,-634,0,0,262,280,-18
BR1_2731348090,8,True,1,1,0,17422,219,48,7.0,True,2,False,0,0,0,13422,189,52,6.4,False,26.03095,4000,6,1,267,241,26
BR1_2716299487,11,False,0,1,0,20362,239,60,7.6,True,5,True,1,0,0,18470,277,80,7.6,False,29.268266666666666,1892,6,-1,299,357,-58
BR1_2715420092,7,False,0,0,0,19255,234,64,7.6,True,7,True,1,1,0,18426,226,68,7.2,False,28.893916666666666,829,0,-1,298,294,4
BR1_2731662075,7,True,1,0,0,15396,175,44,6.2,False,9,False,0,1,0,17096,181,60,7.0,True,26.9763,-1700,-2,1,219,241,-22
BR1_2731634266,4,False,0,0,0,15209,192,60,6.8,False,3,True,1,0,0,15068,227,64,7.0,True,26.84555,141,1,-1,252,291,-39
BR1_2729173517,11,False,0,0,1,18789,204,60,7.2,True,4,True,1,1,0,15414,185,48,6.4,False,26.75115,3375,7,-1,264,233,31
BR1_2731746767,7,True,0,0,0,17722,199,60,7.4,True,4,False,1,0,0,16284,196,64,7.2,False,27.831483333333335,1438,3,-1,259,260,-1
BR1_2729811829,4,True,0,1,0,15972,181,70,6.8,False,7,False,1,0,0,17803,209,65,7.4,True,28.845716666666668,-1831,-3,-1,251,274,-23
BR1_2730035347,3,False,0,1,0,15180,187,56,6.6,False,8,True,1,0,0,16809,221,36,6.8,True,26.392983333333333,-1629,-5,-1,243,257,-14
BR1_2726968119,8,True,1,0,0,16997,224,48,7.0,True,6,False,0,1,0,16160,201,44,7.0,False,26.136,837,2,1,272,245,27
BR1_2705432071,6,False,0,0,0,15513,163,64,6.4,False,13,True,1,1,0,19342,222,60,7.2,True,26.5087,-3829,-7,-1,227,282,-55
BR1_2705415736,9,True,1,0,0,16933,186,48,6.6,True,8,False,0,0,0,16141,166,60,6.6,False,26.211583333333333,792,1,1,234,226,8
BR1_2728447095,12,False,1,0,0,20674,204,64,7.2,True,8,True,0,0,0,18316,181,48,6.6,False,28.1993,2358,4,1,268,229,39
BR1_2728413531,4,True,0,0,0,16241,183,63,6.8,True,6,False,1,0,0,17455,230,48,7.2,False,29.91095,-1214,-2,-1,246,278,-32
BR1_2727882060,8,False,1,0,0,16903,201,60,7.2,True,5,True,0,1,0,15364,218,48,6.6,False,26.129816666666667,1539,3,1,261,266,-5
BR1_2725740131,12,True,0,0,0,20766,182,36,6.8,True,19,False,1,1,0,23091,221,60,7.4,False,28.60895,-2325,-7,-1,218,281,-63
BR1_2727910009,10,True,1,1,0,19347,233,68,7.6,True,7,False,0,0,0,17596,241,48,7.4,False,29.699633333333335,1751,3,1,301,289,12
BR1_2731662013,2,False,0,0,0,14174,177,56,6.4,False,9,True,1,1,0,17189,211,44,6.8,True,25.165766666666666,-3015,-7,-1,233,255,-22
BR1_2711899495,10,False,1,1,0,19154,213,68,7.4,True,5,True,0,0,0,17282,210,56,7.0,False,29.301516666666668,1872,5,1,281,266,15
BR1_2691247881,10,False,0,0,0,20426,252,72,7.8,True,4,True,1,0,0,15847,193,48,7.0,False,29.396133333333335,4579,6,-1,324,241,83
BR1_2688264714,7,False,0,1,0,18718,232,64,7.6,True,11,True,1,0,0,18526,201,64,7.6,False,28.00215,192,-4,-1,296,265,31
BR1_2728874441,11,False,1,0,0,16678,149,52,6.4,False,13,True,0,0,0,19329,196,28,6.8,True,26.94305,-2651,-2,1,201,224,-23
BR1_2729999976,4,False,0,0,0,15096,212,60,6.8,False,4,True,1,0,0,16367,237,56,6.8,True,25.263683333333333,-1271,0,-1,272,293,-21
BR1_2729314053,9,False,0,0,0,18801,201,36,7.0,False,10,True,0,0,0,19296,206,51,7.0,True,28.552316666666666,-495,-1,0,237,257,-20
BR1_2726055691,8,False,1,0,0,18644,234,60,7.6,True,4,True,0,1,0,15586,196,68,7.0,False,27.63993333333333,3058,4,1,294,264,30
BR1_2729631544,7,True,0,0,0,18111,246,48,7.2,True,5,False,0,1,0,17597,219,68,7.6,False,28.868033333333333,514,2,0,294,287,7
BR1_2714866839,9,True,0,0,0,16856,168,48,7.2,False,6,False,1,0,0,14848,155,52,6.6,True,27.141,2008,3,-1,216,207,9
BR1_2707074290,12,True,0,0,0,20397,225,60,7.6,True,7,False,0,0,0,17450,187,36,6.8,False,29.527183333333333,2947,5,0,285,223,62
BR1_2703922208,2,False,0,0,0,13641,170,64,6.8,False,11,True,0,0,0,18167,223,60,7.4,True,26.976383333333334,-4526,-9,0,234,283,-49
BR1_2703904260,12,True,0,1,0,20098,216,68,7.6,True,12,False,1,0,0,20105,219,64,7.8,False,28.740916666666667,-7,0,-1,284,283,1
BR1_2703847532,5,True,0,0,0,17011,221,70,7.4,True,5,False,0,0,0,15696,179,46,7.2,False,29.43205,1315,0,0,291,225,66
BR1_2703833976,10,False,1,0,0,18653,215,48,7.2,False,14,True,0,1,0,21272,199,56,7.4,True,28.67665,-2619,-4,1,263,255,8
BR1_2731041255,10,True,1,0,0,17347,201,44,6.6,True,5,False,0,0,0,15286,195,36,6.2,False,26.86135,2061,5,1,245,231,14
BR1_2731025531,7,False,0,1,0,18102,228,56,7.2,True,10,True,1,0,0,19122,210,56,7.6,False,27.566116666666666,-1020,-3,-1,284,266,18
BR1_2725250269,4,True,0,0,0,16180,200,64,7.2,False,10,False,1,1,0,18811,222,44,7.4,True,29.040283333333335,-2631,-6,-1,264,266,-2
BR1_2725211130,14,True,1,1,0,20393,182,56,7.0,True,4,False,0,0,0,15369,190,56,6.2,False,29.424033333333334,5024,10,1,238,246,-8
BR1_2731722211,9,False,0,1,0,19197,228,63,7.4,True,11,True,1,0,0,20487,243,56,7.4,False,29.6289,-1290,-2,-1,291,299,-8
BR1_2731536898,10,True,1,0,1,19994,211,68,7.0,True,7,False,0,1,0,16813,199,56,6.8,False,25.127816666666668,3181,3,1,279,255,24
BR1_2731446886,8,True,1,0,0,18925,243,50,7.4,False,3,False,0,1,0,17017,221,68,7.4,True,28.63695,1908,5,1,293,289,4
BR1_2730957469,5,False,1,1,0,16298,223,56,7.0,True,4,True,0,0,0,15161,226,64,6.8,False,25.650483333333334,1137,1,1,279,290,-11
BR1_2721598680,2,True,1,0,0,13642,190,40,6.6,True,3,False,0,0,0,14453,188,72,6.8,False,25.43475,-811,-1,1,230,260,-30
BR1_2710212584,13,False,1,0,0,20569,211,64,7.4,True,9,True,0,1,0,20036,199,56,7.2,False,29.20315,533,4,1,275,255,20
BR1_2731252279,11,True,0,1,1,19512,209,48,7.0,True,2,False,1,0,0,13543,180,44,6.4,False,25.403683333333333,5969,9,-1,257,224,33
BR1_2731228399,9,False,0,0,0,17030,185,48,7.0,True,5,True,0,1,0,16059,217,52,6.8,False,26.145933333333332,971,4,0,233,269,-36
BR1_2731197802,4,True,0,1,0,16928,220,56,7.0,True,7,False,1,0,0,18307,246,52,7.2,False,29.28725,-1379,-3,-1,276,298,-22
BR1_2730609636,6,True,0,0,0,16940,206,60,7.2,True,4,False,0,1,0,16197,217,40,6.8,False,27.99795,743,2,0,266,257,9
BR1_2730357275,4,False,0,1,0,17299,200,68,7.6,False,9,True,1,0,0,20088,240,68,7.4,True,28.980633333333333,-2789,-5,-1,268,308,-40
BR1_2693803675,3,False,0,0,0,15940,210,56,7.0,False,9,True,1,0,0,19574,268,78,7.4,True,29.072866666666666,-3634,-6,-1,266,346,-80
BR1_2726229542,7,True,1,0,0,15722,184,52,6.4,True,3,False,0,0,0,14121,181,42,6.2,False,27.09113333333333,1601,4,1,236,223,13
BR1_2730982201,7,True,0,0,0,17750,207,43,6.8,True,5,False,0,1,0,16692,217,56,7.0,False,27.63596666666667,1058,2,0,250,273,-23
BR1_2725099739,9,False,0,0,0,18508,234,64,7.2,False,11,True,1,1,0,20351,249,60,7.4,True,29.079833333333333,-1843,-2,-1,298,309,-11
BR1_2685700556,9,False,0,0,0,18298,202,56,7.2,False,12,True,1,0,0,19329,204,52,7.6,True,29.022833333333335,-1031,-3,-1,258,256,2
BR1_2719786331,9,True,0,0,0,20348,258,72,8.0,True,7,False,1,1,0,18836,247,68,7.6,False,29.618466666666666,1512,2,-1,330,315,15
BR1_2719760454,3,False,1,0,0,15414,227,56,7.2,True,3,True,0,1,0,15489,220,56,7.2,False,26.986983333333335,-75,0,1,283,276,7
BR1_2730709560,8,False,1,0,0,15455,155,50,6.6,False,7,True,0,1,0,18025,217,44,6.8,True,25.117583333333332,-2570,1,1,205,261,-56
BR1_2730783056,5,True,0,1,0,15166,193,44,6.8,True,3,False,0,0,0,13563,178,48,6.8,False,26.7029,1603,2,0,237,226,11
BR1_2730439254,4,False,1,0,0,14979,174,52,6.4,True,10,True,0,1,0,17719,186,44,6.4,False,27.246433333333332,-2740,-6,1,226,230,-4
BR1_2720004506,8,True,0,0,0,17358,202,44,6.8,False,5,False,0,0,0,16413,208,39,7.0,True,28.742,945,3,0,246,247,-1
BR1_2730322372,7,True,0,1,0,18627,204,72,7.6,True,3,False,1,0,0,16236,234,52,7.4,False,29.037283333333335,2391,4,-1,276,286,-10
BR1_2729676153,13,False,0,0,0,20545,228,68,7.4,True,12,True,1,0,0,20100,200,63,7.6,False,28.922633333333334,445,1,-1,296,263,33
BR1_2726592724,9,False,0,0,0,17878,175,56,7.2,True,11,True,1,0,0,17679,200,44,6.6,False,25.1365,199,-2,-1,231,244,-13
BR1_2726569962,3,False,1,0,0,14657,190,41,7.2,False,4,True,0,0,0,17265,248,68,7.2,True,28.740283333333334,-2608,-1,1,231,316,-85
BR1_2731244347,8,True,1,1,1,18404,205,64,6.8,True,10,False,0,0,0,16013,149,44,6.2,False,27.22605,2391,-2,1,269,193,76
BR1_2728152940,14,True,1,1,0,19000,200,48,7.0,True,2,False,0,0,0,14273,186,72,6.4,False,25.951466666666665,4727,12,1,248,258,-10
BR1_2730907906,5,False,0,0,0,14699,166,48,6.4,False,10,True,0,1,0,17570,201,44,7.0,True,25.120266666666666,-2871,-5,0,214,245,-31
BR1_2704514060,6,True,1,1,0,15010,181,56,7.0,True,5,False,0,0,0,15950,197,48,7.0,False,25.77785,-940,1,1,237,245,-8
BR1_2731711172,10,False,0,0,0,18262,189,48,7.2,False,7,True,0,0,0,17761,207,60,7.2,True,29.8365,501,3,0,237,267,-30
BR1_2729976029,10,True,0,0,0,19102,212,60,7.6,True,7,False,0,0,0,18790,231,56,7.4,False,29.946433333333335,312,3,0,272,287,-15
BR1_2729258998,5,True,1,0,0,15795,210,52,6.8,True,5,False,0,1,0,14808,177,62,6.4,False,27.016266666666667,987,0,1,262,239,23
BR1_2687982109,7,False,1,0,1,19787,235,72,7.6,True,7,True,0,0,0,17817,205,60,7.2,False,28.9326,1970,0,1,307,265,42
BR1_2687956466,8,True,1,1,0,16940,192,54,7.2,True,6,False,0,0,0,15652,197,57,6.6,False,26.497566666666668,1288,2,1,246,254,-8
BR1_2731437186,11,True,1,0,0,17343,189,40,6.6,True,1,False,0,0,0,13669,190,44,6.8,False,25.067683333333335,3674,10,1,229,234,-5
BR1_2731574745,7,True,1,1,0,17413,211,64,6.6,True,7,False,0,0,0,16043,202,52,6.8,False,25.5174,1370,0,1,275,254,21
BR1_2731553564,12,True,1,0,0,19554,184,56,6.8,True,4,False,0,0,0,14318,153,48,6.0,False,25.753633333333333,5236,8,1,240,201,39
BR1_2731542671,11,True,1,0,0,18854,219,48,7.0,True,5,False,0,1,0,16306,188,63,6.8,False,27.39165,2548,6,1,267,251,16
BR1_2671175365,4,False,0,0,0,16179,211,61,7.2,False,6,True,1,0,0,17207,205,74,7.2,True,28.592366666666667,-1028,-2,-1,272,279,-7
BR1_2671152527,6,True,0,0,0,15425,168,40,6.4,False,7,False,0,1,0,17606,197,60,7.2,True,26.654566666666668,-2181,-1,0,208,257,-49
BR1_2671110486,9,True,0,0,0,17661,220,44,7.0,True,1,False,1,0,0,13175,190,56,6.6,False,26.056466666666665,4486,8,-1,264,246,18
BR1_2671092092,9,False,0,0,0,19468,226,72,7.6,True,6,True,1,1,0,17054,184,56,7.2,False,28.18045,2414,3,-1,298,240,58
BR1_2729163599,9,False,0,0,0,17565,143,48,7.0,False,8,True,1,0,0,18988,219,72,7.2,True,28.25505,-1423,1,-1,191,291,-100
BR1_2729053602,12,True,1,0,0,18185,205,28,6.6,True,9,False,0,0,0,17039,216,34,6.8,False,27.058916666666665,1146,3,1,233,250,-17
BR1_2731560136,10,False,0,0,0,17996,176,51,7.2,False,13,True,1,1,0,20221,197,76,7.2,True,27.915016666666666,-2225,-3,-1,227,273,-46
BR1_2731059908,2,False,1,0,0,13687,171,47,6.8,False,7,True,0,0,0,17189,171,48,6.6,True,27.28001666666667,-3502,-5,1,218,219,-1
BR1_2731009328,13,True,0,0,0,18992,176,48,7.0,True,9,False,0,0,0,16413,165,48,6.6,False,27.347566666666665,2579,4,0,224,213,11
BR1_2730288573,23,False,1,1,0,23849,179,60,7.4,True,15,True,0,0,0,22180,194,56,7.2,False,28.49651666666667,1669,8,1,239,250,-11
BR1_2731447555,10,False,0,1,0,19141,191,40,7.0,False,10,True,1,0,0,18628,210,47,7.2,True,28.452833333333334,513,0,-1,231,257,-26
BR1_2711856378,6,True,0,0,0,17602,273,49,7.2,True,7,False,0,0,0,18339,248,64,7.8,False,29.661066666666667,-737,-1,0,322,312,10
BR1_2728429927,8,True,1,0,0,17153,227,44,7.0,True,4,False,0,0,0,15490,214,56,6.8,False,27.46835,1663,4,1,271,270,1
BR1_2731023156,2,True,0,0,0,16027,259,52,7.4,False,4,False,1,1,0,17503,225,72,7.6,True,29.37435,-1476,-2,-1,311,297,14
BR1_2720733024,4,False,0,0,0,14737,183,44,6.8,False,10,True,1,1,0,17497,176,55,7.0,True,26.0398,-2760,-6,-1,227,231,-4
BR1_2715868473,10,True,1,0,0,17499,183,32,6.6,False,8,False,0,0,0,17414,218,52,7.0,True,27.024483333333333,85,2,1,215,270,-55
BR1_2729364069,11,True,1,0,0,17655,206,68,7.4,True,2,False,0,1,0,13644,169,56,6.4,False,25.51425,4011,9,1,274,225,49
BR1_2729341642,8,True,0,0,0,16821,196,56,7.0,True,6,False,1,0,0,16417,184,48,6.6,False,25.028866666666666,404,2,-1,252,232,20
BR1_2728904293,3,False,1,0,0,15996,236,56,7.2,True,3,True,0,0,0,17001,261,60,7.4,False,29.693,-1005,0,1,292,321,-29
BR1_2731715105,6,False,1,0,0,18477,237,68,7.4,True,3,True,0,0,0,16082,215,60,7.2,False,29.5615,2395,3,1,305,275,30
BR1_2731657824,4,True,0,0,0,14658,179,43,7.0,True,7,False,0,0,0,15463,176,40,7.0,False,26.254066666666667,-805,-3,0,222,216,6
BR1_2731499886,10,True,1,0,0,19674,226,48,7.0,False,11,False,0,1,0,19595,209,44,6.8,True,29.829366666666665,79,-1,1,274,253,21
BR1_2682744092,6,False,0,0,0,17895,224,56,7.4,False,1,True,0,0,0,13760,185,56,6.8,True,29.6305,4135,5,0,280,241,39
BR1_2677880365,8,True,1,0,0,17232,212,47,7.0,True,7,False,0,0,0,16630,228,64,7.2,False,25.365483333333334,602,1,1,259,292,-33
BR1_2711600945,4,True,0,0,0,15521,202,72,7.0,True,2,False,0,0,0,14521,218,52,6.8,False,27.283333333333335,1000,2,0,274,270,4
BR1_2711703408,4,False,0,1,0,16221,219,60,7.0,False,9,True,1,0,0,17888,231,68,7.4,True,29.15945,-1667,-5,-1,279,299,-20
BR1_2707569834,4,False,0,0,0,15685,217,56,6.8,False,3,True,0,0,0,14456,194,48,6.6,True,27.36245,1229,1,0,273,242,31
BR1_2726988976,10,False,0,0,0,18806,183,60,6.8,True,6,True,1,0,0,17535,207,60,7.4,False,28.62085,1271,4,-1,243,267,-24
BR1_2730067701,8,True,0,0,0,17652,230,40,7.2,True,1,False,0,0,0,12903,166,44,6.8,False,27.327733333333335,4749,7,0,270,210,60
BR1_2731465128,6,False,0,1,0,15978,196,64,6.8,True,7,True,1,0,0,18399,228,78,7.4,False,28.910433333333334,-2421,-1,-1,260,306,-46
BR1_2731449799,4,False,1,1,0,14620,143,56,6.2,False,6,True,0,0,0,16168,200,56,6.8,True,26.06961666666667,-1548,-2,1,199,256,-57
BR1_2731439454,12,True,1,1,0,19669,192,62,7.6,True,6,False,0,0,0,17326,224,53,6.8,False,29.654016666666667,2343,6,1,254,277,-23
BR1_2699363242,4,True,1,0,0,15284,190,60,6.8,True,2,False,0,0,0,13695,192,48,6.8,False,25.248383333333333,1589,2,1,250,240,10
BR1_2690180616,6,False,0,0,0,17548,212,51,7.0,False,17,True,0,0,0,22193,272,56,7.4,True,28.583,-4645,-11,0,263,328,-65
BR1_2730048624,13,False,1,0,0,19902,190,60,7.4,True,9,True,0,1,0,17453,192,48,7.0,False,29.556683333333332,2449,4,1,250,240,10
BR1_2730027208,14,True,1,1,0,19162,154,46,6.6,True,4,False,0,0,0,14721,185,52,6.2,False,27.104733333333332,4441,10,1,200,237,-37
BR1_2729666943,11,True,0,1,0,19863,239,56,7.4,True,6,False,0,0,0,16922,219,56,7.4,False,28.80085,2941,5,0,295,275,20
BR1_2721606192,8,True,0,0,1,18994,216,51,7.4,True,3,False,1,1,0,16315,226,56,7.2,False,29.605083333333333,2679,5,-1,267,282,-15
BR1_2730764855,3,False,0,1,0,16948,234,64,7.2,False,4,True,1,0,0,16904,265,56,7.2,True,28.91871666666667,44,-1,-1,298,321,-23
BR1_2717955027,11,True,0,1,0,20480,252,64,7.6,True,5,False,1,0,0,15657,207,60,7.0,False,29.2509,4823,6,-1,316,267,49
BR1_2706784105,9,False,0,0,0,15146,153,44,6.2,False,8,True,1,0,0,17335,206,52,6.4,True,27.43245,-2189,1,-1,197,258,-61
BR1_2728926355,8,False,0,0,0,17667,198,44,6.6,False,9,True,1,0,0,18852,205,64,7.0,True,28.136366666666667,-1185,-1,-1,242,269,-27
BR1_2729180215,9,False,0,0,0,16913,162,32,6.2,False,13,True,1,0,0,17936,195,39,6.4,True,27.336683333333333,-1023,-4,-1,194,234,-40
BR1_2725880725,9,False,1,0,0,18187,208,63,7.4,True,10,True,0,0,0,19648,234,48,7.6,False,28.199716666666667,-1461,-1,1,271,282,-11
BR1_2731216795,6,True,1,0,0,17451,205,58,7.6,True,5,False,0,0,0,17049,231,58,7.2,False,29.050066666666666,402,1,1,263,289,-26
BR1_2731421972,6,False,1,0,0,17433,212,44,6.8,False,9,True,0,0,0,19264,222,48,7.4,True,27.88235,-1831,-3,1,256,270,-14
BR1_2731200529,5,True,1,0,0,16418,229,68,7.2,True,6,False,0,0,0,16927,210,64,7.6,False,27.667416666666668,-509,-1,1,297,274,23
BR1_2727833426,1,False,1,1,0,15583,222,64,6.8,True,9,True,0,0,0,17988,231,48,7.6,False,29.52765,-2405,-8,1,286,279,7
BR1_2727183273,10,False,0,0,0,19836,225,49,7.2,False,9,True,0,1,0,18289,199,50,7.0,True,28.503733333333333,1547,1,0,274,249,25
BR1_2730209670,3,False,0,1,0,15721,205,48,7.0,False,11,True,1,0,0,19320,207,76,7.2,True,29.427883333333334,-3599,-8,-1,253,283,-30
BR1_2730150477,8,True,0,0,0,17031,194,48,7.0,False,10,False,1,0,0,18323,195,44,7.2,True,27.743916666666667,-1292,-2,-1,242,239,3
BR1_2731289694,10,True,1,1,0,17500,201,56,6.8,True,5,False,0,0,0,15315,167,44,6.4,False,26.801616666666668,2185,5,1,257,211,46
BR1_2731325193,11,False,0,1,0,19395,251,56,7.4,True,3,True,1,0,0,14486,169,64,6.8,False,28.948916666666666,4909,8,-1,307,233,74
BR1_2691993000,4,True,0,1,0,14571,184,53,6.6,False,8,False,1,0,0,15689,164,22,6.8,True,25.693616666666667,-1118,-4,-1,237,186,51
BR1_2691970442,6,False,0,0,0,18244,237,56,7.4,True,6,True,1,0,0,16709,212,68,7.4,False,28.833916666666667,1535,0,-1,293,280,13
BR1_2730654071,12,False,0,1,0,20434,188,48,7.4,True,9,True,0,0,0,17965,200,52,6.8,False,28.1002,2469,3,0,236,252,-16
BR1_2712005949,10,True,1,0,0,16902,200,51,6.8,True,6,False,0,0,0,14610,167,44,6.6,False,25.942683333333335,2292,4,1,251,211,40
BR1_2728782974,3,False,0,0,0,15279,187,60,7.0,False,10,True,1,1,0,20623,246,68,7.4,True,28.315,-5344,-7,-1,247,314,-67
BR1_2730868951,8,False,1,1,0,16171,192,64,7.0,True,6,True,0,0,0,16067,199,40,6.6,False,26.058366666666668,104,2,1,256,239,17
BR1_2712124705,6,True,0,1,0,15943,201,56,7.0,True,4,False,0,0,0,14993,194,44,6.6,False,26.159366666666667,950,2,0,257,238,19
BR1_2713431001,12,True,0,0,0,17371,164,36,6.2,False,16,False,0,0,0,20873,173,52,7.0,True,27.237683333333333,-3502,-4,0,200,225,-25
BR1_2729163774,7,False,0,0,0,17544,197,48,7.0,False,10,True,1,1,0,19364,211,60,7.4,True,28.104216666666666,-1820,-3,-1,245,271,-26
BR1_2730818464,1,True,0,0,0,14966,233,54,7.0,False,2,False,1,1,0,15941,229,76,7.4,True,29.6571,-975,-1,-1,287,305,-18
BR1_2727677712,8,True,1,0,0,18589,192,56,7.0,True,6,False,0,0,0,16589,196,52,7.0,False,29.607383333333335,2000,2,1,248,248,0
BR1_2725374653,18,False,0,1,0,20642,195,56,7.0,True,7,True,1,0,0,15435,170,52,6.2,False,25.6072,5207,11,-1,251,222,29
BR1_2730633062,7,True,0,0,0,18530,220,64,7.2,False,11,False,1,1,0,20111,246,60,7.2,True,29.656383333333334,-1581,-4,-1,284,306,-22
BR1_2730586724,11,False,0,0,0,19144,205,60,7.4,True,9,True,1,0,0,18513,211,58,7.4,False,28.5919,631,2,-1,265,269,-4
BR1_2729731280,8,False,1,0,0,17176,222,60,7.2,True,4,True,0,0,0,15148,190,56,6.8,False,25.7903,2028,4,1,282,246,36
BR1_2723234196,10,True,1,1,0,20161,226,80,7.8,True,8,False,0,0,0,19368,226,44,7.6,False,29.071116666666665,793,2,1,306,270,36
BR1_2723206648,7,True,0,1,0,17973,202,52,7.0,False,7,False,1,0,0,18330,227,72,7.6,True,28.872833333333332,-357,0,-1,254,299,-45
BR1_2723182318,7,True,0,1,0,18545,235,56,7.2,True,7,False,0,0,0,17343,178,56,6.8,False,28.15945,1202,0,0,291,234,57
BR1_2719798990,11,False,0,0,0,17378,168,35,7.0,False,11,True,0,0,0,20720,232,68,7.6,True,29.151516666666666,-3342,0,0,203,300,-97
BR1_2731612772,5,False,0,1,0,16943,194,52,7.2,False,14,True,0,0,0,20639,221,56,7.2,True,28.166,-3696,-9,0,246,277,-31
BR1_2731522283,5,True,1,1,0,16303,203,68,7.0,False,7,False,0,0,0,17897,209,51,7.6,True,29.613983333333334,-1594,-2,1,271,260,11
BR1_2731668521,1,False,0,1,0,14555,215,64,7.2,False,4,True,1,0,0,14525,198,44,7.0,True,25.76675,30,-3,-1,279,242,37
BR1_2687170944,7,False,1,1,0,18657,215,68,7.4,False,11,True,0,0,0,19506,210,60,7.4,True,28.81215,-849,-4,1,283,270,13
BR1_2686052995,8,True,0,0,0,18467,223,60,7.8,False,4,False,1,0,0,16079,222,60,7.4,True,29.388166666666667,2388,4,-1,283,282,1
BR1_2685434040,9,True,0,0,0,19227,227,50,7.4,True,6,False,1,0,0,15584,144,53,7.0,False,28.953266666666668,3643,3,-1,277,197,80
BR1_2726434357,4,True,0,0,0,15600,225,44,6.8,True,1,False,0,0,0,13428,188,56,6.8,False,26.018833333333333,2172,3,0,269,244,25
BR1_2729810092,9,True,1,1,0,19819,224,88,7.8,True,4,False,0,0,0,16050,216,56,7.0,False,27.941566666666667,3769,5,1,312,272,40
BR1_2730075972,6,True,0,1,0,17443,211,56,7.8,False,9,False,1,0,0,18704,233,68,7.6,True,28.922666666666668,-1261,-3,-1,267,301,-34
BR1_2731079755,11,False,0,0,0,18966,175,55,7.0,True,9,True,0,1,0,18232,152,54,6.6,False,28.28248333333333,734,2,0,230,206,24
BR1_2731668127,5,False,1,0,0,15911,175,52,7.0,True,11,True,0,0,0,19879,227,68,7.4,False,29.64905,-3968,-6,1,227,295,-68
BR1_2731282695,13,False,0,0,0,20588,221,52,7.4,True,10,True,1,1,0,18532,197,52,6.6,False,29.020816666666665,2056,3,-1,273,249,24
BR1_2731327853,11,False,1,0,0,19688,201,80,7.6,True,8,True,0,1,0,18093,202,48,7.0,False,28.64195,1595,3,1,281,250,31
BR1_2731258454,5,True,0,0,0,17732,224,60,7.4,False,14,False,1,1,0,22556,227,60,7.4,True,28.25505,-4824,-9,-1,284,287,-3
BR1_2729301462,7,False,0,0,0,16294,204,60,7.0,False,7,True,0,0,0,16882,191,60,7.0,True,26.78045,-588,0,0,264,251,13
BR1_2717947366,8,True,1,1,0,17239,211,54,7.0,True,1,False,0,0,0,12773,157,50,6.4,False,26.9504,4466,7,1,265,207,58
BR1_2731062684,6,False,0,0,0,14802,135,48,6.4,False,9,True,1,0,0,17651,207,52,7.0,True,25.22335,-2849,-3,-1,183,259,-76
BR1_2730957163,12,True,0,1,0,20550,211,56,7.2,True,9,False,1,0,0,18389,231,56,7.4,False,28.826033333333335,2161,3,-1,267,287,-20
BR1_2729927489,7,False,0,0,0,18095,240,53,7.4,False,13,True,1,1,0,20389,233,66,7.6,True,28.1045,-2294,-6,-1,293,299,-6
BR1_2729893465,8,False,0,1,0,18735,195,64,7.0,False,8,True,1,0,0,18601,270,60,7.4,True,28.470033333333333,134,0,-1,259,330,-71
BR1_2731303351,5,True,1,0,0,15687,172,55,6.8,False,7,False,0,0,0,15333,170,60,6.6,True,26.667583333333333,354,-2,1,227,230,-3
BR1_2731282441,12,True,1,0,0,19243,187,76,7.0,True,6,False,0,1,0,18756,238,52,7.4,False,28.526133333333334,487,6,1,263,290,-27
BR1_2730260970,7,True,1,0,0,17087,203,68,6.6,True,3,False,0,1,0,14808,195,44,6.4,False,25.1737,2279,4,1,271,239,32
BR1_2730660516,9,True,1,0,0,17993,188,56,6.4,True,9,False,0,0,0,16756,127,49,5.8,False,25.1181,1237,0,1,244,176,68
BR1_2719718663,12,True,1,0,0,20271,226,64,7.0,True,7,False,0,1,0,17799,230,56,7.2,False,27.736333333333334,2472,5,1,290,286,4
BR1_2729562252,13,False,1,0,0,17853,187,44,7.0,True,4,True,0,0,0,15349,213,44,6.8,False,26.514016666666667,2504,9,1,231,257,-26
BR1_2731244271,12,True,0,1,0,20381,213,64,7.6,True,3,False,1,0,0,15084,207,56,7.2,False,27.757583333333333,5297,9,-1,277,263,14
BR1_2730632928,9,False,0,0,0,18856,225,50,7.4,True,8,True,0,0,0,17628,205,56,7.0,False,27.789,1228,1,0,275,261,14
BR1_2729590065,4,True,0,0,0,16185,230,52,6.6,True,5,False,1,0,0,14743,179,56,6.8,False,25.547116666666668,1442,-1,-1,282,235,47
BR1_2723154924,2,False,0,0,0,13570,197,52,6.8,False,8,True,1,0,0,17339,192,57,7.2,True,26.437083333333334,-3769,-6,-1,249,249,0
BR1_2730363057,7,True,0,1,0,19131,240,74,7.6,True,1,False,0,0,0,14835,195,54,7.0,False,27.689133333333334,4296,6,0,314,249,65
BR1_2730332399,9,True,1,1,0,19619,233,64,7.6,True,5,False,0,0,0,16362,211,60,7.4,False,27.619633333333333,3257,4,1,297,271,26
BR1_2725551404,10,False,1,1,0,19288,211,80,7.6,True,7,True,0,0,0,17670,189,68,7.2,False,28.56201666666667,1618,3,1,291,257,34
BR1_2725523693,5,True,1,0,0,17216,233,52,7.6,False,3,False,0,1,0,16801,238,60,7.4,True,28.201583333333332,415,2,1,285,298,-13
BR1_2730778293,8,False,0,0,0,18021,184,68,7.2,False,6,True,1,0,0,16301,224,56,7.2,True,28.73595,1720,2,-1,252,280,-28
BR1_2730752806,12,True,0,1,0,18890,192,47,6.8,False,10,False,1,0,0,17206,183,40,6.8,True,26.672133333333335,1684,2,-1,239,223,16
BR1_2730932671,4,False,0,0,0,13844,182,46,6.4,False,8,True,1,0,0,16562,175,56,6.8,True,25.601633333333332,-2718,-4,-1,228,231,-3
BR1_2730927461,10,False,1,0,0,18729,196,61,7.4,True,8,True,0,1,0,19063,240,62,7.6,False,29.888966666666665,-334,2,1,257,302,-45
BR1_2687967880,3,False,0,0,0,14843,200,48,7.6,False,6,True,1,1,0,17245,219,60,7.8,True,28.65755,-2402,-3,-1,248,279,-31
BR1_2687885857,12,True,0,0,0,18823,203,51,7.6,True,3,False,1,0,0,13806,147,56,7.0,False,29.445983333333334,5017,9,-1,254,203,51
BR1_2731678451,7,False,0,0,0,17648,176,56,7.2,True,7,True,1,0,0,16709,211,52,7.2,False,29.713066666666666,939,0,-1,232,263,-31
BR1_2730298431,5,True,1,0,0,17166,234,48,7.2,False,8,False,0,1,0,18712,253,72,7.8,True,29.211733333333335,-1546,-3,1,282,325,-43
BR1_2726106220,7,True,0,0,0,16805,208,56,6.8,True,6,False,1,0,0,15357,187,48,6.4,False,26.123966666666668,1448,1,-1,264,235,29
BR1_2725698126,10,True,1,1,0,19000,218,48,7.0,True,3,False,0,0,0,14975,210,56,6.8,False,26.28605,4025,7,1,266,266,0
BR1_2731378273,9,True,1,0,0,19088,225,59,7.4,True,8,False,0,1,0,18470,218,64,7.2,False,27.787716666666668,618,1,1,284,282,2
BR1_2731368929,8,False,0,1,0,17873,189,60,7.4,False,7,True,1,0,0,18018,235,60,7.6,True,28.91496666666667,-145,1,-1,249,295,-46
BR1_2731235369,9,True,0,0,0,18470,206,44,6.8,False,9,False,1,0,0,18920,207,52,7.4,True,29.58405,-450,0,-1,250,259,-9
BR1_2700176076,4,False,0,0,0,15158,186,48,6.8,True,3,True,0,0,0,14702,189,45,6.6,False,26.906783333333333,456,1,0,234,234,0
BR1_2726733587,12,True,1,0,0,20629,214,44,7.6,True,9,False,0,0,0,19258,233,55,7.2,False,28.123816666666666,1371,3,1,258,288,-30
BR1_2726719573,6,True,0,0,0,17790,217,56,7.4,False,8,False,0,0,0,18099,216,56,7.0,True,28.92925,-309,-2,0,273,272,1
BR1_2712122281,5,False,0,0,0,15933,165,56,6.4,False,13,True,0,0,0,20006,219,44,7.2,True,27.209633333333333,-4073,-8,0,221,263,-42
BR1_2729194590,7,False,1,0,0,18711,217,80,7.4,True,10,True,0,1,0,18917,193,44,7.4,False,27.53295,-206,-3,1,297,237,60
BR1_2729168095,3,False,0,1,0,14505,171,57,6.6,False,9,True,1,0,0,17317,190,50,6.8,True,26.149283333333333,-2812,-6,-1,228,240,-12
BR1_2731180666,7,False,1,0,0,17216,214,45,7.4,True,4,True,0,1,0,16064,188,60,7.2,False,27.5471,1152,3,1,259,248,11
BR1_2731553249,8,True,0,0,0,16648,189,44,6.6,True,5,False,0,0,0,14808,169,44,6.6,False,27.48443333333333,1840,3,0,233,213,20
BR1_2722343430,8,True,1,0,0,17622,213,51,6.6,True,5,False,0,0,0,14997,189,44,6.6,False,26.94708333333333,2625,3,1,264,233,31
BR1_2730973899,3,False,1,0,0,14801,209,56,6.8,True,3,True,0,0,0,14075,168,48,6.6,False,26.117166666666666,726,0,1,265,216,49
BR1_2730205580,10,True,0,1,0,18628,220,52,7.0,False,12,False,1,0,0,18448,220,44,7.0,True,26.6362,180,-2,-1,272,264,8
BR1_2716682330,4,False,0,0,0,16709,294,8,6.4,True,3,True,0,1,0,17111,254,68,7.4,False,28.362283333333334,-402,1,0,302,322,-20
BR1_2713687801,4,False,0,0,0,13880,174,44,6.6,False,5,True,1,0,0,15608,197,56,6.8,True,27.240366666666667,-1728,-1,-1,218,253,-35
BR1_2713663358,5,True,1,0,0,16369,206,48,6.8,False,10,False,0,1,0,19225,244,63,7.4,True,29.427683333333334,-2856,-5,1,254,307,-53
BR1_2702480157,6,True,0,0,0,15873,184,35,6.6,False,9,False,1,0,0,17964,194,72,7.2,True,26.963116666666668,-2091,-3,-1,219,266,-47
BR1_2684775798,7,True,0,0,0,16707,185,56,7.0,False,5,False,1,1,0,15078,162,48,6.6,True,27.3161,1629,2,-1,241,210,31
BR1_2709641954,5,False,0,0,0,17009,223,56,7.4,False,4,True,1,1,0,16666,220,56,7.2,True,27.988716666666665,343,1,-1,279,276,3
BR1_2694214763,12,True,1,0,0,19899,240,64,7.0,True,4,False,0,0,0,14313,150,39,6.6,False,25.455933333333334,5586,8,1,304,189,115
BR1_2730566257,10,True,1,0,0,19468,222,68,7.4,True,8,False,0,1,0,18977,223,52,7.4,False,28.153283333333334,491,2,1,290,275,15
BR1_2723516992,9,True,1,0,0,17055,199,52,6.8,True,3,False,0,0,0,13361,157,60,6.4,False,26.062816666666667,3694,6,1,251,217,34
BR1_2726948926,8,True,1,0,0,19334,220,56,7.6,True,7,False,0,0,0,16974,201,60,7.4,False,28.224516666666666,2360,1,1,276,261,15
BR1_2726880610,9,True,1,0,0,16836,192,40,7.0,True,4,False,0,1,0,14643,198,48,6.8,False,27.109883333333332,2193,5,1,232,246,-14
BR1_2729259987,7,True,0,0,0,16321,202,40,6.6,False,6,False,1,0,0,15186,167,64,6.8,True,26.029716666666666,1135,1,-1,242,231,11
BR1_2724826987,11,True,0,0,0,18927,217,56,7.6,True,6,False,1,1,0,17733,214,52,7.2,False,28.668433333333333,1194,5,-1,273,266,7
BR1_2671942168,8,True,0,0,0,16568,192,48,6.8,True,8,False,0,0,0,15955,210,44,6.8,False,26.6836,613,0,0,240,254,-14
BR1_2730706539,8,False,1,0,0,17931,213,50,7.2,True,6,True,0,0,0,18185,239,49,7.2,False,29.269466666666666,-254,2,1,263,288,-25
BR1_2730477066,3,True,0,0,0,14312,170,60,6.4,False,8,False,1,0,0,16599,231,43,7.2,True,25.741583333333335,-2287,-5,-1,230,274,-44
BR1_2730174628,5,False,0,1,0,17109,238,52,7.4,False,8,True,1,0,0,19677,236,52,7.2,True,27.538133333333334,-2568,-3,-1,290,288,2
BR1_2730428097,7,False,0,1,0,17093,193,60,7.2,False,5,True,0,0,0,17227,205,48,7.2,True,29.05755,-134,2,0,253,253,0
BR1_2728361365,6,False,0,0,0,18110,214,72,7.0,False,12,True,0,1,0,20444,220,64,7.6,True,29.809683333333332,-2334,-6,0,286,284,2
BR1_2731609872,4,True,0,1,0,15231,216,56,7.0,False,3,False,0,0,0,14759,189,60,6.8,True,27.126666666666665,472,1,0,272,249,23
BR1_2731555980,11,False,1,0,0,20611,245,56,7.4,True,8,True,0,0,0,18234,201,59,7.0,False,29.0748,2377,3,1,301,260,41
BR1_2731544337,12,False,0,0,2,21411,239,39,7.0,True,7,True,0,1,0,19595,217,56,7.2,False,28.64285,1816,5,0,278,273,5
BR1_2729723220,9,True,1,0,0,19340,217,64,7.4,True,8,False,0,1,0,19098,201,68,7.8,False,28.6483,242,1,1,281,269,12
BR1_2727067635,4,False,0,1,0,17944,241,68,7.6,True,3,True,1,0,0,15691,208,60,7.0,False,29.545116666666665,2253,1,-1,309,268,41
BR1_2713866197,5,True,0,0,0,16000,172,48,7.0,True,6,False,0,1,0,17995,249,52,7.4,False,29.958483333333334,-1995,-1,0,220,301,-81
BR1_2711909007,5,True,0,0,0,16076,216,56,6.4,True,6,False,1,0,0,16547,233,56,6.8,False,26.967766666666666,-471,-1,-1,272,289,-17
BR1_2692551540,5,False,1,0,0,15038,172,60,6.4,True,6,True,0,0,0,14884,172,48,6.6,False,27.121466666666667,154,-1,1,232,220,12
BR1_2731744149,9,True,0,0,0,18441,215,63,7.0,False,11,False,1,0,0,19595,222,56,7.4,True,29.4132,-1154,-2,-1,278,278,0
BR1_2731713256,10,True,1,1,0,18957,217,52,7.2,True,4,False,0,0,0,15304,219,36,7.2,False,28.334783333333334,3653,6,1,269,255,14
BR1_2731532221,7,False,0,0,0,17824,233,64,7.4,False,8,True,1,0,0,17454,235,36,7.0,True,28.0473,370,-1,-1,297,271,26
BR1_2731342040,11,True,1,1,0,18880,203,48,7.0,True,3,False,0,0,0,13573,177,52,6.6,False,25.3848,5307,8,1,251,229,22
BR1_2731324295,5,False,0,0,0,16839,251,48,7.4,False,10,True,1,0,0,19668,216,79,7.6,True,28.430766666666667,-2829,-5,-1,299,295,4
BR1_2702970321,6,False,1,0,0,15453,143,64,6.6,False,8,True,0,0,0,17463,198,60,6.8,True,27.139916666666668,-2010,-2,1,207,258,-51
BR1_2731640558,5,False,0,0,1,16540,194,40,6.4,True,6,True,1,0,0,15148,163,40,6.2,False,26.12465,1392,-1,-1,234,203,31
BR1_2722631690,5,True,1,0,0,14742,128,52,6.6,False,8,False,0,0,0,16818,181,44,6.8,True,26.418766666666667,-2076,-3,1,180,225,-45
BR1_2722619083,4,False,0,0,0,13897,172,40,6.4,False,11,True,1,0,0,18163,212,60,7.0,True,25.11328333333333,-4266,-7,-1,212,272,-60
BR1_2722590966,8,False,0,0,0,17226,207,50,7.6,True,7,True,1,0,0,16916,179,48,7.4,False,28.996416666666665,310,1,-1,257,227,30
BR1_2681364790,10,True,1,0,1,19197,202,56,7.2,True,6,False,0,1,0,14939,173,48,6.6,False,26.10696666666667,4258,4,1,258,221,37
BR1_2680877658,5,True,1,1,0,15454,209,52,6.4,True,4,False,0,0,0,14349,178,64,6.8,False,26.284916666666668,1105,1,1,261,242,19
BR1_2729741871,13,False,1,0,0,19729,194,64,7.2,False,10,True,0,1,0,20503,226,56,7.4,True,29.603016666666665,-774,3,1,258,282,-24
BR1_2731247907,9,True,0,1,0,16659,209,36,6.8,True,5,False,0,0,0,16094,185,52,6.6,False,26.979216666666666,565,4,0,245,237,8
BR1_2731686699,9,True,1,0,0,17591,209,48,6.8,True,7,False,0,0,0,16545,182,64,7.0,False,25.527266666666666,1046,2,1,257,246,11
BR1_2720566173,11,True,0,1,0,18641,144,56,6.8,False,7,False,1,0,0,16553,200,48,6.8,True,29.17285,2088,4,-1,200,248,-48
BR1_2730746149,5,False,0,0,0,14722,173,56,6.8,True,4,True,0,0,0,15103,208,48,6.8,False,26.680966666666666,-381,1,0,229,256,-27
BR1_2709231699,7,True,0,0,0,18303,204,50,7.0,False,8,False,1,0,0,18277,219,58,7.4,True,28.929916666666667,26,-1,-1,254,277,-23
BR1_2705764158,5,True,0,1,0,15663,201,54,6.6,False,9,False,1,0,0,17613,190,37,7.0,True,26.92575,-1950,-4,-1,255,227,28
BR1_2692450114,3,True,1,0,0,15627,244,52,7.0,False,5,False,0,0,0,16617,242,56,7.4,True,28.04008333333333,-990,-2,1,296,298,-2
BR1_2692429700,8,True,1,0,0,17622,216,44,7.0,False,6,False,0,1,0,17542,231,48,7.2,True,29.043483333333334,80,2,1,260,279,-19
BR1_2692362921,8,True,0,0,0,19366,272,52,7.4,True,9,False,1,0,0,18251,226,76,7.2,False,28.9335,1115,-1,-1,324,302,22
BR1_2727018067,2,False,0,0,0,12954,146,56,6.4,False,7,True,1,0,0,15806,165,52,6.8,True,25.052766666666667,-2852,-5,-1,202,217,-15
BR1_2729505903,5,False,1,0,0,17539,249,64,7.4,False,7,True,0,1,0,19018,245,68,7.2,True,27.731866666666665,-1479,-2,1,313,313,0
BR1_2703743704,11,False,1,1,0,18844,202,36,7.2,True,12,True,0,0,1,21032,215,51,7.6,False,27.6742,-2188,-1,1,238,266,-28
BR1_2702500139,7,True,0,1,0,17709,180,62,7.4,False,11,False,1,0,0,19195,241,58,7.2,True,29.1488,-1486,-4,-1,242,299,-57
BR1_2729779819,5,False,1,1,0,15994,197,48,6.4,True,6,True,0,0,0,15823,208,56,6.8,False,25.253116666666667,171,-1,1,245,264,-19
BR1_2729660184,1,False,0,0,0,13020,188,48,6.6,False,7,True,1,1,0,16697,230,48,7.0,True,25.608183333333333,-3677,-6,-1,236,278,-42
BR1_2725611262,3,False,0,0,0,14078,167,60,6.2,False,9,True,1,0,0,17052,199,56,6.8,True,26.285716666666666,-2974,-6,-1,227,255,-28
BR1_2731732616,6,True,0,0,0,18411,274,55,7.2,True,2,False,0,0,0,15299,211,56,7.2,False,28.654916666666665,3112,4,0,329,267,62
BR1_2674621078,3,False,0,0,0,16068,234,60,7.2,False,5,True,1,0,0,18568,270,60,7.6,True,28.903783333333333,-2500,-2,-1,294,330,-36
BR1_2731757296,5,True,0,1,0,18156,219,64,7.2,True,5,False,1,0,0,17353,232,55,7.4,False,28.4984,803,0,-1,283,287,-4
BR1_2731733167,8,True,1,1,0,16788,216,56,6.6,True,5,False,0,0,0,16010,180,44,6.8,False,26.851316666666666,778,3,1,272,224,48
BR1_2730653862,12,True,0,0,0,18681,194,40,6.8,False,13,False,1,0,0,20519,178,52,7.2,True,29.10295,-1838,-1,-1,234,230,4
BR1_2730221811,7,False,0,0,0,17898,227,64,7.0,True,9,True,0,1,0,18260,185,52,6.8,False,28.880666666666666,-362,-2,0,291,237,54
BR1_2731183012,6,True,0,0,0,17438,172,60,7.0,False,9,False,1,0,0,16846,164,48,6.6,True,29.886916666666668,592,-3,-1,232,212,20
BR1_2726548946,6,False,0,1,0,16553,200,60,7.0,True,11,True,0,0,0,19293,228,65,7.6,False,29.512533333333334,-2740,-5,0,260,293,-33
BR1_2729264092,9,False,0,1,0,17869,167,52,6.6,False,17,True,1,0,1,23343,181,53,7.4,True,29.05538333333333,-5474,-8,-1,219,234,-15
BR1_2715577783,7,False,0,0,0,17512,212,64,7.4,True,5,True,1,0,0,15795,197,48,7.0,False,29.43915,1717,2,-1,276,245,31
BR1_2730090067,10,True,1,0,0,18674,204,60,7.8,True,6,False,0,0,1,19698,227,76,7.6,False,29.715783333333334,-1024,4,1,264,303,-39
BR1_2728218379,5,False,0,0,0,15417,220,40,6.6,False,7,True,0,0,0,16784,204,52,6.8,True,26.12761666666667,-1367,-2,0,260,256,4
BR1_2729095851,4,False,1,0,0,14145,161,44,6.6,False,11,True,0,0,0,17951,202,44,6.8,True,27.498566666666665,-3806,-7,1,205,246,-41
BR1_2728108058,9,True,1,0,0,17066,178,56,6.6,False,4,False,0,0,0,16051,225,60,6.6,True,25.4489,1015,5,1,234,285,-51
BR1_2726974345,6,True,0,0,0,16644,216,68,6.8,True,4,False,0,1,0,14361,172,42,6.8,False,25.9776,2283,2,0,284,214,70
BR1_2705522306,6,True,0,0,0,15698,212,52,6.8,True,3,False,1,0,0,13720,178,56,6.6,False,26.436683333333335,1978,3,-1,264,234,30
BR1_2709439768,7,False,0,0,0,18050,201,51,6.8,True,12,True,1,1,0,21292,237,71,7.6,False,29.695233333333334,-3242,-5,-1,252,308,-56
BR1_2730026399,2,False,0,0,0,13860,177,52,6.4,False,5,True,1,1,0,17052,221,72,7.0,True,25.607133333333334,-3192,-3,-1,229,293,-64
BR1_2731605115,4,False,0,0,0,14637,208,24,6.4,False,7,True,0,0,0,16160,204,40,6.8,True,25.572033333333334,-1523,-3,0,232,244,-12
BR1_2731526461,2,False,0,1,0,16849,235,67,7.0,False,9,True,1,0,0,19688,237,60,7.6,True,28.053366666666665,-2839,-7,-1,302,297,5
BR1_2708964537,5,False,0,0,0,15942,202,40,7.0,False,8,True,0,0,0,18699,201,43,7.0,True,28.9987,-2757,-3,0,242,244,-2
BR1_2680404568,8,True,0,1,0,17574,170,68,7.4,False,9,False,1,0,0,19002,240,80,7.8,True,29.3065,-1428,-1,-1,238,320,-82
BR1_2680399209,5,False,0,0,0,15259,220,48,7.0,False,3,True,0,0,0,14896,212,44,6.8,True,26.5628,363,2,0,268,256,12
BR1_2721642512,13,True,1,0,0,19135,220,51,7.0,True,6,False,0,0,0,15783,185,48,6.8,False,25.486383333333333,3352,7,1,271,233,38
BR1_2692301148,8,True,0,1,0,18003,197,56,7.2,True,8,False,0,0,0,17055,188,40,6.8,False,26.586683333333333,948,0,0,253,228,25
BR1_2718687220,9,True,0,0,0,17015,145,48,7.2,False,5,False,1,1,0,16827,233,56,7.2,True,29.10171666666667,188,4,-1,193,289,-96
BR1_2691024365,10,True,0,0,0,19405,205,64,7.4,True,4,False,0,0,0,15442,182,44,6.8,False,29.8313,3963,6,0,269,226,43
BR1_2731306335,10,True,1,0,0,17264,198,48,7.0,True,2,False,0,0,0,13206,155,48,6.6,False,25.874583333333334,4058,8,1,246,203,43
BR1_2725911018,5,False,0,0,0,14157,157,28,6.2,False,6,True,1,0,0,16212,210,68,6.6,True,25.098416666666665,-2055,-1,-1,185,278,-93
BR1_2725895137,4,False,0,0,0,15323,226,52,7.0,False,11,True,1,0,0,19268,230,56,7.8,True,27.560216666666665,-3945,-7,-1,278,286,-8
BR1_2725203335,10,False,1,0,0,17716,167,56,6.6,False,10,True,0,1,0,20267,212,52,7.0,True,28.435133333333333,-2551,0,1,223,264,-41
BR1_2730744528,6,True,0,1,0,17979,200,64,7.4,True,9,False,1,0,0,18248,228,68,7.6,False,28.202916666666667,-269,-3,-1,264,296,-32
BR1_2731158978,13,True,1,0,0,18244,154,47,6.4,True,5,False,0,0,0,15197,183,52,6.6,False,27.33195,3047,8,1,201,235,-34
BR1_2686501076,4,False,1,0,0,15673,216,43,7.2,False,9,True,0,1,0,19311,195,60,7.6,True,28.23828333333333,-3638,-5,1,259,255,4
BR1_2731608295,6,True,1,0,0,18444,254,52,7.4,True,4,False,0,1,0,16660,189,76,7.4,False,29.573083333333333,1784,2,1,306,265,41
BR1_2731484658,7,True,0,0,0,16121,149,48,6.8,False,10,False,1,1,0,19149,215,60,7.4,True,29.114383333333333,-3028,-3,-1,197,275,-78
BR1_2727948717,2,True,1,0,0,14357,213,64,6.8,False,1,False,0,0,0,13580,199,48,6.8,True,27.354583333333334,777,1,1,277,247,30
BR1_2731291018,6,False,0,0,0,15823,194,49,6.8,False,5,True,0,0,0,15890,230,48,6.6,True,27.45865,-67,1,0,243,278,-35
BR1_2730350386,8,False,1,0,0,17874,192,56,7.0,True,9,True,0,1,0,17775,202,58,7.4,False,29.858966666666667,99,-1,1,248,260,-12
BR1_2731410673,6,True,0,0,0,16287,175,64,6.8,True,9,False,1,1,1,18629,189,48,6.8,False,25.483083333333333,-2342,-3,-1,239,237,2
BR1_2730896751,7,False,0,0,0,16871,170,40,7.0,False,13,True,0,1,0,19657,201,66,7.2,True,28.107483333333334,-2786,-6,0,210,267,-57
BR1_2731137152,11,False,0,0,0,17306,186,24,6.2,False,15,True,1,1,0,19827,180,60,6.6,True,25.057833333333335,-2521,-4,-1,210,240,-30
BR1_2692057114,9,True,1,1,0,20885,252,50,7.4,True,6,False,0,0,0,17562,243,51,7.2,False,27.750766666666667,3323,3,1,302,294,8
BR1_2692028265,2,True,1,0,0,15128,228,48,7.0,False,8,False,0,0,0,18602,245,52,7.8,True,29.04625,-3474,-6,1,276,297,-21
BR1_2696254859,9,False,0,1,0,19984,238,56,7.6,True,5,True,1,0,0,16419,183,52,7.2,False,29.1925,3565,4,-1,294,235,59
BR1_2731231763,7,True,0,0,0,17583,251,44,7.4,False,4,False,1,0,0,16790,242,48,7.2,True,29.163766666666668,793,3,-1,295,290,5
BR1_2728528856,10,True,1,0,0,18105,230,49,7.2,True,7,False,0,0,0,17143,188,56,6.8,False,27.129716666666667,962,3,1,279,244,35
BR1_2728955063,7,True,0,0,0,18352,238,64,7.6,True,7,False,1,0,0,16556,186,60,7.2,False,28.54085,1796,0,-1,302,246,56
BR1_2728766257,7,True,1,1,0,17233,193,56,7.0,True,3,False,0,0,0,13581,161,40,6.6,False,26.834583333333335,3652,4,1,249,201,48
BR1_2725700314,6,False,1,0,0,15608,192,52,6.8,True,3,True,0,1,0,14479,189,52,6.2,False,25.7731,1129,3,1,244,241,3
BR1_2730875984,14,True,1,0,0,19327,190,56,7.0,True,6,False,0,0,0,15235,167,40,6.2,False,26.60955,4092,8,1,246,207,39
BR1_2726475120,13,True,0,0,0,19968,180,52,6.8,True,9,False,1,0,0,18715,209,48,7.0,False,27.55055,1253,4,-1,232,257,-25
BR1_2724682906,6,False,0,0,0,16623,186,50,7.0,True,2,True,0,0,0,14310,194,50,6.6,False,26.631483333333332,2313,4,0,236,244,-8
BR1_2723707340,0,False,1,1,0,14518,220,60,7.2,False,6,True,0,0,0,18358,228,80,7.6,True,28.5786,-3840,-6,1,280,308,-28
BR1_2682457799,12,False,0,0,0,20940,222,44,7.6,False,13,True,1,0,0,20448,184,60,7.6,True,29.70265,492,-1,-1,266,244,22
BR1_2731691800,7,False,1,0,0,19424,231,68,7.4,True,11,True,0,1,0,19831,205,60,7.4,False,29.402416666666667,-407,-4,1,299,265,34
BR1_2731249257,4,True,1,1,0,15731,194,68,7.0,False,9,False,0,0,0,18959,233,60,7.8,True,29.73205,-3228,-5,1,262,293,-31
BR1_2731191545,6,True,1,0,0,16999,198,48,7.2,True,3,False,0,0,0,14853,179,35,6.6,False,28.858516666666667,2146,3,1,246,214,32
BR1_2709111292,5,False,1,0,0,16264,195,72,7.0,True,4,True,0,0,0,14213,167,44,6.6,False,25.06815,2051,1,1,267,211,56
BR1_2709086552,4,True,0,1,0,15275,151,56,6.2,False,12,False,1,0,0,18794,196,50,6.8,True,26.2734,-3519,-8,-1,207,246,-39
BR1_2731605908,7,True,1,0,0,17106,222,64,7.4,False,9,False,0,1,0,19004,201,64,7.4,True,29.957766666666668,-1898,-2,1,286,265,21
BR1_2690936153,3,False,1,0,0,14045,166,54,6.4,False,10,True,0,0,0,16638,184,50,6.6,True,27.30145,-2593,-7,1,220,234,-14
BR1_2731527629,10,False,0,0,0,16061,161,52,6.6,False,8,True,0,0,0,16068,181,60,6.6,True,26.4769,-7,2,0,213,241,-28
BR1_2731516366,4,False,0,0,0,16140,208,56,7.2,False,11,True,1,0,0,18771,205,56,7.4,True,28.966683333333332,-2631,-7,-1,264,261,3
BR1_2731502219,7,False,0,0,0,15960,188,33,6.6,False,9,True,1,1,0,18140,179,46,7.0,True,29.736983333333335,-2180,-2,-1,221,225,-4
BR1_2730271906,8,False,0,0,0,18419,211,48,7.4,False,9,True,1,0,0,18121,219,32,7.0,True,29.325266666666668,298,-1,-1,259,251,8
BR1_2719854347,7,True,0,1,0,16850,184,64,6.6,False,7,False,1,0,0,15524,190,52,6.6,True,25.4299,1326,0,-1,248,242,6
BR1_2718673840,3,False,1,0,0,14481,165,56,6.4,False,17,True,0,1,1,21598,184,48,6.8,True,27.0429,-7117,-14,1,221,232,-11
BR1_2731350398,5,True,0,0,0,17082,219,68,7.2,False,10,False,1,1,0,18586,197,60,7.0,True,29.1882,-1504,-5,-1,287,257,30
BR1_2731337322,2,False,0,0,0,15006,208,64,7.0,False,11,True,0,0,0,18560,218,72,7.4,True,27.01175,-3554,-9,0,272,290,-18
BR1_2731409018,6,True,1,0,0,16179,181,56,7.0,True,3,False,0,0,0,14145,189,40,6.4,False,27.376783333333332,2034,3,1,237,229,8
BR1_2731350564,18,True,1,1,0,21812,184,72,7.4,True,10,False,0,0,0,19450,189,59,7.0,False,28.047966666666667,2362,8,1,256,248,8
BR1_2727224974,9,False,1,0,0,17098,192,60,7.0,True,2,True,0,0,0,15009,187,64,6.8,False,26.297166666666666,2089,7,1,252,251,1
BR1_2727184390,8,False,1,1,0,16715,187,44,6.8,True,6,True,0,0,0,13738,114,60,6.2,False,27.124583333333334,2977,2,1,231,174,57
BR1_2726697842,7,True,0,0,0,18029,219,52,7.4,False,8,False,1,0,0,18975,215,64,7.8,True,27.55405,-946,-1,-1,271,279,-8
BR1_2726685675,9,True,1,0,0,16731,156,56,6.8,False,8,False,0,0,0,17116,191,48,6.6,True,29.7202,-385,1,1,212,239,-27
BR1_2718350221,3,False,0,0,0,14372,204,52,6.6,True,6,True,1,0,0,16516,193,48,6.8,False,27.156116666666666,-2144,-3,-1,256,241,15
BR1_2730422137,1,False,0,1,0,12969,150,40,6.8,False,4,True,1,0,0,16581,220,68,7.2,True,25.934666666666665,-3612,-3,-1,190,288,-98
BR1_2730043634,11,True,0,1,0,17884,206,52,7.0,True,2,False,0,0,0,14332,167,68,6.6,False,25.639483333333335,3552,9,0,258,235,23
BR1_2693572159,9,True,0,0,0,17705,184,44,7.0,False,15,False,0,1,0,22134,225,56,7.2,True,27.69125,-4429,-6,0,228,281,-53
BR1_2731731989,11,False,1,0,0,17631,172,48,6.8,True,11,True,0,0,0,18915,199,56,6.8,False,26.6425,-1284,0,1,220,255,-35
BR1_2729673626,5,False,0,1,0,17957,260,52,7.6,True,7,True,0,0,0,17895,251,60,7.4,False,29.10621666666667,62,-2,0,312,311,1
BR1_2730992578,8,False,0,0,0,18191,238,40,7.4,True,7,True,1,0,0,15751,156,60,6.8,False,27.533083333333334,2440,1,-1,278,216,62
BR1_2730443748,11,True,1,1,0,17480,209,56,7.0,True,4,False,0,0,0,14174,175,36,6.6,False,26.1385,3306,7,1,265,211,54
BR1_2730436014,8,True,0,0,0,18745,251,48,7.4,True,6,False,1,1,0,17497,224,54,7.6,False,28.275283333333334,1248,2,-1,299,278,21
BR1_2730955851,7,True,1,1,0,18128,240,56,7.2,False,9,False,0,0,0,19403,264,32,7.6,True,28.125516666666666,-1275,-2,1,296,296,0
BR1_2730649239,8,True,0,0,0,17473,188,49,7.0,False,6,False,0,1,0,17289,214,40,7.0,True,29.273266666666668,184,2,0,237,254,-17
BR1_2730765689,14,False,1,0,0,20557,181,56,7.4,False,9,True,0,0,0,18856,179,48,7.0,True,27.907916666666665,1701,5,1,237,227,10
BR1_2716363698,6,False,0,1,0,18228,211,68,7.6,True,11,True,1,0,0,19383,224,44,7.2,False,29.38945,-1155,-5,-1,279,268,11
BR1_2699678867,15,True,1,0,0,20244,162,40,6.4,True,8,False,0,0,0,16529,170,64,6.6,False,25.11895,3715,7,1,202,234,-32
BR1_2731063623,7,True,0,0,0,17174,216,52,7.0,False,11,False,0,0,0,18731,217,55,7.4,True,29.5157,-1557,-4,0,268,272,-4
BR1_2731577954,13,True,1,0,0,18790,195,46,6.8,True,10,False,0,0,0,16585,158,57,6.4,False,26.4402,2205,3,1,241,215,26
BR1_2731209863,13,False,1,1,0,20954,222,68,7.4,True,7,True,0,0,0,17654,177,64,7.2,False,29.637183333333333,3300,6,1,290,241,49
BR1_2731732028,8,False,1,0,0,16715,166,55,6.8,True,4,True,0,0,0,13549,131,64,6.6,False,26.435966666666666,3166,4,1,221,195,26
BR1_2730940533,16,True,0,1,1,22234,196,68,7.4,True,9,False,1,0,0,18682,240,52,7.2,False,27.954816666666666,3552,7,-1,264,292,-28
BR1_2730931582,8,True,1,1,0,16589,224,36,6.8,False,3,False,0,0,0,14925,221,51,7.0,True,27.216583333333332,1664,5,1,260,272,-12
BR1_2730927224,12,False,0,0,0,19370,222,67,7.4,True,7,True,1,1,0,17605,205,44,7.0,False,29.372966666666667,1765,5,-1,289,249,40
BR1_2730595592,7,False,1,0,0,15745,175,48,6.4,False,6,True,0,0,0,15577,182,60,6.8,True,26.21688333333333,168,1,1,223,242,-19
BR1_2731657167,7,False,0,0,0,18402,194,78,6.8,False,15,True,0,0,0,19516,235,4,6.2,True,27.602916666666665,-1114,-8,0,272,239,33
BR1_2731237865,13,True,0,0,0,18976,198,48,7.2,False,16,False,0,1,0,22324,219,39,7.4,True,27.641116666666665,-3348,-3,0,246,258,-12
BR1_2731214171,9,False,1,0,0,19011,209,76,7.2,True,7,True,0,0,0,18138,241,60,7.2,False,27.725466666666666,873,2,1,285,301,-16
BR1_2731330392,9,True,1,0,0,18491,193,52,6.8,True,2,False,0,0,0,13426,179,40,6.6,False,27.028483333333334,5065,7,1,245,219,26
BR1_2730866073,10,True,0,0,0,18047,196,48,7.0,False,8,False,1,1,0,17384,172,52,7.0,True,27.782583333333335,663,2,-1,244,224,20
BR1_2730293551,8,False,1,1,1,19919,237,51,7.6,True,3,True,0,0,0,14874,163,61,7.2,False,28.64435,5045,5,1,288,224,64
BR1_2718739976,5,True,0,0,0,16381,235,44,6.6,False,1,False,1,0,0,14022,203,56,6.6,True,25.088483333333333,2359,4,-1,279,259,20
BR1_2723146536,5,True,0,1,0,17334,238,56,7.6,True,3,False,0,0,0,15373,205,60,7.0,False,28.420866666666665,1961,2,0,294,265,29
BR1_2727688622,6,False,1,0,0,15307,197,56,7.0,True,6,True,0,0,0,14897,167,56,6.4,False,25.616766666666667,410,0,1,253,223,30
BR1_2731412043,7,False,1,0,0,16571,208,42,6.8,True,4,True,0,0,0,15607,191,64,7.0,False,25.565683333333332,964,3,1,250,255,-5
BR1_2726351347,3,True,0,1,0,14640,161,52,6.4,False,10,False,1,0,0,19459,221,64,7.4,True,27.552333333333333,-4819,-7,-1,213,285,-72
BR1_2731723487,11,True,1,1,0,19234,188,60,7.4,False,7,False,0,0,0,17468,223,52,6.8,True,29.549783333333334,1766,4,1,248,275,-27
BR1_2721106365,3,False,0,0,0,13346,142,40,6.0,False,13,True,1,0,0,20785,237,68,7.2,True,26.212966666666667,-7439,-10,-1,182,305,-123
BR1_2727399947,12,True,0,0,0,17823,180,48,6.4,False,9,False,0,0,0,16232,181,36,6.4,True,26.081083333333332,1591,3,0,228,217,11
BR1_2724093477,9,False,0,0,0,19155,221,64,7.4,True,6,True,0,0,0,17491,188,60,7.2,False,29.7854,1664,3,0,285,248,37
BR1_2731626467,1,False,0,0,0,13097,152,52,6.6,False,7,True,1,1,0,16532,195,54,7.0,True,25.657766666666667,-3435,-6,-1,204,249,-45
BR1_2727499313,5,True,0,0,0,15371,184,64,7.0,False,3,False,0,0,0,14665,222,36,6.8,True,26.596666666666668,706,2,0,248,258,-10
BR1_2731638326,11,False,1,0,1,18604,179,53,6.4,True,6,True,0,0,0,15701,171,46,6.6,False,25.48645,2903,5,1,232,217,15
BR1_2731317356,5,True,0,0,0,16085,198,44,7.2,False,7,False,1,0,0,16560,202,60,7.2,True,29.211683333333333,-475,-2,-1,242,262,-20
BR1_2731290492,6,False,1,0,0,15853,197,46,7.4,False,11,True,0,1,0,18220,195,60,7.4,True,29.01735,-2367,-5,1,243,255,-12
BR1_2729691402,2,False,0,0,0,16017,227,63,7.4,True,6,True,1,0,0,17466,260,56,7.6,False,28.576266666666665,-1449,-4,-1,290,316,-26
BR1_2722187751,7,False,0,1,0,16313,163,64,7.2,False,9,True,1,0,0,17074,187,52,7.0,True,25.12601666666667,-761,-2,-1,227,239,-12
BR1_2729512162,4,False,0,1,0,15835,225,39,7.0,False,8,True,1,0,0,18646,218,64,7.6,True,29.94115,-2811,-4,-1,264,282,-18
BR1_2731304661,7,True,1,0,0,16789,183,50,7.4,True,7,False,0,0,0,18037,198,81,7.4,False,27.974633333333333,-1248,0,1,233,279,-46
BR1_2731501953,6,False,0,1,0,17450,216,64,7.2,False,12,True,1,0,0,19153,201,69,7.4,True,29.902483333333333,-1703,-6,-1,280,270,10
BR1_2702454960,5,False,1,0,0,15108,179,52,7.2,True,6,True,0,1,0,16922,233,60,7.4,False,28.172933333333333,-1814,-1,1,231,293,-62
BR1_2702429877,8,False,1,0,0,16634,215,40,6.6,True,8,True,0,0,0,16017,164,44,6.4,False,26.87725,617,0,1,255,208,47
BR1_2719772750,6,True,0,1,0,17555,219,60,7.4,True,5,False,0,0,0,16620,208,68,7.6,False,28.2757,935,1,0,279,276,3
BR1_2731337249,6,True,1,1,0,16658,214,50,7.0,True,4,False,0,0,0,15221,209,51,7.2,False,27.4829,1437,2,1,264,260,4
BR1_2730873577,9,True,0,0,0,18055,207,56,7.0,False,9,False,1,1,0,19315,212,64,7.4,True,29.527216666666668,-1260,0,-1,263,276,-13
BR1_2674445155,11,True,0,0,0,18260,210,44,6.8,True,4,False,0,0,0,14870,176,48,6.6,False,26.299466666666667,3390,7,0,254,224,30
BR1_2731527561,9,True,0,0,0,15868,167,36,6.8,True,11,False,0,0,0,18703,213,44,7.0,False,26.045166666666667,-2835,-2,0,203,257,-54
BR1_2731441926,6,False,1,0,0,14588,142,52,6.6,True,7,True,0,0,0,17333,194,40,6.8,False,25.8135,-2745,-1,1,194,234,-40
BR1_2731435333,9,False,1,0,0,18390,189,56,7.2,True,3,True,0,1,1,16765,205,64,6.8,False,28.69975,1625,6,1,245,269,-24
BR1_2729389963,4,False,0,0,0,14312,192,40,6.6,False,6,True,1,0,0,16697,190,68,6.8,True,25.244533333333333,-2385,-2,-1,232,258,-26
BR1_2731668746,9,True,1,1,0,16778,170,64,6.8,True,5,False,0,0,0,15244,197,51,6.8,False,25.72821666666667,1534,4,1,234,248,-14
BR1_2731639490,7,True,0,0,0,16719,207,56,6.6,True,6,False,0,0,0,15435,198,48,6.8,False,26.96575,1284,1,0,263,246,17
BR1_2728007634,12,False,1,1,0,17982,173,56,6.6,True,4,True,0,0,0,14967,172,56,6.4,False,26.594633333333334,3015,8,1,229,228,1
BR1_2722427399,4,True,0,0,0,14595,144,46,6.2,False,15,False,0,1,0,19039,175,46,7.0,True,26.790066666666668,-4444,-11,0,190,221,-31
BR1_2709435183,9,False,0,1,0,19150,224,44,7.2,False,10,True,1,0,0,20257,210,68,7.2,True,28.6273,-1107,-1,-1,268,278,-10
BR1_2717845832,7,True,0,0,0,16286,183,48,6.6,False,8,False,1,0,0,17084,184,40,6.4,True,26.709566666666667,-798,-1,-1,231,224,7
BR1_2717431091,7,False,0,0,0,16663,188,56,6.6,False,12,True,1,1,0,20235,238,53,7.2,True,27.974333333333334,-3572,-5,-1,244,291,-47
BR1_2731601429,8,True,1,1,0,17166,194,56,7.0,True,6,False,0,0,0,16874,205,56,6.8,False,26.223516666666665,292,2,1,250,261,-11
BR1_2728139107,7,True,1,0,0,15844,187,44,6.4,True,10,False,0,0,0,16859,155,53,6.8,False,26.86225,-1015,-3,1,231,208,23
BR1_2730863024,8,False,1,1,0,17989,211,54,7.4,True,6,True,0,0,0,17069,219,66,7.8,False,28.183916666666665,920,2,1,265,285,-20
BR1_2730849422,7,True,0,0,0,15712,168,40,6.6,False,11,False,0,0,0,16822,171,48,6.6,True,26.903083333333335,-1110,-4,0,208,219,-11
BR1_2729111362,7,True,1,0,0,17145,194,48,7.0,True,2,False,0,1,0,14109,173,44,6.6,False,25.919166666666666,3036,5,1,242,217,25
BR1_2727511894,2,False,0,0,0,13035,166,44,6.4,False,7,True,0,1,0,17259,202,52,6.8,True,26.119933333333332,-4224,-5,0,210,254,-44
BR1_2719626700,3,True,1,0,0,14052,164,46,6.6,True,4,False,0,0,0,15711,226,56,7.0,False,25.115966666666665,-1659,-1,1,210,282,-72
BR1_2730853804,5,True,0,0,0,17803,232,64,7.0,False,7,False,1,1,1,20042,267,60,7.6,True,28.95475,-2239,-2,-1,296,327,-31
BR1_2730843239,2,False,0,0,0,16535,231,76,7.2,True,3,True,1,1,0,18671,253,60,7.6,False,28.27788333333333,-2136,-1,-1,307,313,-6
BR1_2725655078,8,False,0,0,0,16410,157,36,6.4,False,10,True,0,0,0,18460,200,50,6.6,True,27.316883333333333,-2050,-2,0,193,250,-57
BR1_2712435124,7,False,0,1,0,16530,177,63,7.0,True,8,True,0,0,0,17618,220,44,6.6,False,25.6944,-1088,-1,0,240,264,-24
BR1_2712353533,7,False,1,0,0,16283,182,40,6.4,True,7,True,0,0,0,16011,183,39,6.4,False,27.16336666666667,272,0,1,222,222,0
BR1_2728458560,7,True,0,0,0,15722,185,44,6.8,False,6,False,0,0,0,15239,179,60,6.8,True,26.936333333333334,483,1,0,229,239,-10
BR1_2726173893,10,True,1,1,1,21696,242,64,7.4,True,7,False,0,0,0,17823,199,36,7.4,False,27.7398,3873,3,1,306,235,71
BR1_2730618897,5,True,0,0,0,15669,192,52,7.0,False,11,False,0,0,0,18752,207,52,7.6,True,27.527366666666666,-3083,-6,0,244,259,-15
BR1_2727906175,10,True,1,0,0,19587,237,72,7.4,True,4,False,0,0,0,16344,230,52,7.4,False,29.0393,3243,6,1,309,282,27
BR1_2731291612,5,True,1,0,0,15183,153,48,6.6,True,3,False,0,1,0,13924,179,63,6.8,False,25.77685,1259,2,1,201,242,-41
BR1_2731271207,13,False,1,1,0,18403,159,44,6.6,True,9,True,0,0,0,17777,185,48,6.8,False,26.801483333333334,626,4,1,203,233,-30
BR1_2715375484,6,True,1,0,0,18215,192,68,7.2,False,9,False,0,1,0,18746,202,65,7.6,True,28.061216666666667,-531,-3,1,260,267,-7
BR1_2729810113,6,True,1,0,0,16022,205,67,7.0,True,6,False,0,0,0,14734,165,44,6.8,False,27.34535,1288,0,1,272,209,63
BR1_2730973912,6,True,1,0,0,15315,180,60,6.6,True,0,False,0,0,0,12873,178,52,6.4,False,27.22896666666667,2442,6,1,240,230,10
BR1_2730961093,4,False,0,1,0,16977,226,64,7.2,False,6,True,1,0,0,17044,207,52,7.2,True,28.43551666666667,-67,-2,-1,290,259,31
BR1_2721542569,12,False,1,1,0,20022,186,60,7.2,True,11,True,0,0,0,20404,194,52,7.0,False,29.396366666666665,-382,1,1,246,246,0
BR1_2715739569,11,True,1,0,0,20186,241,48,7.4,True,3,False,0,1,0,16867,226,64,7.2,False,29.617216666666668,3319,8,1,289,290,-1
BR1_2713949981,6,True,0,1,0,17598,231,44,7.0,True,5,False,1,0,0,16687,179,72,7.4,False,28.005783333333333,911,1,-1,275,251,24
BR1_2731433580,3,True,1,0,0,16186,227,62,7.2,False,8,False,0,1,0,18396,199,62,7.8,True,29.945683333333335,-2210,-5,1,289,261,28
BR1_2731141643,5,True,0,0,0,16195,225,56,6.6,False,8,False,1,0,0,17217,213,48,7.0,True,26.295533333333335,-1022,-3,-1,281,261,20
BR1_2714895327,8,False,1,0,0,16540,194,56,7.0,True,6,True,0,1,0,16536,205,53,7.0,False,25.616933333333332,4,2,1,250,258,-8
BR1_2729570823,2,False,0,0,0,13921,173,48,6.4,False,2,True,0,0,0,14396,223,53,6.8,True,25.397716666666668,-475,0,0,221,276,-55
BR1_2725797344,4,False,0,0,0,15406,197,52,6.6,True,6,True,0,0,0,15927,197,44,6.8,False,27.268433333333334,-521,-2,0,249,241,8
BR1_2722525201,1,False,0,0,0,15569,238,60,7.8,True,2,True,1,0,0,17000,260,80,7.6,False,29.459983333333334,-1431,-1,-1,298,340,-42
BR1_2728985274,10,True,0,0,0,17862,190,60,7.2,True,5,False,0,0,0,16829,208,64,7.0,False,29.0467,1033,5,0,250,272,-22
BR1_2728941481,6,False,1,0,0,17369,234,54,7.2,True,4,True,0,0,0,16308,224,60,7.2,False,29.110333333333333,1061,2,1,288,284,4
BR1_2730551932,8,True,0,0,0,15717,161,54,6.8,True,3,False,1,0,0,14299,173,60,6.4,False,26.636533333333333,1418,5,-1,215,233,-18
BR1_2730544049,10,False,0,0,0,17246,184,48,6.6,False,9,True,1,1,0,16936,174,56,6.8,True,27.117583333333332,310,1,-1,232,230,2
BR1_2726194972,8,True,1,0,0,16669,191,44,7.0,True,2,False,0,1,0,13962,184,52,6.6,False,25.46885,2707,6,1,235,236,-1
BR1_2711898383,12,True,1,0,0,19791,210,57,7.0,False,7,False,0,1,0,17971,196,54,6.8,True,27.6067,1820,5,1,267,250,17
BR1_2731189751,3,False,1,0,0,13567,167,44,6.4,False,11,True,0,1,0,17825,186,52,7.2,True,25.87955,-4258,-8,1,211,238,-27
BR1_2731132481,6,False,0,1,0,16772,207,60,7.0,True,3,True,0,0,0,15506,209,56,7.0,False,26.81315,1266,3,0,267,265,2
BR1_2730720968,6,True,1,0,0,16959,200,68,7.2,True,4,False,0,0,0,17147,225,64,7.4,False,29.737783333333333,-188,2,1,268,289,-21
BR1_2731713856,10,True,1,1,0,20877,262,67,8.0,True,4,False,0,0,0,16078,187,52,7.2,False,28.047333333333334,4799,6,1,329,239,90
BR1_2730937429,5,False,1,0,0,17786,243,60,7.6,True,5,True,0,1,0,16383,193,56,7.2,False,28.87015,1403,0,1,303,249,54
BR1_2730955828,5,True,0,1,0,16577,201,43,7.0,False,9,False,1,0,0,18883,256,55,7.4,True,27.968166666666665,-2306,-4,-1,244,311,-67
BR1_2730950303,8,False,0,0,0,16525,203,40,6.6,True,8,True,0,0,0,16640,188,59,7.0,False,27.142633333333333,-115,0,0,243,247,-4
BR1_2730786599,4,False,0,1,0,15540,193,60,6.8,True,6,True,1,0,0,15651,184,44,6.6,False,26.305616666666666,-111,-2,-1,253,228,25
BR1_2728390376,8,True,0,1,0,18991,213,72,7.8,True,6,False,1,0,0,18516,243,52,7.4,False,28.476333333333333,475,2,-1,285,295,-10
BR1_2731435525,7,False,0,0,0,19097,231,65,7.4,False,5,True,1,0,0,16420,213,48,7.4,True,28.696866666666665,2677,2,-1,296,261,35
BR1_2729858409,9,True,0,0,0,15838,205,48,6.8,True,5,False,1,1,0,15814,182,60,6.8,False,26.272616666666668,24,4,-1,253,242,11
BR1_2722266295,14,False,0,0,0,18829,199,44,6.8,True,9,True,1,0,0,16067,150,48,6.6,False,26.442716666666666,2762,5,-1,243,198,45
BR1_2731099651,9,True,1,0,0,18134,197,60,7.2,True,8,False,0,0,0,19615,209,80,7.4,False,27.6596,-1481,1,1,257,289,-32
BR1_2730814097,4,False,0,1,0,14846,193,52,6.4,False,8,True,1,0,0,16734,213,40,6.8,True,26.918083333333332,-1888,-4,-1,245,253,-8
BR1_2730747056,8,True,1,0,1,19846,268,52,7.6,True,6,False,0,0,0,16674,200,64,7.2,False,27.7029,3172,2,1,320,264,56
BR1_2730716445,9,True,0,0,0,18339,203,55,6.6,False,10,False,1,0,0,18557,213,64,7.4,True,29.80465,-218,-1,-1,258,277,-19
BR1_2729661630,14,True,1,1,0,23661,255,72,7.8,True,4,False,0,0,0,15156,169,48,6.8,False,28.612866666666665,8505,10,1,327,217,110
BR1_2731508696,17,True,1,0,0,21417,190,50,7.0,True,10,False,0,0,0,19589,227,68,7.4,False,27.981833333333334,1828,7,1,240,295,-55
BR1_2731498201,6,False,1,0,0,15978,196,56,7.0,True,5,True,0,1,0,15969,175,36,6.6,False,26.137533333333334,9,1,1,252,211,41
BR1_2725183425,4,True,0,0,0,14732,206,52,6.6,True,5,False,1,1,0,14911,199,56,6.8,False,26.62088333333333,-179,-1,-1,258,255,3
BR1_2726465490,8,True,0,0,0,16380,192,48,6.6,False,7,False,1,0,0,17242,164,60,6.4,True,25.149016666666668,-862,1,-1,240,224,16
BR1_2726344397,9,True,0,1,0,17549,192,60,7.0,False,12,False,1,0,0,18216,187,48,6.8,True,26.1088,-667,-3,-1,252,235,17
BR1_2731683509,12,False,1,0,0,19274,184,68,7.0,True,11,True,0,0,0,18098,170,56,6.8,False,28.41765,1176,1,1,252,226,26
BR1_2729476723,6,False,0,0,0,17446,255,60,7.2,True,10,True,0,1,0,21020,261,60,7.4,False,28.0126,-3574,-4,0,315,321,-6
BR1_2705773363,5,False,0,0,0,15591,204,48,6.6,False,11,True,1,0,0,18565,207,48,6.6,True,27.2974,-2974,-6,-1,252,255,-3
BR1_2701001913,10,False,1,1,0,18255,229,56,7.0,True,5,True,0,0,0,14982,192,52,6.8,False,26.558733333333333,3273,5,1,285,244,41
BR1_2731323877,4,True,0,0,0,14512,161,48,6.4,False,6,False,0,0,0,16851,223,48,6.8,True,26.4149,-2339,-2,0,209,271,-62
BR1_2730685298,9,False,1,1,0,16695,174,59,6.6,True,3,True,0,0,0,13768,153,44,6.4,False,25.657383333333332,2927,6,1,233,197,36
BR1_2725313905,6,True,0,1,0,18035,256,52,7.2,False,4,False,1,0,0,16406,226,64,7.2,True,29.737866666666665,1629,2,-1,308,290,18
BR1_2730920437,10,False,0,0,0,18889,191,40,6.8,False,16,True,0,0,0,21197,217,52,7.4,True,28.1616,-2308,-6,0,231,269,-38
BR1_2728523088,7,False,1,0,0,16632,225,44,6.6,True,7,True,0,1,0,17353,216,52,7.0,False,27.272616666666668,-721,0,1,269,268,1
BR1_2731323177,14,True,1,0,0,19380,220,60,7.2,True,8,False,0,0,0,16018,170,48,6.4,False,26.927066666666665,3362,6,1,280,218,62
BR1_2716984203,5,True,1,0,0,18295,217,70,7.6,True,5,False,0,0,0,15075,160,54,6.6,False,29.609866666666665,3220,0,1,287,214,73
BR1_2718150621,4,False,1,0,0,15234,201,50,6.8,True,12,True,0,0,0,17469,179,36,6.4,False,26.412533333333332,-2235,-8,1,251,215,36
BR1_2731185524,12,False,0,0,0,18018,178,34,6.6,True,8,True,0,0,0,16280,181,41,6.8,False,27.134333333333334,1738,4,0,212,222,-10
BR1_2729220017,4,False,0,1,0,15029,191,52,6.6,True,6,True,1,0,0,16351,234,60,7.0,False,27.1047,-1322,-2,-1,243,294,-51
BR1_2731658799,8,False,0,0,0,16748,169,46,6.6,True,8,True,1,0,0,17370,197,56,7.0,False,26.5234,-622,0,-1,215,253,-38
BR1_2731173664,7,False,0,1,0,16075,172,60,6.6,True,7,True,1,0,0,15566,196,40,6.4,False,26.4913,509,0,-1,232,236,-4
BR1_2730373862,12,False,0,0,0,18605,185,49,7.0,True,8,True,1,0,0,17003,171,54,6.4,False,27.963416666666667,1602,4,-1,234,225,9
BR1_2730281649,11,False,1,0,0,20454,210,60,7.4,True,6,True,0,1,0,16323,184,49,7.0,False,27.618016666666666,4131,5,1,270,233,37
BR1_2731248380,5,True,0,0,0,15961,193,56,7.2,False,11,False,1,0,0,19772,274,56,7.6,True,29.664933333333334,-3811,-6,-1,249,330,-81
BR1_2730785857,2,False,0,0,0,13492,176,52,6.4,False,7,True,1,0,0,16940,211,60,7.2,True,26.992766666666668,-3448,-5,-1,228,271,-43
BR1_2730695431,9,True,0,1,0,17353,190,43,6.8,True,3,False,0,0,0,14868,206,53,6.6,False,26.398,2485,6,0,233,259,-26
BR1_2728567712,5,False,0,0,0,15004,175,44,6.6,False,10,True,1,0,0,18332,169,68,6.8,True,26.28548333333333,-3328,-5,-1,219,237,-18
BR1_2728530309,11,True,1,0,0,19579,234,52,7.6,True,4,False,0,1,0,15677,187,56,7.0,False,27.66075,3902,7,1,286,243,43
BR1_2691859672,5,True,0,0,0,16079,237,40,6.8,False,11,False,1,1,0,19089,199,76,7.6,True,28.59895,-3010,-6,-1,277,275,2
BR1_2730751768,9,True,1,0,0,18467,256,38,7.2,True,6,False,0,0,0,17606,241,40,7.0,False,28.1456,861,3,1,294,281,13
BR1_2720649438,12,True,1,0,0,21321,226,72,7.6,False,7,False,0,0,0,17406,229,52,7.4,True,29.891533333333335,3915,5,1,298,281,17
BR1_2731291184,6,False,0,0,0,15556,161,48,6.6,False,10,True,1,0,0,16957,178,36,6.4,True,25.879816666666667,-1401,-4,-1,209,214,-5
BR1_2728909976,8,False,0,1,0,16563,171,52,7.2,True,5,True,1,0,0,15382,177,56,6.6,False,27.435066666666668,1181,3,-1,223,233,-10
BR1_2728890579,2,False,1,0,0,14415,182,56,6.8,False,8,True,0,0,0,16284,175,48,6.8,True,26.539666666666665,-1869,-6,1,238,223,15
BR1_2674977361,14,False,0,1,0,20742,238,56,7.8,True,6,True,0,0,0,17275,194,75,7.2,False,28.8836,3467,8,0,294,269,25
BR1_2725286189,9,True,0,0,0,17277,202,36,6.4,False,9,False,1,1,0,18803,209,60,7.0,True,26.00658333333333,-1526,0,-1,238,269,-31
BR1_2725277511,8,False,0,0,0,17981,232,64,7.4,False,5,True,0,0,0,16374,204,64,6.8,True,29.107266666666668,1607,3,0,296,268,28
BR1_2725428922,5,False,0,0,0,16531,210,52,6.8,False,12,True,0,1,0,20825,200,52,7.4,True,28.261733333333332,-4294,-7,0,262,252,10
BR1_2729417748,8,True,1,0,0,17899,207,32,7.2,True,7,False,0,1,0,17308,208,72,7.4,False,29.31165,591,1,1,239,280,-41
BR1_2705354727,2,True,1,0,0,14799,216,48,7.4,False,2,False,0,0,0,15573,230,52,7.2,True,28.211883333333333,-774,0,1,264,282,-18
BR1_2730690992,9,False,0,1,0,19163,214,48,7.4,False,9,True,1,0,0,18838,203,60,7.0,True,29.1871,325,0,-1,262,263,-1
BR1_2723593150,10,True,0,0,0,18593,223,56,7.2,True,3,False,0,0,0,14095,211,52,6.4,False,26.150433333333332,4498,7,0,279,263,16
BR1_2724488048,10,True,0,1,0,18739,195,56,7.2,False,12,False,1,0,0,20309,223,63,7.6,True,27.53535,-1570,-2,-1,251,286,-35
BR1_2723598621,13,True,0,0,0,19228,175,49,7.0,True,7,False,1,0,0,17201,174,50,7.0,False,28.136866666666666,2027,6,-1,224,224,0
BR1_2731556672,3,False,0,0,0,16084,222,48,7.0,False,4,True,0,1,0,16185,227,52,7.4,True,29.053816666666666,-101,-1,0,270,279,-9
BR1_2731521585,2,False,0,0,0,13328,177,40,6.4,False,11,True,1,0,0,18495,200,68,7.2,True,27.426883333333333,-5167,-9,-1,217,268,-51
BR1_2724510531,8,False,1,0,0,17629,220,64,7.4,False,6,True,0,1,0,17571,199,64,7.4,True,27.661966666666668,58,2,1,284,263,21
BR1_2731159473,1,False,1,1,0,12647,145,52,6.4,False,12,True,0,0,0,18142,186,48,6.8,True,26.584566666666667,-5495,-11,1,197,234,-37
BR1_2729698793,10,True,0,0,0,17517,190,60,6.6,True,7,False,0,0,0,16704,168,40,6.6,False,26.5941,813,3,0,250,208,42
BR1_2701167632,7,True,0,0,0,17257,223,44,6.8,False,8,False,1,0,0,17698,182,40,7.2,True,29.0758,-441,-1,-1,267,222,45
BR1_2701140323,9,True,0,1,0,19032,209,52,7.0,False,7,False,1,0,0,17114,215,52,7.2,True,27.9828,1918,2,-1,261,267,-6
BR1_2729220378,6,False,0,0,0,16682,242,44,6.8,True,6,True,0,0,0,15600,180,48,6.6,False,26.0397,1082,0,0,286,228,58
BR1_2729022326,9,True,0,1,0,17258,176,44,6.8,False,5,False,1,0,0,15682,222,40,7.0,True,26.706416666666666,1576,4,-1,220,262,-42
BR1_2730033410,13,False,1,0,0,19551,162,56,6.8,True,7,True,0,0,0,16571,195,32,6.6,False,28.495783333333332,2980,6,1,218,227,-9
BR1_2731158531,9,False,1,0,0,18079,220,52,7.0,True,9,True,0,0,0,16500,161,60,6.8,False,26.056166666666666,1579,0,1,272,221,51
BR1_2725649872,7,True,0,0,0,18369,213,52,7.4,True,11,False,0,0,0,18825,216,48,7.6,False,29.238366666666668,-456,-4,0,265,264,1
BR1_2711326382,7,False,0,0,0,15544,167,44,6.4,False,9,True,1,0,0,16933,191,56,6.6,True,26.367716666666666,-1389,-2,-1,211,247,-36
BR1_2730827474,5,False,1,1,0,16918,222,60,7.2,False,8,True,0,0,0,19305,247,56,7.4,True,27.575683333333334,-2387,-3,1,282,303,-21
BR1_2731390090,7,False,0,0,0,14475,133,35,6.4,False,12,True,0,0,0,18419,198,48,7.2,True,25.613233333333334,-3944,-5,0,168,246,-78
BR1_2731385124,14,True,1,0,0,19523,215,44,7.0,True,2,False,0,0,0,13176,120,48,6.0,False,27.093183333333332,6347,12,1,259,168,91
BR1_2724748279,4,False,1,0,0,16668,252,68,7.2,False,9,True,0,0,0,17867,207,52,7.2,True,28.887316666666667,-1199,-5,1,320,259,61
BR1_2718640498,11,True,0,0,0,17144,183,40,6.8,False,9,False,1,0,0,17447,161,51,6.8,True,26.606116666666665,-303,2,-1,223,212,11
BR1_2688973682,7,False,0,1,0,16671,190,54,7.0,False,6,True,1,0,0,14803,169,49,6.8,True,27.408283333333333,1868,1,-1,244,218,26
BR1_2688313816,5,False,0,1,1,18700,236,47,7.2,False,11,True,1,0,0,20747,276,68,7.8,True,29.148433333333333,-2047,-6,-1,283,344,-61
BR1_2724735821,7,True,1,0,0,16587,194,48,6.8,True,4,False,0,0,0,14091,161,40,6.6,False,26.2834,2496,3,1,242,201,41
BR1_2724734187,7,True,1,1,0,16767,175,56,6.8,True,1,False,0,0,0,12486,159,56,6.6,False,27.211233333333332,4281,6,1,231,215,16
BR1_2724713989,3,False,1,0,0,14955,183,60,6.8,False,10,True,0,1,0,18888,228,56,7.6,True,29.464233333333333,-3933,-7,1,243,284,-41
BR1_2729504638,5,True,0,1,0,15778,208,52,7.4,False,9,False,1,0,0,17482,220,60,7.6,True,29.85425,-1704,-4,-1,260,280,-20
BR1_2729452525,8,True,0,0,0,17209,214,52,6.6,False,4,False,0,1,0,15035,179,60,6.8,True,27.17365,2174,4,0,266,239,27
BR1_2731100732,6,True,0,0,0,17585,246,42,7.2,True,8,False,1,1,0,18882,265,73,7.4,False,28.250866666666667,-1297,-2,-1,288,338,-50
BR1_2727070774,8,True,0,0,0,15597,145,44,6.4,False,12,False,0,0,0,18980,202,60,6.6,True,26.99035,-3383,-4,0,189,262,-73
BR1_2731621787,3,True,0,0,1,15825,202,36,7.0,False,6,False,1,0,0,19825,222,75,7.6,True,29.832083333333333,-4000,-3,-1,238,297,-59
BR1_2731482036,9,True,0,1,0,19316,219,56,7.4,True,4,False,0,0,0,16682,242,52,7.4,False,28.981416666666668,2634,5,0,275,294,-19
BR1_2730632964,7,True,0,0,0,17710,197,59,7.6,True,8,False,1,0,0,18157,228,56,7.4,False,29.120016666666668,-447,-1,-1,256,284,-28
BR1_2715238871,6,True,1,0,0,16568,219,56,7.0,True,5,False,0,0,0,15504,178,60,6.8,False,26.57518333333333,1064,1,1,275,238,37
BR1_2731463488,5,True,0,0,0,16868,208,59,7.6,True,4,False,1,1,0,17444,217,76,7.4,False,27.9265,-576,1,-1,267,293,-26
BR1_2726892728,8,True,0,0,0,17373,184,60,7.0,True,9,False,0,0,0,18702,227,40,7.2,False,28.202833333333334,-1329,-1,0,244,267,-23
BR1_2726870383,9,True,1,0,0,18328,204,64,7.4,True,5,False,0,0,0,16336,221,68,7.6,False,29.346533333333333,1992,4,1,268,289,-21
BR1_2696747478,7,False,0,0,0,16785,205,50,7.4,False,4,True,1,1,0,17615,224,48,7.0,True,27.64325,-830,3,-1,255,272,-17
BR1_2696398878,9,False,1,0,0,17680,184,55,6.6,True,10,True,0,0,0,17237,129,60,6.6,False,25.353733333333334,443,-1,1,239,189,50
BR1_2726114389,10,True,1,0,0,18193,213,52,7.0,True,2,False,0,1,0,13461,162,44,6.4,False,25.593716666666666,4732,8,1,265,206,59
BR1_2731471485,13,True,0,1,0,19666,180,56,7.0,False,12,False,1,0,0,19843,223,46,7.2,True,28.94023333333333,-177,1,-1,236,269,-33
BR1_2692696232,6,True,0,0,0,15867,179,37,6.8,True,10,False,1,0,0,15545,152,28,6.6,False,26.5892,322,-4,-1,216,180,36
BR1_2724083959,4,False,0,0,0,16420,244,48,6.8,False,10,True,1,1,0,18774,215,64,7.6,True,29.604033333333334,-2354,-6,-1,292,279,13
BR1_2729267425,7,False,0,0,0,16385,191,72,7.0,False,3,True,1,1,0,15369,222,44,7.0,True,26.183116666666667,1016,4,-1,263,266,-3
BR1_2728511639,2,False,0,0,0,13894,205,56,6.6,True,2,True,0,0,0,14378,231,44,6.6,False,27.495733333333334,-484,0,0,261,275,-14
BR1_2728202523,7,True,0,0,0,16841,195,44,6.8,True,5,False,0,0,0,14819,139,67,6.0,False,26.515133333333335,2022,2,0,239,206,33
BR1_2731260167,2,False,0,0,0,13329,197,40,6.8,False,11,True,1,0,0,19216,239,68,7.4,True,26.943266666666666,-5887,-9,-1,237,307,-70
BR1_2731209469,3,True,0,1,0,15513,212,64,6.8,False,7,False,1,0,0,16185,196,56,7.0,True,27.389316666666666,-672,-4,-1,276,252,24
BR1_2725092470,11,True,0,0,0,20391,249,48,7.4,True,3,False,0,0,0,15621,199,54,7.0,False,27.630233333333333,4770,8,0,297,253,44
BR1_2725050243,7,False,1,1,0,18708,210,60,6.8,False,11,True,0,0,0,18835,198,40,6.8,True,29.87825,-127,-4,1,270,238,32
BR1_2731286152,6,False,0,1,0,16658,180,55,6.8,False,9,True,1,0,0,18356,205,60,7.2,True,28.19005,-1698,-3,-1,235,265,-30
BR1_2723745357,8,False,0,0,0,17763,204,55,7.0,False,7,True,1,1,0,18753,231,48,7.2,True,28.202766666666665,-990,1,-1,259,279,-20
BR1_2722638586,14,False,1,1,0,20888,194,59,7.4,True,10,True,0,0,0,18403,182,49,6.8,False,28.2736,2485,4,1,253,231,22
BR1_2714780600,7,False,0,0,0,16725,167,52,7.2,True,7,True,1,1,0,17134,198,52,7.2,False,27.896183333333333,-409,0,-1,219,250,-31
BR1_2731773297,9,False,0,0,0,17182,179,39,6.6,False,10,True,1,0,0,18413,197,60,6.6,True,26.066233333333333,-1231,-1,-1,218,257,-39
BR1_2731742834,7,False,1,0,0,17308,203,52,7.0,True,7,True,0,1,0,16354,183,76,7.2,False,27.4879,954,0,1,255,259,-4
BR1_2730655105,7,False,0,1,0,17060,192,60,7.2,False,11,True,1,0,0,19543,195,67,7.2,True,29.229983333333333,-2483,-4,-1,252,262,-10
BR1_2730392328,10,True,0,1,0,16687,182,48,7.0,False,8,False,1,0,0,17926,232,52,6.6,True,27.46675,-1239,2,-1,230,284,-54
BR1_2731082316,3,False,0,1,0,15487,208,40,6.4,False,10,True,1,0,0,16923,172,57,7.2,True,26.713266666666666,-1436,-7,-1,248,229,19
BR1_2731233961,4,True,0,0,0,13752,119,52,5.8,False,4,False,1,0,0,15598,195,72,6.8,True,26.328683333333334,-1846,0,-1,171,267,-96
BR1_2730288615,9,False,0,1,0,18929,209,50,7.2,True,9,True,1,0,0,18119,207,62,7.2,False,28.463566666666665,810,0,-1,259,269,-10
BR1_2728737988,5,False,1,0,0,16238,208,47,7.0,False,4,True,0,1,0,17246,243,60,7.4,True,29.016883333333332,-1008,1,1,255,303,-48
BR1_2728621455,13,True,0,1,0,21402,220,48,7.4,True,14,False,1,0,0,20387,160,52,6.8,False,29.103483333333333,1015,-1,-1,268,212,56
BR1_2730966010,4,True,0,0,0,14942,207,40,6.4,False,5,False,0,0,0,15362,216,35,6.6,True,25.679183333333334,-420,-1,0,247,251,-4
BR1_2708644058,8,True,1,0,0,17319,225,59,7.0,True,6,False,0,0,0,15640,199,44,6.6,False,25.036483333333333,1679,2,1,284,243,41
BR1_2731714133,9,True,1,0,0,18079,205,52,7.0,True,4,False,0,0,0,15011,209,48,6.6,False,25.669016666666668,3068,5,1,257,257,0
BR1_2672034762,10,False,0,0,0,18076,195,50,7.0,True,5,True,1,0,0,15520,157,60,6.0,False,27.038266666666665,2556,5,-1,245,217,28
BR1_2669650922,8,False,0,1,0,18839,199,64,7.4,False,7,True,1,0,1,19715,234,72,7.4,True,28.981933333333334,-876,1,-1,263,306,-43
BR1_2731758544,4,False,1,0,0,14086,198,36,6.2,False,5,True,0,1,0,16351,235,44,7.0,True,25.502833333333335,-2265,-1,1,234,279,-45
BR1_2731729695,9,True,1,0,0,17302,222,44,6.8,True,7,False,0,0,0,15728,176,48,6.6,False,27.40865,1574,2,1,266,224,42
BR1_2731394248,7,False,0,1,0,18855,244,47,7.6,True,8,True,0,0,0,18259,243,52,7.4,False,28.20928333333333,596,-1,0,291,295,-4
BR1_2703136570,11,True,0,0,0,19520,214,56,7.2,True,3,False,0,0,0,15766,210,40,6.8,False,29.7621,3754,8,0,270,250,20
BR1_2703105621,11,True,1,0,0,19846,224,48,7.6,True,6,False,0,1,0,17812,176,56,7.2,False,28.192333333333334,2034,5,1,272,232,40
BR1_2730276514,10,False,0,0,0,17280,185,45,6.6,False,14,True,1,0,0,18998,194,48,6.8,True,25.079783333333335,-1718,-4,-1,230,242,-12
BR1_2728603828,2,False,0,1,0,15601,227,62,7.4,False,4,True,1,0,0,16705,229,45,7.2,True,27.853766666666665,-1104,-2,-1,289,274,15
BR1_2729738414,6,True,1,0,0,15911,186,64,6.8,False,5,False,0,1,0,16370,197,60,6.8,True,27.465933333333332,-459,1,1,250,257,-7
BR1_2731766226,13,True,1,1,0,20498,217,60,7.4,True,7,False,0,0,0,16661,129,56,6.6,False,28.042033333333332,3837,6,1,277,185,92
BR1_2731708571,3,False,0,0,0,15053,222,48,7.2,False,12,True,1,1,0,21068,219,58,7.8,True,27.56235,-6015,-9,-1,270,277,-7
BR1_2729552768,9,False,0,1,0,20477,254,54,7.4,True,6,True,1,0,0,18289,218,60,7.2,False,28.8196,2188,3,-1,308,278,30
BR1_2731646189,8,False,0,0,0,17622,241,62,7.2,True,5,True,0,0,0,15137,188,46,6.6,False,25.798216666666665,2485,3,0,303,234,69
BR1_2731583367,5,False,1,0,0,15849,204,48,6.4,False,10,True,0,0,0,16743,186,52,7.2,True,25.806266666666666,-894,-5,1,252,238,14
BR1_2731225319,6,True,0,0,0,15714,178,56,6.6,False,8,False,1,1,0,16594,200,56,6.8,True,26.967916666666667,-880,-2,-1,234,256,-22
BR1_2731546464,9,False,0,0,0,18421,204,56,7.2,True,11,True,1,1,0,19717,215,64,7.8,False,29.753133333333334,-1296,-2,-1,260,279,-19
BR1_2731770178,13,True,1,0,1,21725,215,48,7.2,True,11,False,0,1,0,19158,220,52,7.4,False,29.215083333333332,2567,2,1,263,272,-9
BR1_2731613395,7,False,0,1,0,16860,188,64,7.0,True,11,True,1,0,0,18625,220,48,7.2,False,29.747033333333334,-1765,-4,-1,252,268,-16
BR1_2731583806,8,False,0,0,0,15982,192,43,6.4,True,11,True,0,0,0,17067,145,32,6.4,False,25.62435,-1085,-3,0,235,177,58
BR1_2731574732,7,True,1,0,0,15554,191,52,6.4,False,8,False,0,0,0,16913,176,60,6.8,True,26.513683333333333,-1359,-1,1,243,236,7
BR1_2731630871,9,False,1,0,0,16694,185,59,7.0,True,11,True,0,0,0,17221,170,44,6.6,False,27.113633333333333,-527,-2,1,244,214,30
BR1_2731704012,7,False,0,0,0,18482,242,58,7.2,False,5,True,1,0,0,17302,202,54,7.2,True,27.8333,1180,2,-1,300,256,44
BR1_2731674888,9,True,0,0,0,17329,179,51,7.0,True,3,False,1,0,0,12775,147,48,6.6,False,26.309283333333333,4554,6,-1,230,195,35
BR1_2731576664,13,True,0,0,0,17895,151,52,6.6,True,6,False,1,0,0,16007,165,56,6.6,False,25.275033333333333,1888,7,-1,203,221,-18
BR1_2731187772,2,False,0,0,0,14158,200,60,6.8,False,11,True,1,1,0,18642,211,44,7.2,True,27.105516666666666,-4484,-9,-1,260,255,5
BR1_2730694155,3,False,1,1,0,14963,221,60,6.8,True,6,True,0,0,0,16312,180,56,6.8,False,27.16893333333333,-1349,-3,1,281,236,45
BR1_2731571462,7,False,0,0,0,16548,234,48,6.8,False,8,True,1,1,0,17481,185,56,6.6,True,27.130533333333332,-933,-1,-1,282,241,41
BR1_2728606410,5,True,0,0,0,16851,203,66,7.6,False,3,False,1,1,0,17186,234,84,7.6,True,28.146983333333335,-335,2,-1,269,318,-49
BR1_2728266281,6,True,0,0,0,16444,209,60,6.8,True,1,False,0,0,0,14113,222,64,7.2,False,27.1269,2331,5,0,269,286,-17
BR1_2729789924,11,False,0,0,0,16950,149,42,6.2,False,11,True,0,0,0,17730,168,46,6.6,True,25.4328,-780,0,0,191,214,-23
BR1_2729623576,11,True,0,0,0,19861,217,44,7.4,False,6,False,1,1,0,18255,227,68,7.0,True,27.663816666666666,1606,5,-1,261,295,-34
BR1_2729567733,4,True,0,1,0,17192,196,60,7.0,True,6,False,0,0,0,17265,219,48,7.2,False,28.68945,-73,-2,0,256,267,-11
BR1_2721267069,7,True,0,1,1,18352,220,56,7.2,True,3,False,0,0,0,13936,163,65,6.8,False,26.686466666666668,4416,4,0,276,228,48
BR1_2684363537,5,False,0,1,0,16833,228,50,7.6,False,10,True,1,0,0,19210,227,62,8.0,True,29.882633333333334,-2377,-5,-1,278,289,-11
BR1_2684166310,6,False,0,1,0,16158,168,40,6.8,True,8,True,1,0,0,17533,204,76,7.4,False,27.911133333333332,-1375,-2,-1,208,280,-72
BR1_2731229304,5,True,1,0,0,17525,216,52,7.2,True,7,False,0,0,0,17200,212,63,7.4,False,29.785533333333333,325,-2,1,268,275,-7
BR1_2730207105,19,True,0,1,0,23201,213,48,7.4,True,10,False,0,0,0,18238,199,64,7.2,False,27.856333333333332,4963,9,0,261,263,-2
BR1_2728159279,15,False,0,1,0,21080,155,48,6.8,True,12,True,1,0,0,18468,151,48,6.6,False,29.5555,2612,3,-1,203,199,4
BR1_2730713407,8,False,0,1,0,19024,150,72,7.0,False,19,True,1,0,0,21789,196,48,7.4,True,27.999083333333335,-2765,-11,-1,222,244,-22
BR1_2730653708,15,True,1,1,0,20122,171,56,7.0,True,9,False,0,0,0,17341,222,64,6.8,False,28.54695,2781,6,1,227,286,-59
BR1_2685781996,10,True,1,0,0,19607,253,60,7.8,True,4,False,0,1,0,16949,194,44,7.0,False,27.874883333333333,2658,6,1,313,238,75
BR1_2728931968,8,True,0,0,0,19042,231,76,7.2,True,3,False,1,1,0,15465,181,52,7.2,False,28.63383333333333,3577,5,-1,307,233,74
BR1_2729264828,12,True,0,0,0,18459,190,52,6.8,True,12,False,1,1,0,18845,184,48,6.6,False,27.30605,-386,0,-1,242,232,10
BR1_2731581851,10,True,1,0,0,20088,192,60,7.0,True,8,False,0,0,0,17761,188,47,6.8,False,28.422666666666668,2327,2,1,252,235,17
BR1_2720282561,12,False,0,0,0,16935,138,56,6.6,True,4,True,0,0,0,14664,148,48,6.2,False,25.1558,2271,8,0,194,196,-2
BR1_2718632818,4,True,0,1,0,15094,198,48,7.0,False,6,False,1,0,0,16401,240,64,7.2,True,27.364566666666665,-1307,-2,-1,246,304,-58
BR1_2731707072,5,True,0,0,0,15129,170,51,6.6,True,9,False,0,1,0,20539,256,40,7.2,False,29.162966666666666,-5410,-4,0,221,296,-75
BR1_2726563951,6,False,0,1,0,17983,224,60,7.4,True,5,True,0,0,0,17526,217,68,7.2,False,28.599983333333334,457,1,0,284,285,-1
BR1_2730506982,13,False,1,0,0,20913,222,60,7.6,True,9,True,0,0,0,17911,190,48,7.2,False,28.096083333333333,3002,4,1,282,238,44
BR1_2731661320,5,True,0,1,0,15714,193,52,7.2,True,4,False,1,0,0,14220,188,64,7.0,False,25.922883333333335,1494,1,-1,245,252,-7
BR1_2723572991,7,False,0,0,0,15164,142,44,6.0,False,12,True,1,1,1,18310,181,72,7.2,True,26.552733333333332,-3146,-5,-1,186,253,-67
BR1_2720397737,3,False,0,0,0,14767,176,55,6.8,False,9,True,1,1,0,18373,210,56,7.4,True,28.549416666666666,-3606,-6,-1,231,266,-35
BR1_2730686809,6,True,0,1,0,15778,186,44,6.8,True,3,False,1,0,0,14019,166,56,6.6,False,27.1163,1759,3,-1,230,222,8
BR1_2731607734,4,True,0,0,0,14255,127,64,6.2,False,12,False,1,0,0,17487,182,44,6.6,True,26.1712,-3232,-8,-1,191,226,-35
BR1_2731527977,5,True,0,1,0,17371,215,60,7.0,False,7,False,1,0,0,19313,252,64,7.4,True,29.190816666666667,-1942,-2,-1,275,316,-41
BR1_2731468913,6,False,0,0,0,15498,177,48,7.0,True,3,True,0,0,0,14611,216,44,6.6,False,25.277633333333334,887,3,0,225,260,-35
BR1_2731452365,10,False,1,0,0,18387,167,57,7.0,False,8,True,0,0,0,18318,205,46,7.0,True,29.084933333333332,69,2,1,224,251,-27
BR1_2730485471,10,True,1,0,0,18965,226,56,7.8,True,6,False,0,1,0,16846,179,51,7.0,False,29.741433333333333,2119,4,1,282,230,52
BR1_2721126093,3,True,0,0,0,16691,209,71,7.0,False,8,False,1,0,0,18315,236,60,7.4,True,28.986283333333333,-1624,-5,-1,280,296,-16
BR1_2730827739,5,True,0,0,0,16647,181,60,7.2,False,8,False,1,0,0,18974,220,64,7.2,True,28.823216666666667,-2327,-3,-1,241,284,-43
BR1_2730293022,5,True,0,0,0,15322,189,44,6.6,True,5,False,1,1,0,16176,201,60,6.8,False,26.74275,-854,0,-1,233,261,-28
BR1_2730200705,0,False,0,0,0,14740,210,64,7.2,False,6,True,0,1,0,18710,238,72,7.8,True,28.164233333333332,-3970,-6,0,274,310,-36
BR1_2699348787,7,False,0,0,1,17884,203,60,7.4,True,12,True,1,1,0,21581,250,64,7.6,False,28.74,-3697,-5,-1,263,314,-51
BR1_2695199693,7,True,0,0,0,15608,174,32,6.4,False,8,False,0,0,0,16324,184,60,6.8,True,26.842833333333335,-716,-1,0,206,244,-38
BR1_2694529557,9,True,1,0,0,17891,205,51,7.0,True,4,False,0,1,0,15060,166,64,6.4,False,25.8977,2831,5,1,256,230,26
BR1_2693386038,6,False,1,0,0,18419,212,58,7.2,True,5,True,0,1,0,17436,225,68,7.2,False,28.217266666666667,983,1,1,270,293,-23
BR1_2731107037,6,False,0,0,0,16473,197,56,6.8,True,4,True,0,0,0,15156,194,52,6.8,False,27.015666666666668,1317,2,0,253,246,7
BR1_2730035424,5,False,0,0,0,15748,215,48,7.0,True,7,True,1,0,0,16047,181,52,6.8,False,25.52435,-299,-2,-1,263,233,30
BR1_2728977530,6,False,1,1,0,15859,160,52,6.2,False,15,True,0,0,0,20437,191,56,7.0,True,26.635433333333335,-4578,-9,1,212,247,-35
BR1_2709299778,4,True,0,0,0,14496,200,52,7.0,False,7,False,1,0,0,17292,183,60,6.8,True,27.379383333333333,-2796,-3,-1,252,243,9
BR1_2708059984,11,True,0,0,1,19021,209,52,6.6,True,6,False,0,0,0,15398,175,48,6.4,False,27.4726,3623,5,0,261,223,38
BR1_2713367280,7,False,1,0,0,17909,204,64,7.4,True,4,True,0,0,0,15544,207,44,7.0,False,28.378433333333334,2365,3,1,268,251,17
BR1_2730257148,5,True,0,0,0,18223,275,64,7.6,False,6,False,1,0,0,17833,195,60,7.6,True,29.118983333333333,390,-1,-1,339,255,84
BR1_2730545914,4,True,1,0,0,14973,177,51,6.6,False,7,False,0,0,0,15997,172,60,7.0,True,26.10425,-1024,-3,1,228,232,-4
BR1_2730533505,9,True,0,0,0,16846,178,48,6.6,False,11,False,1,0,0,18229,174,54,6.8,True,25.968433333333333,-1383,-2,-1,226,228,-2
BR1_2731084052,6,True,0,0,0,17305,226,68,7.4,False,8,False,1,0,0,18803,207,64,7.2,True,28.461683333333333,-1498,-2,-1,294,271,23
BR1_2731246932,0,False,1,1,0,14670,220,56,7.2,False,6,True,0,0,0,18108,244,72,7.2,True,28.694733333333332,-3438,-6,1,276,316,-40
BR1_2731210508,8,True,0,0,0,16988,196,44,6.6,True,6,False,0,0,0,15236,164,56,6.2,False,26.06523333333333,1752,2,0,240,220,20
BR1_2730857613,10,False,0,0,0,19786,227,56,7.6,True,7,True,0,0,0,17711,203,60,7.4,False,29.01545,2075,3,0,283,263,20
BR1_2731625294,4,True,1,0,0,17637,239,76,7.6,False,5,False,0,1,0,17045,201,58,7.2,True,28.78425,592,-1,1,315,259,56
BR1_2731270234,3,False,0,0,0,14543,173,56,6.4,False,12,True,1,0,0,19037,213,64,7.2,True,25.1009,-4494,-9,-1,229,277,-48
BR1_2731246132,5,False,0,1,0,17594,250,68,7.6,False,5,True,1,0,0,17725,225,56,7.4,True,28.997283333333332,-131,0,-1,318,281,37
BR1_2731653984,6,False,0,0,0,17087,193,62,7.4,False,5,True,1,1,0,17821,241,72,7.4,True,28.26365,-734,1,-1,255,313,-58
BR1_2719541320,5,True,1,0,0,16155,192,72,6.8,True,3,False,0,0,0,15259,210,56,7.2,False,25.757483333333333,896,2,1,264,266,-2
BR1_2731673591,9,True,1,0,0,16127,204,44,7.0,True,2,False,0,1,0,15529,188,60,6.8,False,27.10985,598,7,1,248,248,0
BR1_2728601850,7,True,0,1,0,16245,180,64,6.6,True,5,False,1,0,0,15057,183,52,6.6,False,25.61916666666667,1188,2,-1,244,235,9
BR1_2728133045,9,True,1,1,0,18206,231,64,7.4,True,4,False,0,0,0,16417,212,64,7.2,False,29.59855,1789,5,1,295,276,19
BR1_2731675397,9,False,0,0,0,18416,234,64,7.4,True,6,True,0,0,0,16998,242,48,7.0,False,28.553516666666667,1418,3,0,298,290,8
BR1_2728367846,4,False,0,0,0,13837,169,28,6.4,False,7,True,0,1,0,17204,201,50,7.0,True,27.461716666666668,-3367,-3,0,197,251,-54
BR1_2730673000,2,True,0,0,0,15528,212,52,7.2,False,8,False,0,1,0,17964,211,68,7.4,True,28.418233333333333,-2436,-6,0,264,279,-15
BR1_2731101289,7,True,1,0,0,16579,177,68,7.2,True,7,False,0,1,0,17616,191,48,7.4,False,28.063533333333332,-1037,0,1,245,239,6
BR1_2730964327,10,False,0,0,0,19497,226,56,7.2,True,10,True,0,1,0,19682,209,64,7.4,False,28.211283333333334,-185,0,0,282,273,9
BR1_2730948992,10,True,0,0,0,19521,218,56,7.6,True,8,False,1,0,0,17499,205,59,7.2,False,29.902483333333333,2022,2,-1,274,264,10
BR1_2730206244,8,False,0,0,0,18281,217,44,7.2,False,10,True,1,0,0,19232,193,76,7.4,True,27.941783333333333,-951,-2,-1,261,269,-8
BR1_2729754307,6,False,1,0,0,18422,267,56,7.8,True,4,True,0,0,0,16699,231,68,7.4,False,29.3279,1723,2,1,323,299,24
BR1_2695969066,8,True,0,1,1,19914,210,56,7.0,True,10,False,1,0,0,18772,225,36,7.2,False,28.121383333333334,1142,-2,-1,266,261,5
BR1_2695926721,7,True,0,1,0,18468,230,56,7.4,True,3,False,0,0,0,16388,227,64,7.0,False,29.6974,2080,4,0,286,291,-5
BR1_2731698905,7,True,0,0,0,16518,207,60,7.0,False,9,False,0,1,0,16798,188,44,6.8,True,25.6865,-280,-2,0,267,232,35
BR1_2708336908,7,True,1,0,0,16259,214,52,7.2,True,4,False,0,0,0,14654,189,68,6.8,False,26.535833333333333,1605,3,1,266,257,9
BR1_2721634255,8,True,0,0,0,18135,208,48,7.0,True,10,False,1,1,0,19812,225,64,7.4,False,29.725016666666665,-1677,-2,-1,256,289,-33
BR1_2731119336,14,False,0,0,0,19119,195,40,6.6,False,6,True,0,0,0,16800,206,52,6.8,True,25.577933333333334,2319,8,0,235,258,-23
BR1_2731371625,9,True,0,0,0,15799,151,40,6.2,False,9,False,0,0,0,17943,182,56,7.2,True,25.160933333333332,-2144,0,0,191,238,-47
BR1_2731359687,7,False,0,0,0,18381,204,68,7.6,True,7,True,0,1,0,16835,163,44,6.8,False,28.52745,1546,0,0,272,207,65
BR1_2724301216,9,True,0,1,0,20387,225,64,7.4,True,8,False,1,0,0,17602,193,44,7.2,False,27.740716666666668,2785,1,-1,289,237,52
BR1_2731121196,7,True,1,0,0,15584,169,52,6.6,True,7,False,0,1,0,16302,163,60,6.4,False,25.418066666666668,-718,0,1,221,223,-2
BR1_2731097813,3,False,0,1,0,14377,174,56,6.4,False,7,True,0,0,0,16233,182,40,6.6,True,27.02488333333333,-1856,-4,0,230,222,8
BR1_2731003215,3,False,0,0,0,14599,198,48,6.8,False,6,True,1,1,1,18228,219,52,7.2,True,27.183633333333333,-3629,-3,-1,246,271,-25
BR1_2731437756,9,True,0,0,0,17972,162,48,7.0,False,17,False,1,0,0,21600,201,64,7.4,True,29.224766666666667,-3628,-8,-1,210,265,-55
BR1_2702789332,5,True,0,1,0,17829,226,48,7.4,True,5,False,0,0,0,16849,209,63,7.2,False,27.516766666666665,980,0,0,274,272,2
BR1_2698740510,10,True,1,0,0,18087,182,68,7.0,True,5,False,0,0,0,14530,169,52,6.6,False,26.647783333333333,3557,5,1,250,221,29
BR1_2719239459,12,True,1,1,0,20175,219,60,7.4,False,6,False,0,0,0,18416,236,60,7.4,True,27.93305,1759,6,1,279,296,-17
BR1_2700002358,4,False,0,0,0,14141,173,40,6.4,True,10,True,1,0,0,18349,238,52,7.2,False,27.462883333333334,-4208,-6,-1,213,290,-77
BR1_2731665142,9,True,1,0,0,17894,197,48,7.0,True,3,False,0,0,0,14411,179,48,6.4,False,27.177666666666667,3483,6,1,245,227,18
BR1_2730800289,5,True,0,1,0,14728,188,48,6.8,False,3,False,1,0,0,14760,182,52,6.6,True,26.587633333333333,-32,2,-1,236,234,2
BR1_2705020115,9,False,1,0,0,18379,206,64,7.4,True,3,True,0,1,0,15043,196,60,6.8,False,28.014766666666667,3336,6,1,270,256,14
BR1_2731172820,5,True,1,0,0,16498,224,56,6.8,True,2,False,0,1,0,14169,173,48,6.4,False,26.337116666666667,2329,3,1,280,221,59
BR1_2726964340,8,True,1,0,0,16551,174,60,6.8,True,5,False,0,0,0,15043,202,56,6.8,False,27.187066666666666,1508,3,1,234,258,-24
BR1_2717809253,12,False,0,0,0,18976,199,60,7.2,False,6,True,0,0,0,15649,179,64,6.8,True,26.655183333333333,3327,6,0,259,243,16
BR1_2725935514,12,False,0,0,0,19552,238,52,7.2,False,11,True,1,0,0,18601,180,60,7.2,True,29.74973333333333,951,1,-1,290,240,50
BR1_2725860790,9,True,1,1,0,17522,183,56,7.2,True,8,False,0,0,0,16971,181,60,6.8,False,26.596983333333334,551,1,1,239,241,-2
BR1_2731699060,6,False,0,0,0,16118,163,46,6.6,False,8,True,0,0,0,18128,208,48,7.2,True,29.55291666666667,-2010,-2,0,209,256,-47
BR1_2729575026,9,True,1,0,0,18575,185,56,7.0,True,4,False,0,0,0,15312,167,52,6.8,False,27.993583333333333,3263,5,1,241,219,22
BR1_2729619350,9,True,1,1,0,18899,228,60,7.4,True,8,False,0,0,0,18909,213,72,7.2,False,29.1845,-10,1,1,288,285,3
BR1_2722185754,8,True,0,0,0,17936,215,56,7.2,True,2,False,1,0,0,13301,161,60,6.4,False,25.908083333333334,4635,6,-1,271,221,50
BR1_2701617636,10,False,1,0,0,17900,170,48,6.6,True,7,True,0,1,0,16204,184,60,6.8,False,25.941883333333333,1696,3,1,218,244,-26
BR1_2727986796,9,True,0,0,0,18751,186,66,7.2,True,10,False,1,0,0,18923,212,52,7.4,False,29.70553333333333,-172,-1,-1,252,264,-12
BR1_2727966055,6,False,0,0,0,15081,149,40,6.4,False,9,True,1,1,0,17244,197,60,6.6,True,26.852933333333333,-2163,-3,-1,189,257,-68
BR1_2727938301,7,True,0,1,0,17737,193,56,7.4,False,8,False,0,0,0,18451,226,56,7.4,True,29.5246,-714,-1,0,249,282,-33
BR1_2699722304,8,True,0,0,0,18584,234,76,7.8,True,4,False,0,1,0,16764,228,76,7.4,False,27.86006666666667,1820,4,0,310,304,6
BR1_2699650951,6,False,0,1,0,15551,171,68,7.0,False,4,True,1,0,0,15298,209,44,7.0,True,26.963833333333334,253,2,-1,239,253,-14
BR1_2729687864,3,False,1,0,0,15114,220,52,6.6,False,7,True,0,1,0,16827,219,72,7.4,True,25.205666666666666,-1713,-4,1,272,291,-19
BR1_2719659045,9,True,0,0,0,19254,202,62,7.2,False,10,False,1,1,0,19552,223,56,7.4,True,29.241816666666665,-298,-1,-1,264,279,-15
BR1_2731668281,9,False,0,0,0,17839,241,52,7.4,True,10,True,1,1,0,18925,227,64,7.2,False,28.759783333333335,-1086,-1,-1,293,291,2
BR1_2686816247,8,True,1,0,0,17577,169,52,7.0,True,7,False,0,0,0,20187,232,66,7.6,False,27.946533333333335,-2610,1,1,221,298,-77
BR1_2683230998,1,False,0,0,0,14022,198,60,6.8,False,8,True,1,0,0,16928,193,56,7.0,True,27.396433333333334,-2906,-7,-1,258,249,9
BR1_2683215471,7,True,1,1,0,18165,213,75,7.6,False,15,False,0,0,0,20269,232,36,7.8,True,29.996933333333335,-2104,-8,1,288,268,20
BR1_2730247001,4,True,1,1,0,15044,181,52,6.6,True,8,False,0,0,0,16209,197,32,6.6,False,25.298083333333334,-1165,-4,1,233,229,4
BR1_2717665543,10,True,0,0,0,18839,196,52,7.2,False,12,False,1,1,0,18750,177,56,7.2,True,29.343833333333333,89,-2,-1,248,233,15
BR1_2714892206,6,True,1,0,0,16778,201,64,7.2,True,4,False,0,1,0,16502,250,32,7.4,False,29.420466666666666,276,2,1,265,282,-17
BR1_2731769079,9,False,0,0,0,16795,199,51,7.0,True,6,True,0,0,0,15839,187,56,6.8,False,25.50805,956,3,0,250,243,7
BR1_2728608200,8,False,1,0,0,18194,208,60,7.4,False,8,True,0,1,0,18595,231,52,7.4,True,28.64715,-401,0,1,268,283,-15
BR1_2729710729,6,True,1,0,0,15933,180,44,6.8,True,3,False,0,1,0,14481,183,60,6.4,False,25.924866666666667,1452,3,1,224,243,-19
BR1_2728600741,5,False,1,0,0,15070,173,52,6.8,False,7,True,0,1,0,17136,212,59,7.4,True,27.470766666666666,-2066,-2,1,225,271,-46
BR1_2728136352,3,False,0,1,0,14676,154,52,6.8,False,8,True,0,0,0,18193,190,52,7.0,True,27.776133333333334,-3517,-5,0,206,242,-36
BR1_2688880186,9,True,1,0,0,18377,240,56,7.4,True,3,False,0,1,0,15855,203,52,7.2,False,28.589466666666667,2522,6,1,296,255,41
BR1_2719642384,4,False,0,0,0,14172,145,56,6.4,False,6,True,1,0,0,17042,204,68,7.0,True,25.080166666666667,-2870,-2,-1,201,272,-71
BR1_2731212996,6,True,0,1,0,16268,148,59,7.0,False,10,False,1,0,0,19174,207,76,7.2,True,27.706566666666667,-2906,-4,-1,207,283,-76
BR1_2729617555,8,False,0,0,0,17824,176,48,6.8,False,11,True,1,0,0,18751,206,40,7.4,True,28.521983333333335,-927,-3,-1,224,246,-22
BR1_2707632466,4,False,1,0,0,16338,193,63,6.8,True,12,True,0,0,0,17590,184,56,7.0,False,26.281683333333334,-1252,-8,1,256,240,16
BR1_2707603080,3,False,1,0,0,13124,136,28,5.8,False,11,True,0,0,0,18136,153,52,6.4,True,27.309416666666667,-5012,-8,1,164,205,-41
BR1_2731354922,3,False,0,0,0,16907,259,60,7.4,False,7,True,1,0,0,18606,222,56,7.6,True,29.73505,-1699,-4,-1,319,278,41
BR1_2719263395,5,True,1,0,0,15162,188,62,7.0,False,10,False,0,1,1,21005,253,52,7.4,True,29.5023,-5843,-5,1,250,305,-55
BR1_2704567194,5,True,0,1,0,18024,237,56,7.4,False,10,False,1,0,0,19389,251,64,8.0,True,28.85335,-1365,-5,-1,293,315,-22
BR1_2704546177,6,False,0,0,0,14055,153,36,5.8,False,10,True,0,0,0,18105,222,52,6.4,True,26.18745,-4050,-4,0,189,274,-85
BR1_2704529153,6,True,0,0,0,15593,195,60,6.8,False,9,False,1,1,0,17478,191,50,6.8,True,26.003683333333335,-1885,-3,-1,255,241,14
BR1_2711775284,10,True,1,1,0,17641,190,48,6.8,True,9,False,0,0,0,16513,165,60,6.6,False,26.04895,1128,1,1,238,225,13
BR1_2711550591,5,False,0,0,0,16143,181,50,6.8,False,10,True,1,0,0,18717,226,40,7.2,True,29.596866666666667,-2574,-5,-1,231,266,-35
BR1_2731575964,8,True,0,0,0,15678,190,36,6.6,False,8,False,1,1,0,16925,185,56,6.4,True,26.389166666666668,-1247,0,-1,226,241,-15
BR1_2731473334,6,False,0,1,0,16463,193,52,7.0,True,4,True,1,0,0,14226,162,50,6.2,False,26.36055,2237,2,-1,245,212,33
BR1_2731311327,10,True,0,0,0,17385,192,52,7.0,True,3,False,1,0,0,13939,177,48,6.6,False,26.945033333333335,3446,7,-1,244,225,19
BR1_2731589337,14,True,0,0,0,22162,199,60,7.8,True,4,False,1,0,0,16052,194,64,6.8,False,27.523983333333334,6110,10,-1,259,258,1
BR1_2731571424,9,False,1,0,0,16335,179,44,6.8,False,8,True,0,0,0,16644,183,56,6.8,True,27.418883333333333,-309,1,1,223,239,-16
BR1_2731757690,6,False,0,1,0,16904,209,44,6.8,True,5,True,1,0,0,14913,180,56,6.6,False,25.82375,1991,1,-1,253,236,17
BR1_2731696720,5,False,1,0,0,15741,207,52,7.0,True,6,True,0,1,0,14947,170,47,7.0,False,26.533933333333334,794,-1,1,259,217,42
BR1_2731170326,6,False,0,1,0,16562,170,60,6.8,False,8,True,1,0,0,18384,215,64,7.6,True,28.9489,-1822,-2,-1,230,279,-49
BR1_2718211923,9,True,1,1,0,18280,202,60,7.0,True,3,False,0,0,0,13485,159,48,6.2,False,27.41655,4795,6,1,262,207,55
BR1_2718144503,8,True,1,0,0,17474,203,61,7.2,True,5,False,0,0,0,15069,174,56,6.6,False,26.00805,2405,3,1,264,230,34
BR1_2717912083,8,True,1,0,0,17747,222,44,7.4,True,2,False,0,0,0,15006,215,60,7.0,False,27.533533333333335,2741,6,1,266,275,-9
BR1_2716016299,5,True,0,1,0,15648,207,60,7.2,True,4,False,1,0,0,15282,187,48,7.0,False,25.081733333333332,366,1,-1,267,235,32
BR1_2729458840,14,False,1,0,0,20068,189,68,7.6,True,10,True,0,0,0,19628,202,48,7.4,False,27.649216666666668,440,4,1,257,250,7
BR1_2731371410,5,False,0,0,0,15801,181,55,6.8,True,9,True,0,0,0,17206,202,40,6.8,False,26.98395,-1405,-4,0,236,242,-6
BR1_2731358656,5,False,0,0,0,16133,204,52,7.2,True,5,True,1,1,0,17479,237,56,7.2,False,29.417083333333334,-1346,0,-1,256,293,-37
BR1_2714625612,9,False,0,0,0,17086,178,52,6.8,True,4,True,0,0,0,13734,169,44,6.4,False,27.27605,3352,5,0,230,213,17
BR1_2714418190,3,False,0,0,0,13308,136,48,6.2,False,11,True,1,0,0,16409,153,56,6.2,True,26.686466666666668,-3101,-8,-1,184,209,-25
BR1_2731355475,5,True,0,0,0,17121,204,56,7.2,True,8,False,0,0,0,18665,220,60,7.2,False,29.915483333333334,-1544,-3,0,260,280,-20
BR1_2731311113,10,True,1,0,0,19270,231,60,7.8,True,4,False,0,1,0,17128,247,48,7.4,False,28.627483333333334,2142,6,1,291,295,-4
BR1_2731443614,8,False,0,1,0,16792,159,40,6.2,False,9,True,0,0,0,20414,254,59,7.2,True,29.578833333333332,-3622,-1,0,199,313,-114
BR1_2731737058,3,False,0,0,0,15277,197,48,7.0,True,3,True,0,0,0,14016,177,52,6.4,False,26.0478,1261,0,0,245,229,16
BR1_2730124130,9,True,0,0,0,17266,203,48,7.2,False,8,False,0,0,0,17570,202,36,7.0,True,28.167033333333332,-304,1,0,251,238,13
BR1_2731315950,6,False,1,0,0,16838,174,60,7.0,False,13,True,0,1,0,21359,195,56,7.4,True,29.881466666666668,-4521,-7,1,234,251,-17
BR1_2675707065,10,True,1,0,0,17639,180,44,7.2,True,4,False,0,0,0,16409,206,52,7.0,False,28.133333333333333,1230,6,1,224,258,-34
BR1_2675688844,10,False,1,0,0,17224,198,52,6.8,False,4,True,0,0,0,15291,183,60,6.8,True,27.007583333333333,1933,6,1,250,243,7
BR1_2731276484,7,True,0,0,0,15844,160,52,6.6,False,10,False,1,0,0,17008,173,60,7.2,True,26.250333333333334,-1164,-3,-1,212,233,-21
BR1_2693022665,9,True,0,0,0,17248,179,40,6.8,False,7,False,1,0,0,17834,211,60,7.0,True,27.85985,-586,2,-1,219,271,-52
BR1_2678629778,9,True,1,1,0,19068,241,62,7.2,True,5,False,0,0,0,17413,218,47,7.0,False,28.6739,1655,4,1,303,265,38
BR1_2731755836,11,True,1,1,0,19569,203,60,7.2,True,7,False,0,0,0,16031,190,40,7.0,False,28.32496666666667,3538,4,1,263,230,33
BR1_2731071594,7,False,1,1,0,16909,203,42,7.4,True,6,True,0,0,0,17542,226,48,6.8,False,29.058566666666668,-633,1,1,245,274,-29
BR1_2731451436,11,False,0,0,0,18444,194,56,7.2,False,12,True,1,0,0,19277,186,48,7.4,True,29.82795,-833,-1,-1,250,234,16
BR1_2731181123,8,False,0,0,0,18302,203,48,7.0,True,13,True,1,0,0,19703,222,52,7.2,False,28.2544,-1401,-5,-1,251,274,-23
BR1_2730941023,9,True,0,0,0,17179,196,40,6.8,False,6,False,1,1,0,16971,193,64,7.0,True,28.748433333333335,208,3,-1,236,257,-21
BR1_2722741853,6,True,1,1,0,16631,167,56,7.0,True,2,False,0,0,0,14170,175,68,6.6,False,27.401083333333332,2461,4,1,223,243,-20
BR1_2729950407,6,False,0,0,0,14849,150,48,6.4,True,5,True,0,0,0,15209,196,52,6.4,False,25.13355,-360,1,0,198,248,-50
BR1_2730155069,5,True,0,1,0,16414,203,52,7.0,True,3,False,1,0,0,14110,168,49,6.8,False,25.01915,2304,2,-1,255,217,38
BR1_2718727691,10,False,1,0,0,18973,221,64,7.4,True,5,True,0,0,0,16863,217,63,7.2,False,29.48995,2110,5,1,285,280,5
BR1_2731519995,6,False,0,0,0,15719,177,38,6.4,False,11,True,1,0,0,18080,208,44,6.6,True,26.347533333333335,-2361,-5,-1,215,252,-37
BR1_2731509069,8,False,1,0,0,17360,179,52,6.8,False,14,True,0,0,0,20346,187,52,7.2,True,28.230383333333332,-2986,-6,1,231,239,-8
BR1_2730752889,9,True,1,0,0,17636,243,44,7.0,True,6,False,0,0,0,15569,183,44,6.6,False,27.032133333333334,2067,3,1,287,227,60
BR1_2721693086,8,False,0,1,0,18016,189,56,6.8,False,8,True,0,0,0,19180,215,64,7.4,True,29.609483333333333,-1164,0,0,245,279,-34
BR1_2712264154,8,True,0,1,0,17049,185,56,6.8,True,3,False,0,0,0,14571,206,52,6.6,False,27.137366666666665,2478,5,0,241,258,-17
BR1_2710582005,5,True,0,0,0,15930,217,64,7.0,False,5,False,1,0,0,16215,240,56,6.8,True,26.50435,-285,0,-1,281,296,-15
BR1_2726106047,10,True,1,1,0,18154,191,44,6.8,True,3,False,0,0,0,14692,180,60,6.8,False,25.255416666666665,3462,7,1,235,240,-5
BR1_2728901927,2,True,0,0,0,14926,208,48,7.0,False,9,False,0,1,0,18013,209,60,7.2,True,27.735566666666667,-3087,-7,0,256,269,-13
BR1_2689924811,7,True,1,0,0,15364,165,54,7.0,True,6,False,0,0,0,16333,193,52,6.8,False,26.811666666666667,-969,1,1,219,245,-26
BR1_2689829802,5,True,1,0,0,16997,250,44,7.4,True,4,False,0,1,0,16573,224,68,7.4,False,28.936216666666667,424,1,1,294,292,2
BR1_2729531567,9,True,0,1,0,18847,231,52,7.4,False,6,False,1,0,0,16819,210,60,7.2,True,29.9486,2028,3,-1,283,270,13
BR1_2729239187,4,False,0,0,0,14372,166,52,6.4,False,8,True,1,0,0,16082,157,50,6.4,True,25.84505,-1710,-4,-1,218,207,11
BR1_2728913940,5,True,0,0,0,16756,202,60,7.0,False,9,False,1,1,0,19477,219,68,7.2,True,28.276516666666666,-2721,-4,-1,262,287,-25
BR1_2724465772,10,False,1,0,0,17770,217,36,7.0,True,5,True,0,0,0,13680,146,32,6.4,False,27.333233333333332,4090,5,1,253,178,75
BR1_2722035382,10,True,0,0,0,16731,150,36,6.4,False,7,False,0,0,0,15821,186,44,6.8,True,25.13635,910,3,0,186,230,-44
BR1_2711076827,5,False,0,0,0,14438,169,36,6.4,False,8,True,1,0,0,16452,197,52,6.8,True,25.152783333333332,-2014,-3,-1,205,249,-44
BR1_2725590143,6,True,0,0,0,16564,181,60,7.0,False,8,False,1,1,0,17250,171,76,7.4,True,29.320133333333334,-686,-2,-1,241,247,-6
BR1_2682242622,8,True,1,0,0,17492,202,56,7.0,True,4,False,0,0,0,14409,200,44,6.4,False,26.09936666666667,3083,4,1,258,244,14
BR1_2731594860,13,True,1,0,0,19294,231,56,7.2,True,7,False,0,0,0,16622,195,52,7.0,False,27.994883333333334,2672,6,1,287,247,40
BR1_2731519273,2,False,0,0,0,14653,218,48,6.8,False,6,True,1,0,0,15709,185,68,7.0,True,25.13445,-1056,-4,-1,266,253,13
BR1_2731497210,6,False,0,1,1,18383,218,60,7.2,False,7,True,1,0,0,16137,181,60,6.8,True,25.530666666666665,2246,-1,-1,278,241,37
BR1_2731493428,14,True,0,0,0,21279,223,56,7.4,True,11,False,0,0,0,19312,207,56,7.4,False,28.08515,1967,3,0,279,263,16
BR1_2731364855,10,True,0,0,0,19212,221,31,7.0,True,8,False,1,1,0,18086,174,44,6.8,False,29.648566666666667,1126,2,-1,252,218,34
BR1_2731514619,6,True,0,0,0,15855,149,52,6.4,True,8,False,1,0,0,17784,190,50,7.0,False,26.088466666666665,-1929,-2,-1,201,240,-39
BR1_2729612982,5,True,1,0,0,15108,185,60,6.6,False,2,False,0,0,0,13194,178,45,6.6,True,26.753983333333334,1914,3,1,245,223,22
BR1_2700194889,8,True,1,1,0,18508,219,63,7.4,True,1,False,0,0,0,14910,205,64,6.8,False,27.593866666666667,3598,7,1,282,269,13
BR1_2700177629,13,True,0,0,0,19137,179,52,7.0,False,5,False,1,0,0,15376,177,58,6.6,True,27.412033333333333,3761,8,-1,231,235,-4
BR1_2699861169,5,True,0,0,0,16160,215,52,7.0,False,13,False,0,1,0,21157,229,56,7.2,True,29.06415,-4997,-8,0,267,285,-18
BR1_2731464149,6,False,0,0,0,15803,168,38,6.6,False,14,True,1,0,0,19520,193,73,7.0,True,26.749016666666666,-3717,-8,-1,206,266,-60
BR1_2694800235,4,True,1,0,0,15101,203,44,6.8,True,5,False,0,0,0,14665,171,40,6.6,False,27.35621666666667,436,-1,1,247,211,36
BR1_2731419165,9,False,0,1,0,19690,233,64,7.6,True,12,True,1,0,0,19730,168,56,7.4,False,29.067833333333333,-40,-3,-1,297,224,73
BR1_2731410159,4,False,0,0,0,14927,178,38,6.6,False,10,True,0,0,0,18813,232,44,6.8,True,25.615683333333333,-3886,-6,0,216,276,-60
BR1_2731502190,14,True,1,1,0,20755,217,52,7.6,False,10,False,0,0,0,18945,201,60,7.2,True,29.458033333333333,1810,4,1,269,261,8
BR1_2731500331,2,False,0,0,0,13064,186,50,6.4,False,6,True,0,1,0,16729,217,58,7.2,True,27.444383333333334,-3665,-4,0,236,275,-39
BR1_2731485612,5,True,0,1,0,14862,151,52,6.4,False,10,False,1,0,0,18741,199,56,7.0,True,27.06126666666667,-3879,-5,-1,203,255,-52
BR1_2731166064,3,False,1,0,0,14077,195,44,6.6,True,2,True,0,0,0,13884,179,56,6.6,False,25.242516666666667,193,1,1,239,235,4
BR1_2731762188,9,True,0,0,0,18374,179,44,7.0,False,9,False,1,0,0,18156,200,48,7.2,True,27.787466666666667,218,0,-1,223,248,-25
BR1_2731241528,4,False,0,0,0,15056,145,56,6.0,True,12,True,0,0,0,18941,229,40,6.4,False,27.103,-3885,-8,0,201,269,-68
BR1_2730247950,5,False,0,1,0,15912,182,59,6.8,False,9,True,0,0,0,18670,238,48,7.2,True,28.430033333333334,-2758,-4,0,241,286,-45
BR1_2728264220,6,True,0,0,0,17493,230,52,7.2,False,5,False,1,0,0,16983,211,76,7.2,True,29.404916666666665,510,1,-1,282,287,-5
BR1_2731451113,6,False,0,0,0,17000,203,56,7.4,False,8,True,0,0,0,17830,217,64,7.6,True,28.282733333333333,-830,-2,0,259,281,-22
BR1_2730641907,2,False,0,0,0,15628,224,59,7.2,False,7,True,1,0,0,17556,235,72,7.6,True,28.69305,-1928,-5,-1,283,307,-24
BR1_2730744732,8,False,0,0,0,17203,198,32,6.6,False,7,True,0,0,0,17390,198,47,7.2,True,28.183566666666668,-187,1,0,230,245,-15
BR1_2731218654,7,True,1,0,0,18356,229,60,7.4,True,3,False,0,0,0,16093,225,71,7.0,False,29.15715,2263,4,1,289,296,-7
BR1_2721948633,10,True,0,0,0,18405,185,51,6.8,False,16,False,1,1,0,20223,177,44,7.0,True,25.9977,-1818,-6,-1,236,221,15
BR1_2730288786,7,True,0,0,0,16195,220,56,7.0,False,7,False,0,1,0,17299,222,60,7.2,True,25.018766666666668,-1104,0,0,276,282,-6
BR1_2730134144,5,False,0,1,0,17536,237,60,7.6,True,3,True,1,0,0,15522,222,56,7.0,False,28.5571,2014,2,-1,297,278,19
BR1_2729142511,5,False,1,0,0,16246,209,51,6.8,False,6,True,0,1,0,19386,269,60,7.0,True,28.6118,-3140,-1,1,260,329,-69
BR1_2727264522,12,True,1,0,0,20329,196,56,7.0,True,11,False,0,0,0,19815,216,60,7.6,False,27.88365,514,1,1,252,276,-24
BR1_2705789142,5,False,0,0,0,13933,110,53,6.0,False,15,True,1,0,0,20440,195,48,7.0,True,26.137983333333334,-6507,-10,-1,163,243,-80
BR1_2705756404,10,False,0,0,0,18081,169,36,6.4,False,12,True,0,0,0,19106,210,48,7.0,True,25.219616666666667,-1025,-2,0,205,258,-53
BR1_2725462455,6,True,0,1,0,16928,190,60,6.8,True,3,False,0,0,0,13938,170,48,6.4,False,26.2086,2990,3,0,250,218,32
BR1_2725025329,3,False,0,0,0,16275,191,52,6.6,False,6,True,0,1,0,17196,221,56,6.8,True,29.403733333333335,-921,-3,0,243,277,-34
BR1_2720060860,5,False,0,0,0,14815,149,48,6.4,False,9,True,0,0,0,18308,196,56,7.2,True,27.45445,-3493,-4,0,197,252,-55
BR1_2730342089,4,True,0,0,0,15168,205,48,6.6,True,1,False,1,0,0,13471,216,48,6.6,False,25.8407,1697,3,-1,253,264,-11
BR1_2730249264,5,False,0,0,0,14700,172,56,6.2,False,12,True,1,0,0,19704,224,66,7.4,True,25.039033333333332,-5004,-7,-1,228,290,-62
BR1_2730116471,4,False,0,0,0,15507,207,54,7.2,False,8,True,1,1,0,19209,251,52,7.4,True,29.280516666666667,-3702,-4,-1,261,303,-42
BR1_2686873378,4,True,1,1,0,14694,155,56,6.2,False,4,False,0,0,0,15649,228,60,7.0,True,26.89665,-955,0,1,211,288,-77
BR1_2718806047,9,True,1,1,0,17966,216,56,7.0,True,9,False,0,0,0,18456,193,64,7.2,False,27.531416666666665,-490,0,1,272,257,15
BR1_2724342364,6,True,1,1,0,17152,196,44,7.2,False,16,False,0,0,0,22792,240,72,7.8,True,29.5256,-5640,-10,1,240,312,-72
BR1_2718418256,5,False,0,0,0,17213,214,66,7.2,False,5,True,1,0,0,17748,248,50,7.6,True,28.392933333333332,-535,0,-1,280,298,-18
BR1_2715205248,6,False,1,0,0,18043,242,64,7.4,True,4,True,0,1,0,15669,182,60,6.8,False,28.649866666666668,2374,2,1,306,242,64
BR1_2731281118,8,False,0,0,0,16090,178,40,6.8,True,5,True,1,0,0,15075,182,52,6.6,False,26.686933333333332,1015,3,-1,218,234,-16
BR1_2731256163,9,True,1,0,0,18114,212,64,7.8,True,7,False,0,0,0,16136,182,48,7.0,False,29.0542,1978,2,1,276,230,46
BR1_2731225962,10,False,1,0,0,18357,197,47,7.2,False,10,True,0,1,0,18793,197,60,7.2,True,28.248333333333335,-436,0,1,244,257,-13
BR1_2730820758,10,False,0,0,0,18180,189,52,7.2,False,7,True,1,0,0,17134,186,52,6.6,True,28.5722,1046,3,-1,241,238,3
BR1_2727591710,3,False,0,0,0,15026,210,56,7.2,False,8,True,0,0,0,17608,223,64,7.4,True,26.329716666666666,-2582,-5,0,266,287,-21
BR1_2731670388,13,False,1,0,0,20130,205,52,7.2,True,5,True,0,0,0,17476,220,48,6.8,False,29.9615,2654,8,1,257,268,-11
BR1_2731564360,9,True,1,0,0,19317,261,64,7.8,True,4,False,0,0,0,17181,240,60,7.2,False,28.03355,2136,5,1,325,300,25
BR1_2731548536,11,True,1,0,0,20519,210,48,7.4,True,10,False,0,1,0,18943,177,52,7.2,False,27.6815,1576,1,1,258,229,29
BR1_2722352504,5,False,1,0,0,17158,188,56,7.4,False,14,True,0,1,0,21575,206,48,7.2,True,28.088416666666667,-4417,-9,1,244,254,-10
BR1_2730852178,12,True,0,0,0,19206,183,48,7.8,True,9,False,1,0,0,17789,204,56,7.6,False,28.97855,1417,3,-1,231,260,-29
BR1_2728539281,11,False,0,1,0,20003,201,59,7.4,True,6,True,1,0,0,17847,227,60,7.0,False,27.931916666666666,2156,5,-1,260,287,-27
BR1_2691547309,9,True,1,0,0,17970,238,48,7.2,False,11,False,0,1,0,19741,206,52,7.4,True,29.2718,-1771,-2,1,286,258,28
BR1_2691508176,9,True,1,0,0,16508,186,60,6.8,True,3,False,0,0,0,14430,180,48,6.8,False,25.9049,2078,6,1,246,228,18
BR1_2691488303,9,False,1,0,0,17936,203,59,6.6,True,4,True,0,0,0,14208,169,52,6.4,False,26.633883333333333,3728,5,1,262,221,41
BR1_2730343986,11,True,1,0,0,19730,187,56,6.6,False,9,False,0,1,0,19618,223,44,7.0,True,29.949833333333334,112,2,1,243,267,-24
BR1_2729789097,7,False,1,1,0,17579,191,68,7.4,False,8,True,0,0,0,19427,272,48,7.4,True,28.785166666666665,-1848,-1,1,259,320,-61
BR1_2729743049,16,True,1,0,0,21569,220,56,7.6,True,11,False,0,1,0,19063,229,36,7.2,False,29.6613,2506,5,1,276,265,11
BR1_2731716733,7,False,1,0,0,15483,204,44,7.0,True,3,True,0,1,0,15066,213,44,6.8,False,25.645966666666666,417,4,1,248,257,-9
BR1_2731652304,7,False,0,0,0,16105,163,52,6.4,False,10,True,1,0,0,17864,200,52,6.6,True,25.1304,-1759,-3,-1,215,252,-37
BR1_2730305486,5,False,1,0,0,15035,194,45,6.8,False,4,True,0,1,0,15999,201,54,7.0,True,25.897633333333335,-964,1,1,239,255,-16
BR1_2726008270,5,False,1,1,0,17669,228,69,7.2,True,7,True,0,0,0,17327,233,32,7.4,False,29.463633333333334,342,-2,1,297,265,32
BR1_2720875326,3,False,1,1,0,16270,204,68,7.4,False,6,True,0,0,0,17286,219,48,7.4,True,28.26265,-1016,-3,1,272,267,5
BR1_2720327726,11,False,0,0,0,16803,143,44,6.4,False,12,True,1,0,0,18280,192,44,7.0,True,26.910133333333334,-1477,-1,-1,187,236,-49
BR1_2725950700,9,True,0,0,0,20074,272,60,7.8,False,8,False,1,1,0,18854,219,48,7.4,True,28.2773,1220,1,-1,332,267,65
BR1_2712560492,11,True,0,0,0,19027,217,52,7.4,False,6,False,0,0,0,16942,198,60,7.2,True,29.225183333333334,2085,5,0,269,258,11
BR1_2686693152,5,False,0,0,0,14788,169,56,6.6,False,6,True,1,0,0,16019,208,44,6.6,True,25.009266666666665,-1231,-1,-1,225,252,-27
BR1_2727547324,4,False,0,0,0,15410,193,40,7.2,True,3,True,0,0,0,16067,222,44,7.2,False,28.605483333333332,-657,1,0,233,266,-33
BR1_2731735659,3,False,0,0,0,13367,140,28,6.0,False,5,True,0,0,0,15163,182,48,6.6,True,25.912533333333332,-1796,-2,0,168,230,-62
BR1_2731772862,10,False,0,0,0,17657,153,44,6.4,False,12,True,0,0,0,18049,189,40,6.6,True,25.1745,-392,-2,0,197,229,-32
BR1_2731353119,7,True,0,0,0,16898,216,50,6.6,False,5,False,1,1,0,15554,173,60,6.8,True,25.6572,1344,2,-1,266,233,33
BR1_2708005592,6,True,0,0,0,18319,258,56,7.6,False,4,False,1,0,0,16295,229,60,7.2,True,27.756983333333334,2024,2,-1,314,289,25
BR1_2730590709,11,True,1,0,0,18610,222,52,7.2,True,3,False,0,0,0,15788,207,60,6.8,False,26.515383333333332,2822,8,1,274,267,7
BR1_2729634418,1,False,0,0,0,14571,198,64,7.2,False,4,True,1,1,0,16724,247,56,7.2,True,29.130966666666666,-2153,-3,-1,262,303,-41
BR1_2721638554,9,True,0,0,0,18922,209,56,7.2,False,14,False,1,0,0,20865,228,40,7.4,True,27.89825,-1943,-5,-1,265,268,-3
BR1_2729861454,5,False,0,0,0,17760,194,48,7.0,False,12,True,1,1,0,20100,227,56,7.2,True,29.39015,-2340,-7,-1,242,283,-41
BR1_2731196089,9,True,0,0,0,17943,209,45,7.0,True,6,False,0,0,0,15715,161,47,6.8,False,28.5619,2228,3,0,254,208,46
BR1_2731111065,3,True,0,0,0,14601,171,44,6.4,False,11,False,0,0,0,17550,189,48,6.8,True,25.13645,-2949,-8,0,215,237,-22
BR1_2730555385,11,True,1,1,0,18418,162,62,7.0,True,5,False,0,0,0,15568,208,54,6.8,False,25.7953,2850,6,1,224,262,-38
BR1_2730537790,10,False,0,1,0,18242,202,54,7.6,True,5,True,0,0,0,16814,207,68,7.2,False,29.368,1428,5,0,256,275,-19
BR1_2727227524,10,True,0,1,0,18143,201,48,6.8,True,7,False,1,0,0,15850,153,48,6.6,False,26.5936,2293,3,-1,249,201,48
BR1_2731744776,8,True,1,0,0,16862,195,52,7.2,False,4,False,0,0,0,16579,228,44,7.4,True,28.264766666666667,283,4,1,247,272,-25
BR1_2730719601,7,False,0,0,0,15062,164,52,6.6,False,10,True,1,1,0,17738,178,56,7.0,True,25.12905,-2676,-3,-1,216,234,-18
BR1_2730399113,6,True,1,1,0,16766,235,48,7.0,True,2,False,0,0,0,14165,178,72,6.8,False,25.427933333333332,2601,4,1,283,250,33
BR1_2727255064,8,True,1,0,0,18907,218,57,7.2,True,6,False,0,0,0,17431,225,70,7.2,False,29.197983333333333,1476,2,1,275,295,-20
BR1_2731617188,7,False,0,0,0,15712,175,32,6.4,False,7,True,0,0,0,15628,178,48,6.4,True,26.1476,84,0,0,207,226,-19
BR1_2731575128,4,True,0,0,0,15902,198,46,6.8,True,6,False,0,0,0,15859,172,49,6.6,False,27.028283333333334,43,-2,0,244,221,23
BR1_2716055559,10,True,0,0,0,16599,191,48,6.8,False,5,False,1,0,0,16616,190,68,6.8,True,25.693616666666667,-17,5,-1,239,258,-19
BR1_2714710424,14,True,0,0,0,17337,179,32,6.6,True,6,False,0,0,0,15238,156,49,6.2,False,25.0387,2099,8,0,211,205,6
BR1_2686966971,10,False,1,0,0,18915,216,56,7.8,False,4,True,0,0,0,15993,201,60,6.8,True,29.945433333333334,2922,6,1,272,261,11
BR1_2686942719,9,False,0,0,0,16529,178,48,7.0,True,11,True,0,0,0,16884,183,40,6.8,False,25.61745,-355,-2,0,226,223,3
BR1_2724296696,8,False,1,0,0,19045,245,71,7.6,True,5,True,0,0,0,16429,201,56,7.4,False,29.256133333333334,2616,3,1,316,257,59
BR1_2727900250,13,True,0,0,0,20573,204,48,7.0,True,6,False,1,0,0,16665,156,54,7.0,False,29.808333333333334,3908,7,-1,252,210,42
BR1_2727876506,7,False,0,0,0,15562,201,52,6.8,False,11,True,0,0,0,17681,199,60,7.2,True,26.14335,-2119,-4,0,253,259,-6
BR1_2730168362,5,False,0,0,0,14974,186,43,6.8,False,8,True,1,0,0,16869,214,40,6.6,True,27.213283333333333,-1895,-3,-1,229,254,-25
BR1_2729865995,5,False,1,0,0,15377,204,56,6.8,True,5,True,0,0,0,15291,218,52,6.6,False,25.67725,86,0,1,260,270,-10
BR1_2729967124,10,True,1,0,0,17178,158,40,6.4,True,10,False,0,0,0,16474,172,36,6.4,False,27.282983333333334,704,0,1,198,208,-10
BR1_2708644544,11,False,1,0,0,19323,242,50,7.6,True,5,True,0,1,0,18357,212,80,7.6,False,28.132283333333334,966,6,1,292,292,0
BR1_2731723301,14,True,0,0,0,19278,224,48,7.0,True,5,False,0,0,0,14106,139,38,6.4,False,26.750533333333333,5172,9,0,272,177,95
BR1_2729442135,9,True,1,0,0,18208,219,64,7.4,False,9,False,0,0,0,19143,189,56,7.2,True,29.64495,-935,0,1,283,245,38
BR1_2722435467,5,False,1,0,0,16136,197,48,6.8,False,6,True,0,1,0,16893,215,47,7.0,True,25.652166666666666,-757,-1,1,245,262,-17
BR1_2722110934,7,False,0,0,0,15711,176,52,6.8,True,9,True,1,0,0,18612,186,60,6.6,False,27.00525,-2901,-2,-1,228,246,-18
BR1_2730861143,11,True,1,0,0,19806,197,76,7.4,True,5,False,0,0,0,16478,189,68,7.2,False,27.979783333333334,3328,6,1,273,257,16
BR1_2702403175,4,False,1,0,0,16882,237,47,7.6,True,3,True,0,0,0,17168,231,68,7.2,False,27.67285,-286,1,1,284,299,-15
BR1_2685750484,4,False,0,0,0,15506,182,48,7.0,False,11,True,1,0,0,19656,238,58,7.8,True,27.5027,-4150,-7,-1,230,296,-66
BR1_2731525160,3,False,0,1,0,15003,190,43,7.0,False,3,True,1,0,0,14769,209,67,7.0,True,25.68205,234,0,-1,233,276,-43
BR1_2730373831,20,True,1,1,0,24058,200,64,7.8,False,8,False,0,0,0,17560,200,44,6.8,True,27.66825,6498,12,1,264,244,20
BR1_2729558620,12,True,0,1,1,22754,240,60,7.4,True,12,False,1,0,0,19597,206,51,6.8,False,28.062866666666668,3157,0,-1,300,257,43
BR1_2731664706,9,False,1,0,0,16685,205,40,6.8,True,7,True,0,1,0,16713,192,68,7.0,False,25.195633333333333,-28,2,1,245,260,-15
BR1_2730937674,4,False,0,0,0,15871,198,52,7.0,False,11,True,1,1,0,18728,183,64,7.2,True,29.098433333333332,-2857,-7,-1,250,247,3
BR1_2729916919,9,True,1,0,0,17997,179,52,6.8,True,10,False,0,0,0,17737,207,43,6.6,False,26.740733333333335,260,-1,1,231,250,-19
BR1_2731465937,12,True,1,1,1,21017,199,64,7.2,True,9,False,0,0,0,18953,212,64,7.4,False,28.7865,2064,3,1,263,276,-13
BR1_2731462240,12,True,0,0,0,18212,172,52,6.6,True,12,False,1,0,0,18137,180,48,7.0,False,25.0448,75,0,-1,224,228,-4
BR1_2731094025,4,False,0,1,0,15042,157,44,6.8,False,6,True,1,0,0,18908,225,60,7.2,True,27.682566666666666,-3866,-2,-1,201,285,-84
BR1_2731067041,5,False,1,1,0,16232,212,40,7.0,True,5,True,0,0,0,16575,226,52,6.8,False,28.370583333333332,-343,0,1,252,278,-26
BR1_2727386757,9,True,1,0,0,17603,182,64,7.0,True,2,False,0,1,0,13998,193,56,6.2,False,25.247166666666665,3605,7,1,246,249,-3
BR1_2731756150,5,True,0,0,0,15611,202,44,6.8,False,6,False,0,0,0,15617,208,52,6.6,True,25.000133333333334,-6,-1,0,246,260,-14
BR1_2731197800,5,False,1,0,0,16986,196,67,7.4,True,5,True,0,1,0,17620,235,48,7.4,False,29.333916666666667,-634,0,1,263,283,-20
BR1_2706701777,7,False,0,0,0,16792,188,60,6.8,True,6,True,0,0,0,16768,190,64,7.4,False,27.565616666666667,24,1,0,248,254,-6
BR1_2730270360,3,False,0,0,0,15190,146,67,6.6,False,17,True,1,0,0,21590,215,62,7.8,True,28.20635,-6400,-14,-1,213,277,-64
BR1_2731503236,7,True,1,0,0,16592,219,76,7.2,True,7,False,0,0,0,15802,172,40,7.2,False,26.643183333333333,790,0,1,295,212,83
BR1_2730864039,9,True,1,0,0,18726,214,52,7.0,True,9,False,0,1,0,18294,185,68,7.2,False,29.589616666666668,432,0,1,266,253,13
BR1_2730854081,8,False,0,0,0,16624,190,60,7.0,False,10,True,0,0,0,17715,190,64,6.6,True,25.784333333333333,-1091,-2,0,250,254,-4
BR1_2722978706,9,True,0,0,0,17430,186,44,6.6,False,7,False,0,0,0,15745,164,44,6.4,True,26.546366666666668,1685,2,0,230,208,22
BR1_2721655131,13,True,0,0,0,20850,240,48,7.4,True,4,False,1,0,0,15937,211,60,6.8,False,28.025016666666666,4913,9,-1,288,271,17
BR1_2731705300,9,True,0,1,0,18954,243,52,7.6,True,8,False,1,0,0,17363,210,52,7.2,False,29.9666,1591,1,-1,295,262,33
BR1_2731686046,2,False,0,0,0,14309,199,50,6.8,False,13,True,0,0,1,19806,202,46,7.4,True,29.173616666666668,-5497,-11,0,249,248,1
BR1_2731321888,7,True,1,0,0,15642,151,40,6.2,False,10,False,0,1,1,19894,217,71,7.0,True,25.868733333333335,-4252,-3,1,191,288,-97
BR1_2731001904,6,False,0,0,0,14005,150,44,6.0,False,11,True,1,1,0,18550,227,51,7.0,True,25.1956,-4545,-5,-1,194,278,-84
BR1_2726289777,11,True,1,0,0,19475,211,52,7.4,True,6,False,0,0,0,15366,186,44,7.0,False,28.960216666666668,4109,5,1,263,230,33
BR1_2731774899,9,True,1,0,0,16483,173,56,7.0,True,4,False,0,0,0,13846,140,52,6.6,False,25.621316666666665,2637,5,1,229,192,37
BR1_2731758047,6,True,0,0,0,14387,174,36,6.8,False,6,False,1,0,0,16972,201,68,7.2,True,25.676683333333333,-2585,0,-1,210,269,-59
BR1_2731148202,7,False,1,0,0,15517,165,44,6.6,False,12,True,0,1,0,16992,150,40,6.4,True,26.720483333333334,-1475,-5,1,209,190,19
BR1_2731119960,8,True,0,0,0,19110,236,41,7.4,True,6,False,1,0,0,16653,204,54,7.0,False,28.4494,2457,2,-1,277,258,19
BR1_2729799167,9,False,0,0,0,17500,161,44,6.6,False,8,True,1,1,0,18796,230,56,7.2,True,29.0437,-1296,1,-1,205,286,-81
BR1_2712373395,4,False,0,0,0,15937,228,56,7.6,True,4,True,1,0,0,16120,224,44,7.4,False,28.726916666666668,-183,0,-1,284,268,16
BR1_2710131435,4,False,1,0,0,14632,168,43,6.4,True,7,True,0,1,0,15761,174,51,7.0,False,27.4059,-1129,-3,1,211,225,-14
BR1_2729350450,5,False,0,0,0,15599,173,56,6.6,False,6,True,1,1,1,20124,251,60,7.6,True,29.909333333333333,-4525,-1,-1,229,311,-82
BR1_2726637249,5,True,0,0,0,17621,214,56,7.2,True,5,False,1,1,0,15736,168,52,6.8,False,29.18065,1885,0,-1,270,220,50
BR1_2731224814,8,False,0,0,0,16982,209,60,7.0,False,9,True,0,1,0,16477,170,44,6.8,True,25.197666666666667,505,-1,0,269,214,55
BR1_2731441258,5,False,0,0,0,14987,177,48,6.8,False,8,True,1,0,0,17535,202,56,6.8,True,27.11788333333333,-2548,-3,-1,225,258,-33
BR1_2730307826,4,False,0,0,0,16987,198,61,7.2,False,7,True,0,0,0,18796,252,50,7.2,True,28.20928333333333,-1809,-3,0,259,302,-43
BR1_2730530965,6,False,1,1,0,17043,205,68,7.4,False,5,True,0,0,0,18070,242,52,7.8,True,29.391733333333335,-1027,1,1,273,294,-21
BR1_2731624301,9,True,0,0,0,18124,198,56,7.0,False,13,False,1,1,0,20708,191,50,7.2,True,28.879,-2584,-4,-1,254,241,13
BR1_2690480336,8,True,0,0,0,16726,188,54,6.8,True,4,False,1,0,0,14423,167,48,6.4,False,25.963483333333333,2303,4,-1,242,215,27
BR1_2690456193,7,False,1,0,0,16352,174,64,7.2,True,5,True,0,0,0,15246,202,48,6.4,False,26.1385,1106,2,1,238,250,-12
BR1_2726136837,7,False,1,0,0,17804,220,64,7.4,False,9,True,0,1,1,20838,243,60,7.4,True,28.314433333333334,-3034,-2,1,284,303,-19
BR1_2726042682,10,False,0,0,0,18026,177,56,7.4,True,11,True,0,0,0,20034,211,60,7.4,False,27.74265,-2008,-1,0,233,271,-38
BR1_2726029146,8,True,0,1,0,16850,202,56,7.0,False,10,False,1,0,0,18513,185,44,6.6,True,27.0731,-1663,-2,-1,258,229,29
BR1_2700119299,6,False,0,0,0,15228,176,54,6.6,False,5,True,1,1,0,16416,194,60,7.0,True,26.867333333333335,-1188,1,-1,230,254,-24
BR1_2731372176,9,True,0,1,0,18702,221,48,7.2,True,6,False,1,0,0,17073,201,66,7.2,False,28.565916666666666,1629,3,-1,269,267,2
BR1_2721641703,8,True,0,0,0,18092,254,40,7.2,False,3,False,0,0,0,16042,235,55,7.2,True,27.6466,2050,5,0,294,290,4
BR1_2721579584,8,False,0,0,0,17051,167,47,7.0,False,8,True,1,0,0,17318,228,56,7.2,True,29.68455,-267,0,-1,214,284,-70
BR1_2729220908,6,True,0,0,0,16063,167,50,7.4,False,10,False,1,0,0,19848,241,61,7.4,True,27.827766666666665,-3785,-4,-1,217,302,-85
BR1_2729960171,3,True,1,0,0,16384,221,56,7.0,True,1,False,0,1,0,15943,219,64,7.2,False,27.7788,441,2,1,277,283,-6
BR1_2728633224,8,True,0,1,0,17745,221,54,7.2,True,3,False,0,0,0,13190,169,44,6.2,False,25.34485,4555,5,0,275,213,62
BR1_2728088469,4,True,0,1,0,16421,198,52,6.8,False,8,False,1,0,0,18381,217,72,7.4,True,28.826116666666667,-1960,-4,-1,250,289,-39
BR1_2731646286,7,False,1,0,0,17353,256,44,7.4,True,4,True,0,1,0,17027,247,64,7.4,False,27.992533333333334,326,3,1,300,311,-11
BR1_2731122807,12,False,0,0,0,17379,176,36,6.6,False,7,True,1,0,0,15650,175,56,6.6,True,27.230266666666665,1729,5,-1,212,231,-19
BR1_2681702098,12,False,0,0,0,18388,207,44,7.2,True,6,True,0,0,0,18217,215,40,7.2,False,28.13535,171,6,0,251,255,-4
BR1_2670874721,3,False,0,0,0,15486,208,52,7.0,False,12,True,0,1,0,19979,202,59,8.0,True,28.00355,-4493,-9,0,260,261,-1
BR1_2730845376,13,False,1,0,0,18811,202,36,7.2,True,6,True,0,0,0,15206,175,36,6.4,False,25.749616666666668,3605,7,1,238,211,27
BR1_2730368298,2,False,0,0,0,13353,178,40,6.8,False,6,True,1,1,0,16409,217,56,7.0,True,25.9516,-3056,-4,-1,218,273,-55
BR1_2725743284,6,False,0,0,0,16490,188,46,6.8,False,11,True,1,0,0,18549,200,52,7.0,True,29.378166666666665,-2059,-5,-1,234,252,-18
BR1_2710348450,5,True,0,0,0,15049,180,48,6.4,False,7,False,1,0,0,15877,200,52,6.8,True,26.1363,-828,-2,-1,228,252,-24
BR1_2731714481,6,False,1,1,0,17112,230,52,7.0,False,8,True,0,0,0,17501,194,50,7.0,True,29.200983333333333,-389,-2,1,282,244,38
BR1_2731316035,6,True,0,0,0,15327,181,40,6.6,False,7,False,0,0,0,15775,145,52,6.4,True,26.583183333333334,-448,-1,0,221,197,24
BR1_2699093825,6,True,1,0,0,15750,169,72,6.6,True,4,False,0,0,0,15403,188,44,6.8,False,27.111,347,2,1,241,232,9
BR1_2699071372,4,True,0,0,0,14613,206,39,6.8,False,9,False,1,1,0,17657,203,68,7.4,True,25.412016666666666,-3044,-5,-1,245,271,-26
BR1_2698924941,8,False,0,1,0,19411,237,64,7.6,True,6,True,1,0,0,16405,190,60,7.2,False,27.614983333333335,3006,2,-1,301,250,51
BR1_2703625777,5,False,0,0,0,14324,176,48,6.8,False,8,True,0,0,0,17244,186,51,6.6,True,27.247316666666666,-2920,-3,0,224,237,-13
BR1_2731508827,9,True,0,0,0,18097,197,68,7.0,True,3,False,0,0,0,14322,178,39,6.8,False,27.96935,3775,6,0,265,217,48
BR1_2730479285,7,False,0,0,0,18199,226,42,7.2,False,6,True,1,1,0,17341,186,65,7.0,True,27.991333333333333,858,1,-1,268,251,17
BR1_2730140017,6,True,0,0,0,17963,230,68,7.2,False,12,False,1,1,0,20695,226,48,7.4,True,28.1849,-2732,-6,-1,298,274,24
BR1_2729679898,8,False,0,0,0,19038,221,52,7.2,False,8,True,1,0,0,19684,227,60,7.0,True,27.802583333333335,-646,0,-1,273,287,-14
BR1_2731198316,3,True,1,0,0,16585,232,56,6.6,True,5,False,0,1,1,17310,208,60,7.0,False,29.051433333333332,-725,-2,1,288,268,20
BR1_2730100721,7,True,0,0,0,17151,180,56,7.0,False,5,False,1,1,0,17985,257,52,7.2,True,28.28173333333333,-834,2,-1,236,309,-73
BR1_2731709093,5,False,1,0,0,16886,229,50,7.4,False,8,True,0,1,0,18757,219,64,7.8,True,29.99315,-1871,-3,1,279,283,-4
BR1_2718649434,11,True,1,0,0,19695,254,60,7.8,True,5,False,0,0,0,16517,213,43,7.0,False,28.31475,3178,6,1,314,256,58
BR1_2718168399,10,False,1,0,0,19988,216,56,7.4,True,7,True,0,1,0,17219,211,48,7.0,False,29.37425,2769,3,1,272,259,13
BR1_2731747824,1,False,0,1,0,13616,207,52,6.6,False,9,True,1,0,0,17557,204,53,7.0,True,26.8151,-3941,-8,-1,259,257,2
BR1_2731719554,4,False,1,0,0,15328,199,58,6.6,False,8,True,0,0,0,16445,156,56,6.8,True,27.31495,-1117,-4,1,257,212,45
BR1_2731171472,10,True,0,0,0,16690,156,20,5.8,False,12,False,0,1,0,18967,199,56,6.8,True,28.14966666666667,-2277,-2,0,176,255,-79
BR1_2731144601,10,False,0,1,0,19735,217,52,7.2,False,9,True,0,0,0,18857,225,52,7.4,True,28.148683333333334,878,1,0,269,277,-8
BR1_2698672770,12,True,0,0,0,19027,199,48,7.2,False,10,False,1,1,0,20781,246,76,7.4,True,29.046533333333333,-1754,2,-1,247,322,-75
BR1_2698608763,11,True,0,0,0,18989,196,52,7.4,True,5,False,1,0,0,15860,201,51,7.0,False,29.263783333333333,3129,6,-1,248,252,-4
BR1_2728906391,4,False,0,1,0,17052,226,75,7.2,True,5,True,1,0,0,16733,238,44,7.6,False,29.075016666666667,319,-1,-1,301,282,19
BR1_2731610641,10,True,1,1,0,17755,212,64,7.0,True,3,False,0,0,0,13149,148,48,6.4,False,27.3829,4606,7,1,276,196,80
BR1_2731197223,5,True,1,1,0,17070,217,62,7.4,True,1,False,0,0,0,14173,192,56,7.2,False,28.585983333333335,2897,4,1,279,248,31
BR1_2707643472,8,True,0,0,0,18404,219,68,7.6,True,5,False,1,0,0,16980,231,68,7.4,False,27.836866666666666,1424,3,-1,287,299,-12
BR1_2717463006,9,False,1,0,0,16816,190,52,6.8,True,10,True,0,0,0,17066,150,56,7.0,False,27.441583333333334,-250,-1,1,242,206,36
BR1_2713848747,4,False,0,0,0,15271,196,56,7.2,False,4,True,1,1,0,15212,211,60,6.8,True,25.86125,59,0,-1,252,271,-19
BR1_2731695697,10,True,0,0,0,19004,250,62,7.4,True,5,False,0,0,0,16369,206,44,7.0,False,29.557883333333333,2635,5,0,312,250,62
BR1_2731673525,12,False,1,0,0,18707,180,52,6.8,False,10,True,0,0,0,17898,169,48,6.2,True,26.52995,809,2,1,232,217,15
BR1_2731576286,4,False,0,1,0,15156,182,52,6.8,False,9,True,0,0,0,17064,195,48,6.8,True,25.492116666666668,-1908,-5,0,234,243,-9
BR1_2715592733,10,True,1,0,0,17547,176,52,6.8,False,5,False,0,0,0,16299,204,59,6.6,True,26.701466666666665,1248,5,1,228,263,-35
BR1_2729650166,7,False,0,0,0,16292,200,44,6.6,True,13,True,0,0,0,18266,171,44,6.2,False,26.579233333333335,-1974,-6,0,244,215,29
BR1_2723443633,8,True,0,0,0,16783,185,48,7.0,False,10,False,1,0,0,17585,184,44,7.2,True,25.059866666666668,-802,-2,-1,233,228,5
BR1_2731742215,5,False,0,0,0,15876,214,40,6.8,False,8,True,1,0,0,18001,218,68,7.0,True,27.6917,-2125,-3,-1,254,286,-32
BR1_2721302137,8,False,1,0,0,18470,242,52,7.4,False,10,True,0,1,0,19195,211,56,7.2,True,29.081233333333333,-725,-2,1,294,267,27
BR1_2728188703,8,True,1,0,0,18456,195,64,7.2,True,9,False,0,1,0,17048,193,44,7.4,False,28.0752,1408,-1,1,259,237,22
BR1_2701152544,8,False,0,1,0,16868,182,56,7.2,True,7,True,1,0,0,14127,144,40,6.4,False,26.401233333333334,2741,1,-1,238,184,54
BR1_2731148241,6,True,0,1,1,20119,237,54,7.4,True,6,False,0,0,0,16834,201,45,6.8,False,28.95916666666667,3285,0,0,291,246,45
BR1_2726316753,9,True,0,1,0,16338,180,63,6.6,True,4,False,0,0,0,14370,154,49,6.6,False,26.76935,1968,5,0,243,203,40
BR1_2726284817,6,False,0,0,0,14951,163,48,6.4,False,12,True,1,1,0,19360,198,52,6.8,True,25.4174,-4409,-6,-1,211,250,-39
BR1_2723519832,9,True,0,0,0,18257,208,36,7.4,True,4,False,1,1,0,16101,203,68,7.2,False,28.053416666666667,2156,5,-1,244,271,-27
BR1_2708162680,11,True,1,0,0,19496,193,56,7.6,True,7,False,0,0,0,16948,180,52,7.0,False,27.680616666666666,2548,4,1,249,232,17
BR1_2708139017,5,False,1,0,0,17145,230,48,7.2,False,4,True,0,1,1,18372,254,60,7.4,True,28.8136,-1227,1,1,278,314,-36
BR1_2731660448,5,False,1,0,0,14332,178,44,6.6,False,5,True,0,1,0,16461,233,48,6.8,True,26.89303333333333,-2129,0,1,222,281,-59
BR1_2731608256,4,False,0,1,0,17412,231,80,7.6,False,6,True,1,0,0,16729,221,48,7.2,True,29.51655,683,-2,-1,311,269,42
BR1_2729091349,8,True,1,0,0,16308,189,40,6.6,True,3,False,0,0,0,14801,190,52,6.6,False,26.15875,1507,5,1,229,242,-13
BR1_2719395076,1,True,1,0,0,13459,176,52,6.2,True,4,False,0,0,0,15171,195,72,6.8,False,25.898483333333335,-1712,-3,1,228,267,-39
BR1_2701179506,8,False,1,0,0,16921,193,59,6.4,True,12,True,0,0,0,18184,191,52,6.8,False,26.265333333333334,-1263,-4,1,252,243,9
BR1_2700099049,11,True,0,1,0,19474,201,56,7.0,True,6,False,1,0,0,15325,180,48,6.6,False,26.987066666666667,4149,5,-1,257,228,29
BR1_2717738954,13,True,0,0,0,18077,191,63,6.8,True,6,False,0,0,0,15442,168,44,6.4,False,25.682833333333335,2635,7,0,254,212,42
BR1_2663631859,10,False,1,0,0,18149,193,52,7.0,True,1,True,0,0,0,13201,150,56,6.4,False,25.799183333333332,4948,9,1,245,206,39
BR1_2722923259,5,False,0,1,0,14596,160,40,6.6,False,7,True,0,0,0,17031,221,52,6.8,True,26.05455,-2435,-2,0,200,273,-73
BR1_2721122396,9,True,1,0,0,16652,189,52,6.8,True,0,False,0,1,0,13029,174,56,6.6,False,26.5356,3623,9,1,241,230,11
BR1_2730648426,4,True,0,0,0,16430,213,60,7.4,True,7,False,1,0,0,17423,190,56,7.2,False,28.9932,-993,-3,-1,273,246,27
BR1_2728565427,9,True,1,0,0,18534,193,60,7.4,True,10,False,0,1,0,18155,188,60,7.2,False,29.4913,379,-1,1,253,248,5
BR1_2727944891,4,True,1,1,0,16092,179,50,7.0,False,7,False,0,0,0,18325,221,62,7.4,True,28.41765,-2233,-3,1,229,283,-54
BR1_2727927218,4,True,0,0,0,14656,195,48,7.2,False,13,False,1,1,0,18687,197,48,7.2,True,27.2976,-4031,-9,-1,243,245,-2
BR1_2730784238,8,True,1,0,1,19254,241,52,7.2,False,7,False,0,0,0,18355,211,62,7.4,True,29.727866666666667,899,1,1,293,273,20
BR1_2717189567,8,True,1,0,0,18775,223,63,7.6,False,9,False,0,0,0,18273,220,64,7.4,True,27.811783333333334,502,-1,1,286,284,2
BR1_2729715975,14,True,1,0,0,19161,200,48,7.4,True,6,False,0,0,0,18031,217,56,7.4,False,27.500516666666666,1130,8,1,248,273,-25
BR1_2728812795,6,True,1,0,0,15717,171,48,6.6,False,9,False,0,0,0,16384,199,40,6.4,True,26.876116666666668,-667,-3,1,219,239,-20
BR1_2731850395,8,False,1,1,0,18307,200,52,7.0,True,11,True,0,0,0,16180,145,44,6.6,False,26.743766666666666,2127,-3,1,252,189,63
BR1_2692976852,7,True,0,0,0,18269,233,60,7.2,True,9,False,1,1,0,18993,211,52,7.0,False,28.632233333333332,-724,-2,-1,293,263,30
BR1_2731660280,12,False,1,1,0,18886,194,51,7.2,True,6,True,0,0,0,15704,157,48,6.4,False,25.08405,3182,6,1,245,205,40
BR1_2727993583,8,False,0,0,0,17447,181,48,6.6,True,10,True,1,0,0,17215,193,60,7.0,False,26.598183333333335,232,-2,-1,229,253,-24
BR1_2675538285,4,False,1,0,0,16703,253,48,6.8,False,8,True,0,1,0,19638,228,64,7.4,True,27.921316666666666,-2935,-4,1,301,292,9
BR1_2723070322,14,True,1,0,0,21095,216,68,7.4,True,7,False,0,0,0,17400,204,48,6.8,False,29.33315,3695,7,1,284,252,32
BR1_2723040796,4,False,0,0,0,14338,181,48,6.6,False,8,True,1,1,0,17291,206,52,7.0,True,26.47298333333333,-2953,-4,-1,229,258,-29
BR1_2723212186,4,True,1,1,0,17750,242,61,7.6,True,7,False,0,0,0,18750,270,54,7.6,False,29.445783333333335,-1000,-3,1,303,324,-21
BR1_2722488267,10,True,1,0,0,17250,178,56,6.4,True,13,False,0,0,0,17885,195,44,6.6,False,25.195966666666667,-635,-3,1,234,239,-5
BR1_2731709621,5,False,0,0,0,16416,201,51,6.6,False,5,True,1,1,0,16279,210,44,6.4,True,26.119333333333334,137,0,-1,252,254,-2
BR1_2731668320,4,False,0,1,0,15520,177,48,6.2,False,10,True,1,0,0,16930,183,44,6.4,True,27.06815,-1410,-6,-1,225,227,-2
BR1_2730339808,1,False,0,0,0,16244,263,68,8.0,False,2,True,1,0,0,15984,240,60,7.6,True,29.9209,260,-1,-1,331,300,31
BR1_2731802902,6,False,1,0,0,16894,208,69,7.4,True,7,True,0,0,0,19123,242,60,7.8,False,27.91045,-2229,-1,1,277,302,-25
BR1_2731786218,10,False,1,0,0,16610,166,40,6.6,True,9,True,0,1,0,17144,183,48,6.8,False,25.691716666666668,-534,1,1,206,231,-25
BR1_2730843211,8,True,0,0,0,17622,202,52,6.8,True,5,False,1,0,0,15028,187,48,6.4,False,25.560333333333332,2594,3,-1,254,235,19
BR1_2686278657,6,False,0,0,0,15855,198,45,6.8,False,14,True,1,0,0,19726,220,56,7.4,True,26.869233333333334,-3871,-8,-1,243,276,-33
BR1_2686199701,7,False,1,0,0,17680,230,64,7.6,True,2,True,0,1,0,15526,219,40,7.2,False,27.753316666666667,2154,5,1,294,259,35
BR1_2730702279,4,True,0,0,0,15409,217,40,6.6,False,9,False,1,0,0,18146,200,56,7.0,True,25.240166666666667,-2737,-5,-1,257,256,1
BR1_2727096482,6,True,0,0,0,16947,232,36,7.4,True,8,False,0,0,0,17157,169,52,7.2,False,27.59525,-210,-2,0,268,221,47
BR1_2729677246,6,False,0,0,0,17354,208,60,7.2,False,5,True,0,1,0,17357,223,52,7.2,True,28.821666666666665,-3,1,0,268,275,-7
BR1_2713564628,7,False,0,1,0,17636,230,56,7.6,False,8,True,1,0,0,18146,193,52,7.2,True,27.62761666666667,-510,-1,-1,286,245,41
BR1_2713489085,7,False,1,0,0,16599,211,44,6.8,True,5,True,0,0,0,15342,149,47,6.0,False,27.227016666666668,1257,2,1,255,196,59
BR1_2730257016,5,True,0,0,0,14812,171,60,6.8,False,4,False,1,1,0,15613,205,52,7.0,True,26.433783333333334,-801,1,-1,231,257,-26
BR1_2724022437,4,True,0,0,0,14927,143,48,6.8,False,6,False,1,0,0,17968,220,71,7.2,True,28.068366666666666,-3041,-2,-1,191,291,-100
BR1_2722870278,1,False,1,1,0,15562,205,68,7.2,False,7,True,0,0,0,16590,176,44,7.4,True,29.417316666666668,-1028,-6,1,273,220,53
BR1_2718473659,10,True,0,1,1,21761,240,56,7.4,True,4,False,1,0,0,16812,221,48,7.2,False,28.839133333333333,4949,6,-1,296,269,27
BR1_2731123564,14,True,0,0,0,20640,196,44,7.4,True,8,False,1,0,0,18959,203,72,7.0,False,28.61403333333333,1681,6,-1,240,275,-35
BR1_2719716628,6,True,0,0,0,15905,192,44,6.8,False,5,False,0,0,0,16195,187,60,6.8,True,25.99588333333333,-290,1,0,236,247,-11
BR1_2719591571,10,True,0,0,0,17164,207,48,6.8,True,4,False,0,1,0,15563,179,52,6.4,False,26.840583333333335,1601,6,0,255,231,24
BR1_2729875261,1,False,0,0,0,14541,200,51,7.0,False,9,True,1,0,0,19423,237,64,7.4,True,28.791333333333334,-4882,-8,-1,251,301,-50
BR1_2706905588,6,True,0,0,0,16000,171,60,6.6,True,7,False,0,0,0,15490,180,56,6.4,False,25.439883333333334,510,-1,0,231,236,-5
BR1_2706765936,9,False,0,0,0,17544,160,50,6.4,False,13,True,0,0,1,21490,233,63,7.4,True,27.560083333333335,-3946,-4,0,210,296,-86
BR1_2706753471,4,False,0,1,0,15755,217,56,6.6,True,6,True,0,0,0,16762,218,64,7.0,False,25.38605,-1007,-2,0,273,282,-9
BR1_2729374450,9,True,1,0,0,18071,233,60,7.0,True,7,False,0,0,0,15868,195,32,6.6,False,27.071483333333333,2203,2,1,293,227,66
BR1_2723091981,5,False,1,0,0,15893,184,57,6.8,True,7,True,0,0,0,15590,181,48,6.6,False,26.501333333333335,303,-2,1,241,229,12
BR1_2723037404,5,True,0,0,0,14526,174,48,6.6,False,7,False,1,0,0,16771,204,60,6.6,True,26.970366666666667,-2245,-2,-1,222,264,-42
BR1_2731409303,12,False,1,1,0,17839,167,44,6.4,False,11,True,0,0,0,18616,171,49,6.6,True,27.415483333333334,-777,1,1,211,220,-9
BR1_2726216505,8,True,0,1,1,18706,170,65,6.8,True,8,False,1,0,0,15671,167,40,6.8,False,25.67325,3035,0,-1,235,207,28
BR1_2731486331,11,False,0,0,0,17271,184,60,6.8,True,3,True,0,0,0,15239,196,56,7.0,False,25.20965,2032,8,0,244,252,-8
BR1_2731452823,7,False,1,0,0,17897,225,60,7.2,False,6,True,0,0,0,17454,175,48,7.2,True,28.0974,443,1,1,285,223,62
BR1_2726021359,12,False,1,0,0,19598,192,60,7.4,False,8,True,0,1,0,17250,197,56,6.8,True,29.036933333333334,2348,4,1,252,253,-1
BR1_2678886025,8,False,1,1,0,18094,218,83,7.8,True,4,True,0,0,0,16691,248,44,7.2,False,29.418916666666668,1403,4,1,301,292,9
BR1_2678853701,6,False,0,0,0,15258,199,56,7.0,False,10,True,1,0,0,18127,196,48,7.0,True,25.848033333333333,-2869,-4,-1,255,244,11
BR1_2678830422,6,False,1,0,0,17519,237,52,7.4,True,10,True,0,1,0,19503,218,56,7.8,False,28.822116666666666,-1984,-4,1,289,274,15
BR1_2678770048,9,False,0,0,0,18274,224,44,7.4,True,4,True,1,0,0,16383,222,60,7.2,False,28.736083333333333,1891,5,-1,268,282,-14
BR1_2730224763,3,True,1,0,0,16030,248,56,7.6,False,5,False,0,1,0,17041,241,60,7.6,True,29.54025,-1011,-2,1,304,301,3
BR1_2730098374,7,True,1,0,0,15959,181,52,6.8,True,4,False,0,0,0,14343,178,51,6.6,False,27.123116666666668,1616,3,1,233,229,4
BR1_2730070721,6,False,0,1,0,15826,183,52,6.6,False,11,True,1,0,0,17869,186,40,6.8,True,26.899566666666665,-2043,-5,-1,235,226,9
BR1_2730036638,12,True,0,0,0,16803,170,48,6.6,False,9,False,0,0,0,17721,206,47,7.0,True,27.00335,-918,3,0,218,253,-35
BR1_2730586831,8,False,1,0,0,17607,196,48,7.0,False,8,True,0,0,1,19779,216,60,7.2,True,28.579933333333333,-2172,0,1,244,276,-32
BR1_2731037326,5,False,0,0,0,17576,221,56,7.6,True,5,True,0,1,0,18446,266,60,7.2,False,28.283266666666666,-870,0,0,277,326,-49
BR1_2726491541,5,True,1,0,0,15459,192,64,6.8,False,6,False,0,1,0,15904,199,56,6.6,True,26.82075,-445,-1,1,256,255,1
BR1_2731628328,15,False,1,1,0,19288,165,60,7.2,True,6,True,0,0,0,16039,195,48,6.8,False,28.1675,3249,9,1,225,243,-18
BR1_2730666729,6,False,0,0,0,15233,189,37,6.8,False,5,True,1,0,0,16358,180,60,6.8,True,25.12686666666667,-1125,1,-1,226,240,-14
BR1_2730610342,7,True,0,1,0,17942,182,56,7.4,False,7,False,1,0,0,17168,210,52,7.4,True,27.5264,774,0,-1,238,262,-24
BR1_2700084301,9,True,1,0,0,17194,209,52,6.8,True,9,False,0,0,0,16626,188,56,7.0,False,26.9194,568,0,1,261,244,17
BR1_2693885486,9,True,1,1,0,17448,203,56,7.0,True,5,False,0,0,0,14446,172,44,6.4,False,25.3647,3002,4,1,259,216,43
BR1_2693437043,8,False,1,0,0,17230,202,52,7.0,False,9,True,0,0,0,19077,228,44,7.2,True,28.829,-1847,-1,1,254,272,-18
BR1_2716793010,11,False,0,0,0,18714,191,40,6.6,False,10,True,0,0,0,18905,210,56,6.6,True,28.968366666666668,-191,1,0,231,266,-35
BR1_2729832001,8,True,1,1,0,17614,196,42,7.2,False,7,False,0,0,0,17007,188,81,7.2,True,28.046266666666668,607,1,1,238,269,-31
BR1_2731715736,9,True,0,0,0,19132,199,64,7.2,True,6,False,0,0,0,16414,176,68,7.0,False,29.43305,2718,3,0,263,244,19
BR1_2731130047,5,True,1,1,0,15576,187,48,6.8,False,2,False,0,0,0,13982,184,62,6.8,True,27.429633333333335,1594,3,1,235,246,-11
BR1_2724071827,10,False,1,1,0,19998,222,64,7.4,False,7,True,0,0,0,17792,217,48,7.2,True,29.104033333333334,2206,3,1,286,265,21
BR1_2731367365,6,False,1,0,0,17441,237,67,7.2,False,5,True,0,0,0,17016,208,68,7.0,True,29.069366666666667,425,1,1,304,276,28
BR1_2730857796,14,True,1,0,0,21480,212,44,7.2,True,8,False,0,1,0,17823,201,60,7.0,False,27.828316666666666,3657,6,1,256,261,-5
BR1_2730742980,7,False,0,0,0,15290,151,48,6.6,False,6,True,0,0,0,16390,196,56,6.8,True,25.2659,-1100,1,0,199,252,-53
BR1_2730101866,14,False,0,1,0,21263,209,44,7.0,True,9,True,0,0,0,18475,212,52,6.6,False,28.812516666666667,2788,5,0,253,264,-11
BR1_2729997387,8,False,0,0,0,17597,224,52,7.0,True,7,True,0,0,0,16354,195,48,6.6,False,26.00175,1243,1,0,276,243,33
BR1_2695514989,2,False,0,0,0,13561,182,44,6.4,False,6,True,1,0,0,16421,199,72,7.0,True,25.154033333333334,-2860,-4,-1,226,271,-45
BR1_2726544234,13,True,1,1,0,21186,205,75,7.6,True,3,False,0,0,0,16438,226,52,7.2,False,29.160683333333335,4748,10,1,280,278,2
BR1_2729490933,8,True,0,0,0,17324,192,38,7.4,False,11,False,1,0,0,19956,235,64,7.4,True,28.683,-2632,-3,-1,230,299,-69
BR1_2731791222,11,False,0,0,0,20124,232,40,7.2,False,11,True,1,1,0,20902,216,72,7.4,True,27.607883333333334,-778,0,-1,272,288,-16
BR1_2731660511,7,True,0,0,0,16542,206,40,6.8,True,2,False,0,1,0,13597,160,56,6.8,False,27.10305,2945,5,0,246,216,30
BR1_2731502353,10,False,0,0,0,18927,198,64,7.4,True,8,True,0,0,0,17296,186,56,7.4,False,28.429033333333333,1631,2,0,262,242,20
BR1_2731402424,10,True,1,0,1,21507,237,60,7.6,True,2,False,0,1,0,14708,171,60,6.8,False,28.693383333333333,6799,8,1,297,231,66
BR1_2731047043,5,True,0,0,0,15627,189,52,6.4,True,6,False,0,0,0,16506,199,64,6.8,False,26.882216666666668,-879,-1,0,241,263,-22
BR1_2731780874,10,True,1,0,0,18800,203,71,7.2,True,7,False,0,1,0,17372,181,44,7.2,False,27.609683333333333,1428,3,1,274,225,49
BR1_2731730486,11,True,1,0,0,18578,203,52,7.2,True,5,False,0,0,0,14118,160,48,6.4,False,26.981416666666668,4460,6,1,255,208,47
BR1_2706308052,2,True,0,0,0,15231,224,55,6.8,False,5,False,0,0,0,16430,232,68,7.2,True,26.010133333333332,-1199,-3,0,279,300,-21
BR1_2704804494,14,True,0,1,0,20254,216,54,7.2,True,3,False,0,0,0,15920,201,65,7.2,False,28.1663,4334,11,0,270,266,4
BR1_2704541857,9,False,1,0,0,16683,213,60,6.8,True,4,True,0,1,0,14078,152,36,6.0,False,26.897333333333332,2605,5,1,273,188,85
BR1_2704526440,10,False,0,0,0,15009,132,48,6.4,False,14,True,1,0,0,20090,197,40,7.2,True,26.460466666666665,-5081,-4,-1,180,237,-57
BR1_2730019566,14,True,1,0,0,20594,207,55,7.4,True,9,False,0,0,0,18952,189,56,7.0,False,29.499716666666668,1642,5,1,262,245,17
BR1_2730000790,3,True,0,0,0,14581,191,51,6.4,False,4,False,0,0,0,14186,182,52,6.8,True,26.726766666666666,395,-1,0,242,234,8
BR1_2725054557,7,False,0,0,0,16034,197,44,6.4,True,3,True,1,1,0,14291,170,52,6.4,False,27.4252,1743,4,-1,241,222,19
BR1_2730872750,12,True,1,0,0,17455,204,52,6.8,True,5,False,0,0,0,14176,161,48,6.2,False,25.642216666666666,3279,7,1,256,209,47
BR1_2731832559,7,True,0,0,0,16212,183,52,6.6,False,8,False,1,0,0,17210,196,60,6.8,True,25.8987,-998,-1,-1,235,256,-21
BR1_2731816751,11,False,0,0,0,18422,230,44,7.0,True,4,True,0,1,0,15231,194,60,6.8,False,26.374883333333333,3191,7,0,274,254,20
BR1_2725190005,6,False,1,0,0,15307,165,52,6.8,False,9,True,0,0,0,17813,207,60,7.0,True,25.68775,-2506,-3,1,217,267,-50
BR1_2725162495,8,True,1,0,0,16695,183,52,6.6,True,7,False,0,0,0,16506,171,52,6.8,False,26.332066666666666,189,1,1,235,223,12
BR1_2707245065,12,True,1,1,1,21911,265,56,7.8,True,3,False,0,0,0,14942,161,68,7.2,False,27.5193,6969,9,1,321,229,92
BR1_2699636111,3,True,1,0,0,15382,230,72,7.0,True,5,False,0,0,0,15586,198,56,6.8,False,25.2738,-204,-2,1,302,254,48
BR1_2730617929,11,False,0,0,0,17585,163,48,6.8,True,8,True,0,0,0,15786,117,48,6.4,False,25.325316666666666,1799,3,0,211,165,46
BR1_2730602038,16,False,1,1,0,20934,158,60,7.0,True,9,True,0,0,0,19009,159,51,6.6,False,28.651516666666666,1925,7,1,218,210,8
BR1_2692019512,15,True,1,0,0,19000,157,56,6.8,False,12,False,0,0,0,18582,203,40,6.6,True,27.3186,418,3,1,213,243,-30
BR1_2726768602,10,True,1,1,0,19583,216,64,7.4,True,6,False,0,0,0,16281,183,52,7.0,False,28.689883333333334,3302,4,1,280,235,45
BR1_2730517577,1,False,1,0,0,13663,175,72,6.8,False,5,True,0,0,0,16484,237,56,7.0,True,26.1288,-2821,-4,1,247,293,-46
BR1_2698249686,6,True,1,0,0,17045,228,68,7.0,True,4,False,0,0,0,13936,149,40,6.8,False,25.78745,3109,2,1,296,189,107
BR1_2704370161,4,False,0,0,0,16561,228,49,7.0,False,10,True,1,0,0,19939,216,60,7.2,True,27.507483333333333,-3378,-6,-1,277,276,1
BR1_2704356793,5,False,1,0,0,16932,245,59,7.4,False,8,True,0,0,0,18249,220,64,7.6,True,28.845966666666666,-1317,-3,1,304,284,20
BR1_2727555508,5,True,0,1,0,15690,175,52,6.6,False,10,False,1,0,0,17546,175,44,6.6,True,27.0988,-1856,-5,-1,227,219,8
BR1_2730019429,11,False,1,0,0,19840,196,55,7.6,True,5,True,0,0,0,16788,212,72,7.2,False,28.186666666666667,3052,6,1,251,284,-33
BR1_2729995680,6,False,0,1,0,16504,160,55,6.8,False,10,True,1,0,0,17945,194,40,7.0,True,25.931083333333333,-1441,-4,-1,215,234,-19
BR1_2729579059,7,True,0,0,0,16064,186,48,6.6,False,11,False,1,0,0,17771,205,52,7.0,True,25.138916666666667,-1707,-4,-1,234,257,-23
BR1_2722384212,5,False,0,1,0,17469,212,51,7.2,True,1,True,1,0,0,14880,191,54,7.0,False,27.999383333333334,2589,4,-1,263,245,18
BR1_2730399808,7,True,1,0,0,15277,173,60,7.2,False,5,False,0,1,0,16607,210,64,6.8,True,25.402983333333335,-1330,2,1,233,274,-41
BR1_2719396413,3,False,1,0,0,15006,191,60,7.0,True,4,True,0,1,0,16106,220,52,7.0,False,29.77825,-1100,-1,1,251,272,-21
BR1_2696037782,9,True,0,0,0,18672,208,56,7.4,True,4,False,0,0,0,15289,186,44,6.8,False,29.263833333333334,3383,5,0,264,230,34
BR1_2731655098,4,False,1,0,0,15090,194,56,6.8,False,5,True,0,0,0,14674,182,40,6.6,True,26.935483333333334,416,-1,1,250,222,28
BR1_2730742171,3,True,1,1,0,14448,186,59,6.6,True,5,False,0,0,0,14835,164,64,6.8,False,27.089,-387,-2,1,245,228,17
BR1_2731265317,4,True,0,0,0,16601,206,52,6.8,True,5,False,1,0,0,16770,219,68,7.6,False,29.859,-169,-1,-1,258,287,-29
BR1_2729610777,4,False,0,0,0,15586,218,56,7.2,False,6,True,1,1,0,15859,173,68,6.6,True,25.8707,-273,-2,-1,274,241,33
BR1_2729324002,11,False,0,0,0,19020,184,47,7.0,True,11,True,1,1,0,19715,219,68,7.2,False,29.74865,-695,0,-1,231,287,-56
BR1_2730816075,13,False,1,1,0,18420,192,56,6.4,True,3,True,0,0,0,13896,140,44,6.0,False,25.794416666666667,4524,10,1,248,184,64
BR1_2728555746,14,False,1,0,0,19552,181,64,7.2,False,7,True,0,0,0,16939,158,44,6.6,True,28.457066666666666,2613,7,1,245,202,43
BR1_2731191754,4,False,0,0,0,14222,186,44,6.4,False,6,True,0,0,0,16418,203,48,6.8,True,25.845316666666665,-2196,-2,0,230,251,-21
BR1_2714798976,9,True,0,0,0,17726,186,40,6.6,True,7,False,1,0,0,15515,150,32,6.2,False,26.01375,2211,2,-1,226,182,44
BR1_2706927307,4,False,1,0,0,13459,159,52,6.6,False,4,True,0,0,0,14784,169,56,6.8,True,26.1832,-1325,0,1,211,225,-14
BR1_2730394657,4,False,1,0,0,15319,221,52,6.8,True,4,True,0,0,0,15823,217,80,7.4,False,26.946716666666667,-504,0,1,273,297,-24
BR1_2699026086,5,False,0,0,0,15810,158,44,6.4,False,11,True,1,0,0,20337,226,64,7.2,True,28.832533333333334,-4527,-6,-1,202,290,-88
BR1_2709712808,9,False,0,0,0,18007,194,64,7.0,False,8,True,1,1,0,18621,221,48,6.8,True,26.685783333333333,-614,1,-1,258,269,-11
BR1_2730347719,6,True,1,1,0,18104,196,60,7.4,False,11,False,0,0,0,20154,209,60,7.2,True,29.39285,-2050,-5,1,256,269,-13
BR1_2730183873,7,True,1,0,0,18906,234,48,7.6,True,10,False,0,1,0,20402,234,64,7.8,False,28.98155,-1496,-3,1,282,298,-16
BR1_2731847735,11,True,1,0,0,17916,140,80,6.8,True,6,False,0,0,1,16933,209,0,6.6,False,25.226,983,5,1,220,209,11
BR1_2703500543,5,False,0,0,0,16056,170,55,7.0,False,9,True,1,0,0,19370,251,52,7.4,True,28.3282,-3314,-4,-1,225,303,-78
BR1_2731294822,4,True,0,1,0,14885,178,56,7.0,False,8,False,1,0,0,15506,155,44,6.8,True,27.288266666666665,-621,-4,-1,234,199,35
BR1_2683450263,8,False,0,1,0,15958,172,52,7.0,True,5,True,1,0,0,15795,188,60,6.6,False,26.60645,163,3,-1,224,248,-24
BR1_2667097482,11,True,1,0,0,17042,162,40,6.8,True,2,False,0,0,0,14261,174,60,6.6,False,25.3227,2781,9,1,202,234,-32
BR1_2731493711,3,False,0,1,0,15053,216,48,6.6,True,5,True,0,0,0,14354,161,44,7.0,False,25.12076666666667,699,-2,0,264,205,59
BR1_2731485202,6,True,1,0,0,15444,214,44,7.2,True,2,False,0,0,0,14228,207,48,7.0,False,25.442133333333334,1216,4,1,258,255,3
BR1_2731317969,3,True,0,0,0,13261,165,32,6.2,True,5,False,1,0,0,15396,221,40,6.8,False,25.815966666666668,-2135,-2,-1,197,261,-64
BR1_2730973648,6,False,0,0,0,15351,165,36,6.2,False,10,True,0,0,0,17325,196,40,6.8,True,26.652533333333334,-1974,-4,0,201,236,-35
BR1_2701750275,10,True,1,0,0,18463,176,52,7.2,True,9,False,0,0,0,17532,210,36,6.8,False,28.3333,931,1,1,228,246,-18
BR1_2731608126,7,False,0,0,0,16764,194,48,6.4,True,4,True,0,1,0,14660,160,36,6.4,False,26.14555,2104,3,0,242,196,46
BR1_2731507152,7,True,0,0,0,16512,179,48,6.4,True,6,False,0,0,0,15103,157,44,6.2,False,26.997616666666666,1409,1,0,227,201,26
BR1_2730703491,3,False,1,0,0,15253,236,44,7.0,True,5,True,0,1,0,15973,181,52,6.8,False,26.871383333333334,-720,-2,1,280,233,47
BR1_2729494959,6,True,1,0,0,17702,207,76,7.4,False,9,False,0,1,0,19356,237,60,7.2,True,29.075766666666667,-1654,-3,1,283,297,-14
BR1_2729424214,4,True,1,0,0,16249,177,64,7.0,False,5,False,0,1,0,17834,220,54,7.4,True,28.328916666666668,-1585,-1,1,241,274,-33
BR1_2729670637,10,False,0,1,0,17369,154,57,6.6,True,12,True,1,0,0,18644,179,52,6.6,False,26.149166666666666,-1275,-2,-1,211,231,-20
BR1_2714905631,6,True,0,0,0,16444,191,59,7.2,False,5,False,0,1,0,18510,254,60,7.2,True,28.491,-2066,1,0,250,314,-64
BR1_2731563286,4,True,0,0,0,16019,213,56,7.2,False,5,False,1,0,0,17596,231,44,7.2,True,28.14935,-1577,-1,-1,269,275,-6
BR1_2731547430,9,True,1,0,0,16973,218,52,7.6,False,12,False,0,0,0,20003,209,52,7.4,True,29.727383333333332,-3030,-3,1,270,261,9
BR1_2731531494,13,False,1,0,0,21618,237,56,7.2,True,4,True,0,0,0,16093,202,44,6.6,False,27.903666666666666,5525,9,1,293,246,47
BR1_2731512859,7,False,1,0,0,17048,201,56,6.6,False,11,True,0,0,1,21354,242,51,7.6,True,27.523716666666665,-4306,-4,1,257,293,-36
BR1_2727416247,10,False,0,0,0,20002,258,68,7.8,False,4,True,1,0,0,16897,207,72,6.8,True,28.560883333333333,3105,6,-1,326,279,47
BR1_2718542691,9,True,1,0,0,17195,189,52,6.6,False,5,False,0,1,0,16462,192,72,6.6,True,26.655733333333334,733,4,1,241,264,-23
BR1_2719228397,6,True,0,0,0,16912,210,40,7.4,True,3,False,0,1,0,15921,198,84,6.8,False,29.77091666666667,991,3,0,250,282,-32
BR1_2698793274,5,False,0,0,0,17351,216,52,7.2,False,7,True,1,1,0,17922,212,68,7.0,True,27.917616666666667,-571,-2,-1,268,280,-12
BR1_2698781005,5,True,0,0,0,16658,210,48,7.0,False,4,False,1,1,0,15686,208,60,7.0,True,28.559233333333335,972,1,-1,258,268,-10
BR1_2730747685,5,False,0,0,0,15182,149,52,7.0,False,10,True,1,0,0,16706,174,48,6.6,True,26.47885,-1524,-5,-1,201,222,-21
BR1_2707089681,8,False,0,0,0,18464,145,59,6.8,True,9,True,0,0,0,17701,188,40,6.8,False,28.190216666666668,763,-1,0,204,228,-24
BR1_2706982136,4,False,1,1,0,17826,205,68,7.0,True,6,True,0,0,0,16210,166,60,7.0,False,29.382,1616,-2,1,273,226,47
BR1_2706955090,8,True,0,1,0,18552,227,56,7.2,False,7,False,0,0,0,18556,244,60,7.2,True,28.418883333333333,-4,1,0,283,304,-21
BR1_2705084894,13,False,0,0,0,18540,182,40,7.0,True,6,True,0,0,0,17237,200,64,7.2,False,29.4066,1303,7,0,222,264,-42
BR1_2705066630,8,True,0,0,0,17011,194,56,6.8,False,6,False,1,1,1,18531,200,60,7.0,True,28.037033333333333,-1520,2,-1,250,260,-10
BR1_2730987676,3,False,1,1,0,15148,170,52,7.4,True,4,True,0,0,0,15691,193,40,6.8,False,29.028083333333335,-543,-1,1,222,233,-11
BR1_2711862540,10,True,0,1,0,18685,217,64,7.6,True,5,False,0,0,0,15663,201,52,7.4,False,28.738183333333332,3022,5,0,281,253,28
BR1_2719447266,10,True,1,0,0,18315,206,53,7.4,True,7,False,0,1,0,17541,178,54,7.2,False,28.263933333333334,774,3,1,259,232,27
BR1_2715400581,3,False,0,0,0,15165,177,56,7.2,False,5,True,1,0,0,16911,209,57,7.4,True,29.49191666666667,-1746,-2,-1,233,266,-33
BR1_2729877207,10,True,1,0,0,17241,199,40,6.6,True,7,False,0,1,0,16338,165,48,6.4,False,26.67275,903,3,1,239,213,26
BR1_2687040177,12,False,1,1,0,18538,199,60,7.0,True,3,True,0,0,0,13850,192,40,6.6,False,26.78555,4688,9,1,259,232,27
BR1_2687022122,7,False,1,1,0,16868,206,48,7.0,True,3,True,0,0,0,14087,179,56,6.4,False,26.2855,2781,4,1,254,235,19
BR1_2697154209,9,False,0,1,0,17554,182,40,6.6,True,5,True,1,0,0,15443,194,48,6.8,False,26.349066666666666,2111,4,-1,222,242,-20
BR1_2695332008,4,False,0,0,0,15161,186,50,6.6,True,7,True,0,0,0,16467,212,44,7.2,False,27.4468,-1306,-3,0,236,256,-20
BR1_2711759546,7,False,0,0,0,16922,185,51,7.4,False,6,True,1,0,0,18453,228,56,7.0,True,28.118966666666665,-1531,1,-1,236,284,-48
BR1_2731089300,11,True,1,0,0,19928,219,64,7.2,False,11,False,0,0,0,19631,234,60,7.4,True,29.162316666666666,297,0,1,283,294,-11
BR1_2702549159,7,False,1,0,0,16072,177,48,6.6,True,7,True,0,0,0,16312,206,60,7.0,False,27.04015,-240,0,1,225,266,-41
BR1_2695202555,7,False,0,0,0,17254,218,40,7.2,False,12,True,1,0,0,18633,200,44,7.6,True,27.726416666666665,-1379,-5,-1,258,244,14
BR1_2695197567,8,False,1,1,0,17497,159,62,6.8,True,5,True,0,0,0,16314,200,48,7.0,False,29.178633333333334,1183,3,1,221,248,-27
BR1_2728287308,5,False,0,0,0,16534,180,60,7.0,False,14,True,0,1,0,19774,244,56,7.6,True,27.592416666666665,-3240,-9,0,240,300,-60
BR1_2731241382,8,False,0,1,0,18736,193,48,7.2,True,10,True,0,0,0,19016,191,59,7.2,False,28.59735,-280,-2,0,241,250,-9
BR1_2716702387,6,False,0,0,0,15795,183,36,6.6,False,5,True,0,0,0,16321,241,56,7.0,True,26.711233333333332,-526,1,0,219,297,-78
BR1_2723498841,11,False,1,1,0,19756,211,71,7.4,True,10,True,0,0,0,18485,168,48,6.6,False,29.050333333333334,1271,1,1,282,216,66
BR1_2723479989,4,True,0,0,0,15450,208,52,6.6,False,2,False,0,0,0,14920,217,52,7.0,True,25.263016666666665,530,2,0,260,269,-9
BR1_2705392586,14,True,0,0,0,20501,204,52,7.4,True,8,False,0,1,1,19138,151,56,6.8,False,27.979866666666666,1363,6,0,256,207,49
BR1_2717580575,3,True,0,1,0,16028,215,47,7.2,False,5,False,0,0,0,17005,257,48,7.0,True,29.71975,-977,-2,0,262,305,-43
BR1_2731303938,9,False,0,0,0,18179,198,52,7.2,False,11,True,0,0,0,20446,240,60,7.8,True,29.888783333333333,-2267,-2,0,250,300,-50
BR1_2730726248,3,False,1,0,0,15337,211,58,7.4,False,6,True,0,1,0,18763,236,58,7.8,True,28.470466666666667,-3426,-3,1,269,294,-25
BR1_2730207910,8,True,0,1,0,19893,232,68,7.2,False,11,False,1,0,0,18624,180,64,7.2,True,27.52755,1269,-3,-1,300,244,56
BR1_2729301355,8,True,1,1,0,18846,203,56,6.8,True,2,False,0,0,0,13857,174,52,6.6,False,26.518233333333335,4989,6,1,259,226,33
BR1_2683629856,9,False,0,0,0,17031,180,44,7.0,False,12,True,0,1,0,19220,185,60,7.2,True,25.377516666666665,-2189,-3,0,224,245,-21
BR1_2677519832,5,False,1,1,0,17188,193,52,7.6,False,10,True,0,0,0,20319,247,60,8.0,True,29.123366666666666,-3131,-5,1,245,307,-62
BR1_2724514298,5,False,0,1,0,14556,143,48,5.8,False,12,True,1,0,0,18007,151,52,6.8,True,27.000116666666667,-3451,-7,-1,191,203,-12
BR1_2726041316,8,False,0,0,0,16767,197,39,6.8,False,6,True,0,0,0,15213,182,44,6.8,True,26.111266666666666,1554,2,0,236,226,10
BR1_2728975548,7,False,1,0,0,18098,233,72,7.6,True,9,True,0,0,0,18585,235,56,7.4,False,29.105033333333335,-487,-2,1,305,291,14
BR1_2719680331,7,False,0,0,0,14611,154,52,6.6,False,11,True,1,1,0,19119,191,64,6.8,True,26.696133333333332,-4508,-4,-1,206,255,-49
BR1_2731538703,5,False,0,0,0,16197,158,67,7.2,False,13,True,1,1,1,22439,230,72,7.8,True,28.64145,-6242,-8,-1,225,302,-77
BR1_2731289536,7,True,1,1,0,18145,236,60,7.4,True,7,False,0,0,0,16873,207,64,7.2,False,29.6564,1272,0,1,296,271,25
BR1_2730880423,12,False,0,0,0,17415,185,36,6.6,False,9,True,1,0,0,17710,174,67,6.4,True,25.927633333333333,-295,3,-1,221,241,-20
BR1_2730356442,6,True,0,0,0,14593,169,48,6.6,False,6,False,0,1,0,16613,183,44,6.6,True,27.117833333333333,-2020,0,0,217,227,-10
BR1_2722196401,8,False,1,0,0,17453,209,44,6.8,False,14,True,0,1,0,20629,193,56,7.6,True,28.554566666666666,-3176,-6,1,253,249,4
BR1_2724523689,6,True,0,1,0,17034,194,64,7.4,False,5,False,1,0,0,17195,199,76,7.6,True,29.417416666666668,-161,1,-1,258,275,-17
BR1_2731436950,5,True,0,1,0,15988,211,36,6.8,False,8,False,1,0,0,16895,186,64,6.8,True,26.52195,-907,-3,-1,247,250,-3
BR1_2718859696,7,False,0,1,1,18269,163,52,7.2,False,7,True,1,0,0,17138,170,52,7.0,True,29.233633333333334,1131,0,-1,215,222,-7
BR1_2724341600,7,False,0,0,0,16967,199,52,7.4,False,4,True,1,0,0,16705,225,60,7.2,True,29.15415,262,3,-1,251,285,-34
BR1_2724015502,6,True,0,0,0,16912,204,61,7.0,False,5,False,1,1,0,16439,199,50,7.2,True,29.983483333333332,473,1,-1,265,249,16
BR1_2731562673,8,True,1,0,0,17128,210,56,7.0,True,6,False,0,0,0,14950,157,56,6.6,False,25.781316666666665,2178,2,1,266,213,53
BR1_2705353106,6,False,1,1,0,17895,209,60,6.8,True,13,True,0,0,0,19718,201,48,7.2,False,29.005216666666666,-1823,-7,1,269,249,20
BR1_2704304150,3,False,0,0,0,14837,207,48,7.0,False,7,True,1,1,0,18039,197,64,7.2,True,28.491416666666666,-3202,-4,-1,255,261,-6
BR1_2704296296,4,False,0,0,0,14735,190,44,6.4,False,5,True,0,0,0,15444,184,44,7.0,True,25.855033333333335,-709,-1,0,234,228,6
BR1_2711987165,7,True,0,0,0,15482,140,44,6.4,False,8,False,1,0,0,16226,151,60,6.8,True,26.999933333333335,-744,-1,-1,184,211,-27
BR1_2719706212,6,True,0,0,0,16225,199,56,6.8,True,8,False,0,0,0,15197,125,40,6.2,False,27.210433333333334,1028,-2,0,255,165,90
BR1_2719612147,10,False,1,0,0,17703,166,44,6.4,True,8,True,0,0,0,15845,180,48,6.6,False,25.2021,1858,2,1,210,228,-18
BR1_2713022697,8,False,1,0,0,16796,192,56,7.0,False,13,True,0,1,1,19748,172,56,7.0,True,25.155116666666668,-2952,-5,1,248,228,20
BR1_2712988648,5,True,1,1,0,15728,183,48,6.8,False,3,False,0,0,0,14101,195,52,7.0,True,25.3023,1627,2,1,231,247,-16
BR1_2712853148,4,True,0,0,0,15740,168,56,7.0,False,7,False,1,0,0,18794,222,80,7.8,True,27.985616666666665,-3054,-3,-1,224,302,-78
BR1_2730143738,3,True,1,0,0,15382,217,56,7.2,True,3,False,0,0,0,17090,209,63,7.6,False,27.5853,-1708,0,1,273,272,1
BR1_2731565572,5,False,0,0,0,15007,183,49,6.6,False,2,True,1,0,0,14259,191,50,6.4,True,26.853716666666667,748,3,-1,232,241,-9
BR1_2731551125,14,True,1,1,0,19641,181,64,6.8,False,16,False,1,0,0,22214,208,55,7.2,True,28.390616666666666,-2573,-2,0,245,263,-18
BR1_2691926758,9,True,0,0,2,20373,221,57,7.2,True,4,False,1,0,0,15858,184,52,6.2,False,28.3925,4515,5,-1,278,236,42
BR1_2691894967,9,True,0,0,0,19117,223,52,7.4,True,1,False,1,0,0,14613,192,72,7.4,False,29.958183333333334,4504,8,-1,275,264,11
BR1_2705546936,12,True,0,0,0,20644,228,69,7.6,True,5,False,1,0,0,16473,197,68,7.2,False,28.610966666666666,4171,7,-1,297,265,32
BR1_2723089507,4,True,1,1,0,17892,257,60,7.4,True,4,False,0,0,0,15225,212,52,7.4,False,29.77466666666667,2667,0,1,317,264,53
BR1_2722809770,4,False,0,0,0,15265,163,60,7.0,False,8,True,1,1,0,18831,204,72,7.6,True,28.88165,-3566,-4,-1,223,276,-53
BR1_2731730772,9,False,1,0,0,16925,180,44,6.6,True,6,True,0,0,0,15974,194,60,6.6,False,25.145516666666666,951,3,1,224,254,-30
BR1_2731053619,7,False,0,0,0,18320,213,56,7.4,False,6,True,1,0,0,17993,240,60,7.6,True,28.239433333333334,327,1,-1,269,300,-31
BR1_2722844441,1,False,0,0,0,14815,207,60,6.8,False,12,True,1,0,0,20807,242,68,7.6,True,28.6618,-5992,-11,-1,267,310,-43
BR1_2693663676,13,False,1,0,0,19335,200,64,7.0,True,7,True,0,0,0,15561,149,48,6.4,False,26.641633333333335,3774,6,1,264,197,67
BR1_2726345625,13,True,0,0,0,20204,221,80,7.8,True,3,False,0,1,0,17043,223,56,7.4,False,28.951183333333333,3161,10,0,301,279,22
BR1_2731731168,6,True,0,0,0,16618,218,44,6.8,True,4,False,1,0,0,15085,205,44,6.8,False,26.5538,1533,2,-1,262,249,13
BR1_2731650938,11,True,1,0,0,18243,196,72,6.8,True,2,False,0,0,0,14114,191,48,6.4,False,26.10395,4129,9,1,268,239,29
BR1_2731627957,18,True,1,0,0,21715,206,37,6.4,True,6,False,0,0,0,16552,129,48,6.0,False,27.480416666666667,5163,12,1,243,177,66
BR1_2723824481,8,False,0,1,0,18927,235,60,7.2,False,11,True,0,0,0,20033,230,54,7.4,True,29.43415,-1106,-3,0,295,284,11
BR1_2723794234,4,True,0,0,0,14843,182,53,6.4,False,7,False,0,0,0,16240,196,57,7.0,True,27.195383333333332,-1397,-3,0,235,253,-18
BR1_2731815191,4,False,0,0,0,16363,213,56,7.0,False,11,True,1,0,0,18633,192,44,7.0,True,29.989916666666666,-2270,-7,-1,269,236,33
BR1_2731790536,10,False,1,0,0,16989,170,48,6.8,False,8,True,0,1,1,19048,213,47,6.6,True,26.67145,-2059,2,1,218,260,-42
BR1_2730397629,7,True,0,0,0,18166,217,60,7.4,False,9,False,1,1,0,19926,247,52,7.8,True,28.921616666666665,-1760,-2,-1,277,299,-22
BR1_2731318336,6,True,1,0,0,16731,209,36,7.0,True,3,False,0,0,0,16127,241,60,7.4,False,28.650433333333332,604,3,1,245,301,-56
BR1_2730793022,9,False,1,0,0,17695,177,64,7.2,False,10,True,0,0,0,19581,251,52,7.4,True,28.802866666666667,-1886,-1,1,241,303,-62
BR1_2729937973,6,False,0,0,0,14860,186,36,6.6,False,4,True,0,0,0,16074,198,60,7.0,True,25.669366666666665,-1214,2,0,222,258,-36
BR1_2729927069,8,False,0,0,0,18704,253,48,7.4,False,5,True,1,1,0,16342,201,56,7.0,True,28.182233333333333,2362,3,-1,301,257,44
BR1_2729760761,3,False,1,0,0,14726,203,47,6.8,True,2,True,0,0,0,13967,213,45,6.6,False,26.135716666666667,759,1,1,250,258,-8
BR1_2729739521,8,False,0,0,0,16995,188,44,7.0,False,9,True,1,0,0,19191,222,76,7.8,True,28.474016666666667,-2196,-1,-1,232,298,-66
BR1_2729316418,7,True,1,0,0,17596,232,56,7.2,True,3,False,0,0,0,14299,193,44,6.8,False,25.6683,3297,4,1,288,237,51
BR1_2728909541,7,True,0,1,0,17262,193,52,6.6,True,0,False,1,0,0,13382,207,56,6.6,False,25.417733333333334,3880,7,-1,245,263,-18
BR1_2730143124,5,False,1,0,0,15879,190,56,6.8,False,11,True,0,0,0,19307,216,56,7.6,True,28.139416666666666,-3428,-6,1,246,272,-26
BR1_2729742517,5,True,1,0,0,17103,231,46,7.0,True,4,False,0,0,0,16185,228,50,7.4,False,29.42805,918,1,1,277,278,-1
BR1_2729718901,4,True,0,0,0,16642,237,48,7.4,True,6,False,1,1,0,17114,199,52,7.0,False,29.884883333333335,-472,-2,-1,285,251,34
BR1_2727372179,0,False,1,0,0,14654,209,72,7.2,True,0,False,0,0,0,15191,248,64,7.4,False,28.912933333333335,-537,0,1,281,312,-31
BR1_2729356552,6,False,1,0,0,15376,184,60,6.8,False,7,True,0,1,0,17277,225,44,6.8,True,25.596433333333334,-1901,-1,1,244,269,-25
BR1_2719835814,8,False,1,0,0,17584,163,51,6.8,False,8,True,0,0,0,18341,203,66,7.2,True,28.043533333333333,-757,0,1,214,269,-55
BR1_2731211803,6,True,0,1,0,16966,218,64,7.0,False,4,False,0,0,0,14706,181,48,6.8,True,26.009233333333334,2260,2,0,282,229,53
BR1_2730921043,6,True,0,0,0,14731,149,44,6.4,False,6,False,1,0,0,16151,171,56,6.6,True,27.387416666666667,-1420,0,-1,193,227,-34
BR1_2731688152,5,False,0,1,0,16693,216,52,7.2,True,9,True,1,0,0,18727,217,56,7.2,False,29.1854,-2034,-4,-1,268,273,-5
BR1_2726250361,8,False,0,0,0,16506,165,52,6.8,False,14,True,0,0,0,19233,201,48,7.2,True,26.638883333333332,-2727,-6,0,217,249,-32
BR1_2729854819,6,False,0,0,0,17185,223,52,7.2,False,10,True,0,0,0,18984,221,56,7.4,True,27.58195,-1799,-4,0,275,277,-2
BR1_2717893930,7,True,0,0,0,18116,258,40,7.4,True,6,False,1,0,0,16639,199,76,7.0,False,29.04195,1477,1,-1,298,275,23
BR1_2717872951,7,True,1,1,0,16957,198,72,7.0,True,3,False,0,0,0,14721,197,48,6.6,False,25.9003,2236,4,1,270,245,25
BR1_2717828997,10,False,0,0,1,20117,207,48,7.4,True,5,True,0,0,0,15489,171,64,6.8,False,27.932433333333332,4628,5,0,255,235,20
BR1_2729155951,8,True,0,1,0,16556,166,60,6.6,True,7,False,1,0,0,16441,189,60,7.0,False,26.927266666666668,115,1,-1,226,249,-23
BR1_2731768365,10,True,1,0,0,17405,203,44,6.8,True,5,False,0,0,0,14539,164,52,6.4,False,26.101266666666668,2866,5,1,247,216,31
BR1_2731223706,6,False,1,0,0,16563,194,48,6.8,True,7,True,0,0,0,18602,196,72,7.0,False,29.230333333333334,-2039,-1,1,242,268,-26
BR1_2699002850,7,False,1,0,0,17122,164,56,7.0,False,9,True,0,1,1,20376,211,64,7.4,True,28.413933333333333,-3254,-2,1,220,275,-55
BR1_2698977880,7,True,0,0,0,18311,250,68,7.8,True,1,False,1,0,0,14478,201,60,7.2,False,28.77585,3833,6,-1,318,261,57
BR1_2730417160,9,True,0,0,0,17113,200,35,6.8,True,7,False,0,0,0,15011,183,41,6.6,False,26.854283333333335,2102,2,0,235,224,11
BR1_2731541002,2,False,0,0,0,13690,139,52,6.2,False,9,True,1,0,0,16832,196,40,6.8,True,27.191916666666668,-3142,-7,-1,191,236,-45
BR1_2731517444,2,False,0,0,0,14520,190,40,6.8,False,15,True,1,0,0,21166,279,56,7.6,True,29.20755,-6646,-13,-1,230,335,-105
BR1_2715567616,11,False,1,0,0,19932,235,60,7.4,True,7,True,0,0,0,17352,226,40,7.2,False,28.959183333333332,2580,4,1,295,266,29
BR1_2730681091,8,True,0,0,0,16121,165,64,6.8,True,4,False,0,0,0,14988,193,40,6.6,False,26.531766666666666,1133,4,0,229,233,-4
BR1_2725025411,2,True,0,0,0,15122,207,48,6.8,False,4,False,1,1,0,15979,212,62,7.0,True,28.3638,-857,-2,-1,255,274,-19
BR1_2718878182,8,True,1,1,0,16981,174,60,7.0,True,7,False,0,0,0,16497,143,52,7.0,False,27.715766666666667,484,1,1,234,195,39
BR1_2726922490,3,True,0,1,0,17211,242,64,7.6,True,3,False,0,0,0,16054,228,64,7.4,False,29.65985,1157,0,0,306,292,14
BR1_2731350193,4,False,0,0,0,15788,212,68,7.0,False,6,True,1,0,0,16351,211,44,6.8,True,27.171866666666666,-563,-2,-1,280,255,25
BR1_2731335075,10,True,1,0,0,20283,231,56,7.0,True,14,False,0,1,0,19665,219,44,6.8,False,28.69305,618,-4,1,287,263,24
BR1_2731290760,3,True,0,0,0,14320,178,64,6.6,False,7,False,1,0,0,16402,211,53,7.0,True,26.518716666666666,-2082,-4,-1,242,264,-22
BR1_2699758845,3,False,0,0,0,13765,178,48,6.8,True,6,True,0,0,0,14946,172,32,6.6,False,25.5847,-1181,-3,0,226,204,22
BR1_2731684060,4,True,0,0,0,16568,233,55,7.2,False,8,False,1,1,0,18040,238,48,7.2,True,28.531833333333335,-1472,-4,-1,288,286,2
BR1_2731659193,8,True,0,1,0,17819,219,47,6.8,True,6,False,1,0,0,15461,189,48,6.4,False,25.92325,2358,2,-1,266,237,29
BR1_2731664725,5,True,0,1,0,17738,212,52,7.2,True,7,False,1,0,1,18667,205,60,7.4,False,29.44885,-929,-2,-1,264,265,-1
BR1_2731534578,6,False,0,0,0,16324,196,47,6.8,False,10,True,1,1,0,19201,209,64,7.0,True,28.60485,-2877,-4,-1,243,273,-30
BR1_2731861492,11,True,1,0,0,19481,224,66,7.2,False,7,False,0,0,0,17273,202,44,6.8,True,28.5516,2208,4,1,290,246,44
BR1_2731808189,6,True,0,0,0,14904,163,52,6.4,False,5,False,0,0,0,15267,171,40,6.6,True,27.265966666666667,-363,1,0,215,211,4
BR1_2731204306,7,True,1,0,0,17722,206,60,7.8,True,2,False,0,0,0,16264,227,72,7.6,False,28.239466666666665,1458,5,1,266,299,-33
BR1_2731849006,9,True,0,0,0,18887,227,68,7.0,False,8,False,1,0,0,19075,248,60,7.4,True,27.618066666666667,-188,1,-1,295,308,-13
BR1_2675000965,7,True,1,0,0,18571,244,52,7.4,True,10,False,0,1,0,19089,192,56,7.8,False,29.50395,-518,-3,1,296,248,48
BR1_2674976156,6,False,0,0,0,17032,203,56,7.4,False,8,True,1,1,0,18056,218,76,8.0,True,27.619833333333332,-1024,-2,-1,259,294,-35
BR1_2729327816,8,False,1,0,0,17885,198,64,7.2,False,7,True,0,0,0,18318,241,56,7.4,True,28.549316666666666,-433,1,1,262,297,-35
BR1_2729309793,9,False,0,0,0,18281,197,59,7.2,True,8,True,0,0,0,19278,210,60,7.4,False,28.315666666666665,-997,1,0,256,270,-14
BR1_2730235746,8,True,0,1,0,17464,204,56,7.4,True,7,False,0,0,0,17633,178,48,7.2,False,28.174416666666666,-169,1,0,260,226,34
BR1_2730208572,4,False,0,0,0,15290,222,50,6.8,False,6,True,1,0,0,15639,216,52,6.8,True,26.54465,-349,-2,-1,272,268,4
BR1_2728133201,6,False,0,0,0,15832,204,52,7.2,False,9,True,0,0,0,17447,188,47,6.8,True,25.4147,-1615,-3,0,256,235,21
BR1_2715005261,4,False,0,0,0,15369,206,43,7.2,False,8,True,1,0,0,18281,219,68,7.6,True,29.279666666666667,-2912,-4,-1,249,287,-38
BR1_2730226778,9,False,1,1,0,17257,194,60,7.0,True,4,True,0,0,0,13437,124,40,6.4,False,25.313033333333333,3820,5,1,254,164,90
BR1_2687269951,11,False,0,0,0,19944,210,56,7.4,False,12,True,0,0,0,19593,226,48,7.4,True,27.565166666666666,351,-1,0,266,274,-8
BR1_2731554963,4,True,0,0,0,14610,178,52,6.6,False,6,False,1,0,0,16085,190,48,6.8,True,27.134983333333334,-1475,-2,-1,230,238,-8
BR1_2730886086,7,False,1,1,0,17224,189,56,7.0,True,4,True,0,0,0,14712,176,38,6.8,False,29.333166666666667,2512,3,1,245,214,31
BR1_2730874593,4,False,1,0,0,14579,173,40,6.8,True,6,True,0,0,0,16400,211,48,6.6,False,25.086233333333332,-1821,-2,1,213,259,-46
BR1_2730828734,18,True,1,0,0,21845,182,56,7.2,True,11,False,0,0,0,18172,159,48,6.8,False,29.667266666666666,3673,7,1,238,207,31
BR1_2714905178,5,True,0,0,0,16642,201,40,6.8,False,6,False,1,0,0,16456,157,60,6.8,True,27.604966666666666,186,-1,-1,241,217,24
BR1_2701624994,7,True,1,1,0,17442,210,80,7.2,False,4,False,0,0,0,16358,214,56,7.4,True,29.744866666666667,1084,3,1,290,270,20
BR1_2714878071,10,True,0,0,0,16781,163,36,6.0,True,7,False,0,0,0,15233,168,36,6.0,False,25.586816666666667,1548,3,0,199,204,-5
BR1_2723896793,4,False,0,0,0,15783,208,52,6.4,True,4,True,0,0,0,14105,167,36,6.6,False,26.908566666666665,1678,0,0,260,203,57
BR1_2705371046,11,False,0,0,0,19154,185,68,7.4,False,9,True,0,0,0,18996,211,43,7.2,True,28.433233333333334,158,2,0,253,254,-1
BR1_2729987879,8,False,0,0,0,15746,170,56,6.4,False,9,True,1,1,0,17459,211,56,6.8,True,25.651633333333333,-1713,-1,-1,226,267,-41
BR1_2670043363,9,False,0,0,0,18577,219,64,7.6,True,9,True,0,1,0,17994,195,56,7.2,False,29.18295,583,0,0,283,251,32
BR1_2731267164,9,False,1,0,0,17674,176,64,7.0,True,7,True,0,0,0,16154,195,52,7.2,False,28.635833333333334,1520,2,1,240,247,-7
BR1_2717672698,12,True,1,0,1,22027,239,56,7.2,True,5,False,0,1,0,15858,168,62,7.0,False,27.808833333333332,6169,7,1,295,230,65
BR1_2731633188,7,False,0,0,0,15861,202,44,6.8,False,8,True,1,0,0,17188,166,64,6.4,True,27.14055,-1327,-1,-1,246,230,16
BR1_2714400918,9,True,0,0,0,17986,189,52,7.0,False,10,False,0,1,0,18513,195,52,7.0,True,28.852633333333333,-527,-1,0,241,247,-6
BR1_2723113772,8,True,1,1,0,18061,217,71,7.6,True,2,False,0,0,0,15057,226,43,7.0,False,29.432283333333334,3004,6,1,288,269,19
BR1_2722733882,8,True,1,0,0,17335,194,59,6.8,True,6,False,0,0,0,15526,188,56,6.8,False,26.9331,1809,2,1,253,244,9
BR1_2696412128,9,True,1,1,0,17421,189,48,6.8,True,5,False,0,0,0,15226,159,52,6.0,False,26.11253333333333,2195,4,1,237,211,26
BR1_2731272390,11,False,1,0,0,18069,203,41,6.4,True,13,True,0,0,0,17570,140,54,6.6,False,25.634566666666668,499,-2,1,244,194,50
BR1_2672450974,7,True,0,0,0,15975,179,36,6.6,False,9,False,1,0,0,17372,193,59,7.2,True,25.492166666666666,-1397,-2,-1,215,252,-37
BR1_2672380905,6,True,1,0,0,17356,213,64,8.0,False,6,False,0,0,0,17777,219,60,7.6,True,29.45545,-421,0,1,277,279,-2
BR1_2672356343,2,True,0,1,0,14283,195,54,6.6,False,6,False,1,0,0,17090,213,72,7.0,True,26.858116666666668,-2807,-4,-1,249,285,-36
BR1_2672261171,4,False,0,0,0,17116,230,58,7.4,True,4,True,1,1,0,17257,232,64,7.2,False,29.089883333333333,-141,0,-1,288,296,-8
BR1_2731280276,9,True,1,0,0,18914,254,64,7.4,True,8,False,0,1,0,17792,188,40,7.0,False,29.10295,1122,1,1,318,228,90
BR1_2731674022,15,True,0,0,0,21110,198,48,7.6,True,11,False,1,0,0,17868,153,51,6.8,False,28.68798333333333,3242,4,-1,246,204,42
BR1_2730219239,3,True,1,0,0,14344,180,50,6.8,False,0,False,0,1,0,13534,202,64,6.8,True,26.829066666666666,810,3,1,230,266,-36
BR1_2709038575,14,False,0,0,0,18570,196,48,6.8,True,10,True,1,0,0,17230,193,44,6.4,False,25.643983333333335,1340,4,-1,244,237,7
BR1_2708880805,6,False,0,1,0,16602,185,64,6.8,False,7,True,1,0,0,18103,220,56,7.2,True,28.451016666666668,-1501,-1,-1,249,276,-27
BR1_2718904437,5,True,0,0,0,16847,204,46,6.6,False,11,False,1,0,0,20961,264,73,7.8,True,28.16796666666667,-4114,-6,-1,250,337,-87
BR1_2731844502,3,True,0,0,0,15200,206,48,6.8,False,5,False,1,0,0,15460,202,56,6.6,True,26.003266666666665,-260,-2,-1,254,258,-4
BR1_2730357741,8,True,0,0,0,19616,233,68,8.0,True,3,False,1,0,0,15609,167,64,7.2,False,29.256283333333332,4007,5,-1,301,231,70
BR1_2730103907,9,False,0,1,0,18613,174,56,7.0,False,16,True,0,0,0,21608,210,56,7.6,True,28.6212,-2995,-7,0,230,266,-36
BR1_2726362659,10,True,1,0,0,19257,246,55,7.6,True,6,False,0,0,0,17099,209,49,7.4,False,27.551816666666667,2158,4,1,301,258,43
BR1_2731699624,12,True,0,1,0,19304,188,60,7.2,True,4,False,0,0,0,14165,151,52,6.6,False,25.375216666666667,5139,8,0,248,203,45
BR1_2731593343,9,True,0,1,0,16633,164,48,6.6,False,11,False,1,0,0,17796,168,56,6.6,True,25.0093,-1163,-2,-1,212,224,-12
BR1_2727508235,9,False,0,0,0,19031,249,40,7.6,False,4,True,0,0,0,15229,177,40,6.8,True,29.023233333333334,3802,5,0,289,217,72
BR1_2727456563,5,False,0,0,0,14642,146,40,6.6,False,9,True,1,0,0,16910,212,56,6.8,True,27.435666666666666,-2268,-4,-1,186,268,-82
BR1_2727005437,6,True,1,0,0,16657,224,59,7.2,False,8,False,0,0,0,18538,208,52,7.8,True,27.7913,-1881,-2,1,283,260,23
BR1_2731616653,4,False,0,0,0,15380,177,52,6.8,False,6,True,1,0,0,17877,220,56,7.2,True,29.9106,-2497,-2,-1,229,276,-47
BR1_2731773934,10,False,0,1,0,18366,191,51,7.4,True,5,True,0,0,0,16908,217,47,7.2,False,29.821916666666667,1458,5,0,242,264,-22
BR1_2718088675,18,True,1,1,0,23690,236,64,7.8,True,11,False,0,0,0,18103,197,40,7.0,False,27.88875,5587,7,1,300,237,63
BR1_2718061530,12,True,0,0,0,19669,201,52,7.2,False,8,False,0,0,0,17420,202,52,6.8,True,29.598183333333335,2249,4,0,253,254,-1
BR1_2726393119,6,False,0,1,0,16416,177,56,7.4,True,7,True,1,0,0,18133,222,64,7.2,False,29.874,-1717,-1,-1,233,286,-53
BR1_2726362011,7,False,1,1,0,17989,197,48,7.0,False,15,True,0,0,0,19705,186,34,7.0,True,27.971183333333332,-1716,-8,1,245,220,25
BR1_2721052926,11,False,1,0,0,19405,205,48,7.4,False,11,True,0,1,0,20466,246,65,7.4,True,29.302816666666665,-1061,0,1,253,311,-58
BR1_2721667515,11,False,0,0,0,17241,159,44,6.6,False,5,True,1,1,0,15860,207,48,6.8,True,26.10185,1381,6,-1,203,255,-52
BR1_2726967988,12,False,0,0,1,20112,210,60,7.6,True,6,True,0,1,0,16927,199,48,7.0,False,29.11795,3185,6,0,270,247,23
BR1_2731689261,6,False,0,0,0,16975,244,56,7.4,False,7,True,1,0,0,18340,234,68,7.2,True,29.336233333333332,-1365,-1,-1,300,302,-2
BR1_2729347120,2,False,0,1,0,14521,175,64,6.8,False,12,True,1,0,0,19045,205,64,7.2,True,27.398583333333335,-4524,-10,-1,239,269,-30
BR1_2719615443,12,True,0,0,0,17691,157,48,6.4,False,8,False,1,0,0,16540,167,48,6.4,True,27.135833333333334,1151,4,-1,205,215,-10
BR1_2717493505,3,True,0,0,0,14815,181,52,6.6,False,9,False,1,0,0,16128,180,44,6.8,True,26.16765,-1313,-6,-1,233,224,9
BR1_2717314686,6,False,0,0,0,15827,159,49,6.6,False,9,True,0,0,0,17044,171,46,7.2,True,29.201283333333333,-1217,-3,0,208,217,-9
BR1_2730596920,4,False,0,0,0,16527,209,56,7.2,True,6,True,1,0,0,16230,197,44,6.8,False,29.569333333333333,297,-2,-1,265,241,24
BR1_2729214864,9,True,1,0,0,17394,202,52,7.0,True,6,False,0,0,0,15779,212,40,6.8,False,26.977883333333335,1615,3,1,254,252,2
BR1_2729027042,8,True,0,0,0,16038,144,28,6.4,False,8,False,1,0,0,16989,193,60,6.8,True,26.877866666666666,-951,0,-1,172,253,-81
BR1_2728875362,11,True,0,0,0,18526,209,53,7.2,False,7,False,1,1,0,16437,182,47,6.4,True,25.01343333333333,2089,4,-1,262,229,33
BR1_2724944940,6,True,0,0,0,14598,151,44,6.6,False,11,False,1,0,0,17341,169,56,6.8,True,26.3299,-2743,-5,-1,195,225,-30
BR1_2713696794,6,True,1,1,0,16027,183,55,6.8,False,4,False,0,0,0,15256,191,44,6.4,True,25.473116666666666,771,2,1,238,235,3
BR1_2703251946,8,False,0,0,0,16149,194,47,7.0,False,11,True,1,0,0,18680,190,56,7.0,True,27.066666666666666,-2531,-3,-1,241,246,-5
BR1_2713336131,5,True,1,0,0,14693,156,44,6.4,False,12,False,0,0,1,19497,175,40,6.6,True,25.712266666666668,-4804,-7,1,200,215,-15
BR1_2713910314,7,False,0,0,0,17122,183,48,7.4,False,9,True,0,0,0,18467,227,44,7.4,True,27.581216666666666,-1345,-2,0,231,271,-40
BR1_2683608657,7,True,1,0,0,16038,194,72,7.2,True,3,False,0,1,0,13736,172,48,6.8,False,25.709516666666666,2302,4,1,266,220,46
BR1_2680580503,7,False,0,0,0,16382,225,44,7.2,False,14,True,0,1,0,21461,246,56,7.8,True,27.9394,-5079,-7,0,269,302,-33
BR1_2697156251,9,True,1,0,0,17909,213,60,7.6,True,5,False,0,0,0,16459,232,56,7.4,False,27.8961,1450,4,1,273,288,-15
BR1_2731720524,1,False,0,0,0,14160,182,72,6.8,False,10,True,1,1,0,17656,199,64,7.2,True,27.118833333333335,-3496,-9,-1,254,263,-9
BR1_2731702122,9,True,1,1,0,19063,225,68,7.4,True,3,False,0,0,0,15388,178,47,6.8,False,28.23435,3675,6,1,293,225,68
BR1_2730194167,1,False,0,1,0,13378,177,60,6.8,False,9,True,1,0,0,18076,236,72,7.2,True,25.13285,-4698,-8,-1,237,308,-71
BR1_2726663475,5,True,1,0,0,16614,179,64,7.2,True,3,False,0,0,0,14758,220,0,6.2,False,28.0584,1856,2,1,243,220,23
BR1_2731771570,14,True,0,1,0,21380,206,64,7.6,True,12,False,1,0,0,20868,237,44,7.4,False,29.917,512,2,-1,270,281,-11
BR1_2730017270,10,True,0,0,0,17847,195,36,6.8,False,9,False,0,0,0,18834,203,44,6.8,True,28.97235,-987,1,0,231,247,-16
BR1_2706328698,11,False,0,1,0,20112,207,44,7.4,False,16,True,1,0,0,21531,216,68,7.6,True,27.528166666666667,-1419,-5,-1,251,284,-33
BR1_2704075833,4,True,0,0,0,14749,181,44,6.6,True,6,False,1,0,0,14154,140,50,6.6,False,26.395783333333334,595,-2,-1,225,190,35
BR1_2731627418,7,False,1,0,0,17071,164,60,7.0,True,7,True,0,0,0,17303,200,36,6.4,False,29.641033333333333,-232,0,1,224,236,-12
BR1_2704697154,9,False,1,0,0,17540,200,56,7.4,True,7,True,0,1,0,17146,187,40,7.0,False,29.830016666666666,394,2,1,256,227,29
BR1_2718580432,4,False,0,0,0,15334,178,36,6.8,False,9,True,1,0,0,18955,216,64,7.2,True,29.43995,-3621,-5,-1,214,280,-66
BR1_2731761270,6,False,0,1,0,16478,206,52,7.4,True,3,True,1,0,0,13074,169,36,6.8,False,27.049416666666666,3404,3,-1,258,205,53
BR1_2731246583,8,False,0,1,0,17372,196,48,7.2,False,8,True,1,0,0,17768,191,64,7.4,True,29.368216666666665,-396,0,-1,244,255,-11
BR1_2723582936,5,True,0,0,0,14690,141,45,6.4,False,4,False,1,1,0,14942,175,54,6.4,True,27.030416666666667,-252,1,-1,186,229,-43
BR1_2721840603,10,True,0,0,0,18199,246,48,7.4,False,6,False,1,0,0,17162,209,56,7.4,True,29.471466666666668,1037,4,-1,294,265,29
BR1_2701724804,3,True,0,0,0,13793,155,48,6.8,False,3,False,1,0,0,15084,210,60,7.0,True,26.539483333333333,-1291,0,-1,203,270,-67
BR1_2730234752,9,True,0,0,0,18561,224,60,7.4,False,7,False,1,1,0,16884,185,68,7.2,True,28.24805,1677,2,-1,284,253,31
BR1_2731068131,8,False,0,0,0,17095,188,56,7.6,False,5,True,1,0,0,16709,215,56,7.2,True,29.630783333333333,386,3,-1,244,271,-27
BR1_2729060748,7,False,1,0,0,17379,202,48,7.2,True,3,True,0,0,0,14664,178,40,6.8,False,28.43105,2715,4,1,250,218,32
BR1_2728510561,7,False,1,0,0,16565,186,58,6.8,True,9,True,0,0,0,17110,169,41,7.0,False,26.46595,-545,-2,1,244,210,34
BR1_2713563308,5,False,0,1,0,14838,189,48,6.6,False,6,True,1,0,0,16101,197,72,6.6,True,26.2494,-1263,-1,-1,237,269,-32
BR1_2730742029,8,True,1,0,0,17986,211,52,6.8,True,10,False,0,1,0,17946,184,35,7.0,False,27.705883333333333,40,-2,1,263,219,44
BR1_2725577564,6,False,1,0,0,16928,198,56,6.8,True,2,True,0,0,0,13634,183,40,6.6,False,25.123483333333333,3294,4,1,254,223,31
BR1_2725508352,7,False,1,0,0,16588,198,64,6.8,True,6,True,0,0,0,15733,185,40,6.8,False,26.672,855,1,1,262,225,37
BR1_2684643128,7,True,1,0,0,16395,171,44,6.8,False,10,False,0,1,0,19023,227,52,7.6,True,27.592816666666668,-2628,-3,1,215,279,-64
BR1_2722846193,9,False,0,1,0,17507,189,60,7.0,True,6,True,0,0,0,14394,165,36,6.0,False,26.925366666666665,3113,3,0,249,201,48
BR1_2719172196,6,False,1,0,0,15013,148,42,6.4,False,10,True,0,0,0,18029,194,65,6.8,True,25.28473333333333,-3016,-4,1,190,259,-69
BR1_2713004072,5,False,0,1,0,16249,152,67,6.4,False,11,True,0,0,0,19650,219,48,7.0,True,28.627083333333335,-3401,-6,0,219,267,-48
BR1_2731610550,7,False,1,0,0,15939,211,36,7.0,False,8,True,0,1,0,18349,216,60,7.2,True,27.847133333333332,-2410,-1,1,247,276,-29
BR1_2731226381,6,True,0,1,0,16894,190,36,6.8,False,6,False,1,0,0,16958,219,64,7.6,True,28.805316666666666,-64,0,-1,226,283,-57
BR1_2731166798,3,False,0,1,0,14347,162,60,6.4,True,2,True,1,0,0,13290,181,33,6.4,False,27.3463,1057,1,-1,222,214,8
BR1_2725806857,6,True,0,0,0,15142,171,32,6.4,False,5,False,0,0,0,16200,202,55,6.6,True,25.579983333333335,-1058,1,0,203,257,-54
BR1_2729872178,7,True,0,1,0,16232,181,40,6.8,True,6,False,1,0,0,15585,155,52,6.8,False,26.5924,647,1,-1,221,207,14
BR1_2731611729,8,False,1,1,0,17763,189,61,7.0,True,5,True,0,0,0,15378,180,28,6.6,False,26.594783333333332,2385,3,1,250,208,42
BR1_2731017638,7,True,0,0,0,15743,176,42,6.2,False,6,False,0,0,0,15238,176,44,6.2,True,25.854233333333333,505,1,0,218,220,-2
BR1_2731282491,7,False,0,1,0,17516,206,52,7.0,True,9,True,1,0,0,18149,204,48,7.2,False,29.6057,-633,-2,-1,258,252,6
BR1_2731802292,14,False,1,1,0,21407,228,56,7.6,False,9,True,0,0,0,20050,223,52,7.0,True,28.136,1357,5,1,284,275,9
BR1_2729446866,11,True,1,0,0,18343,195,52,7.0,True,6,False,0,0,0,15612,172,56,6.8,False,26.19885,2731,5,1,247,228,19
BR1_2729752238,11,True,1,1,1,20242,224,64,7.4,True,2,False,0,0,0,13191,177,36,6.2,False,26.4188,7051,9,1,288,213,75
BR1_2728054436,5,False,0,0,0,16752,222,48,6.8,True,6,True,0,0,0,16477,199,36,7.2,False,27.758666666666667,275,-1,0,270,235,35
BR1_2717280593,7,True,0,0,0,16118,216,48,6.8,False,7,False,0,0,0,15642,162,40,6.4,True,25.308133333333334,476,0,0,264,202,62
BR1_2731305812,7,False,0,0,0,17270,188,52,7.2,True,8,True,1,1,0,16380,198,44,6.6,False,27.25645,890,-1,-1,240,242,-2
BR1_2695246998,9,False,1,1,0,17622,166,68,7.0,False,15,True,0,0,0,21892,226,48,7.6,True,29.681933333333333,-4270,-6,1,234,274,-40
BR1_2731622925,2,False,1,0,0,13676,165,60,6.4,False,9,True,0,0,0,17112,197,52,7.0,True,26.741866666666667,-3436,-7,1,225,249,-24
BR1_2728406842,11,True,1,0,0,19443,197,64,7.0,True,6,False,0,0,0,16853,181,48,6.8,False,29.60108333333333,2590,5,1,261,229,32
BR1_2693933988,11,True,0,1,0,16479,137,50,6.4,False,5,False,0,0,0,15115,150,53,6.4,True,26.2477,1364,6,0,187,203,-16
BR1_2693904706,7,True,1,0,0,17585,220,62,7.6,True,4,False,0,1,0,15477,174,51,7.0,False,28.152866666666668,2108,3,1,282,225,57
BR1_2693887492,3,False,1,0,0,14494,196,48,6.8,False,5,True,0,0,0,14657,205,40,6.8,True,26.9661,-163,-2,1,244,245,-1
BR1_2693463743,7,True,0,1,0,17510,238,35,7.4,True,4,False,0,0,0,15558,181,56,7.0,False,27.905133333333332,1952,3,0,273,237,36
BR1_2731476260,8,False,1,0,0,16572,181,57,6.8,True,7,True,0,0,0,16782,185,46,6.8,False,26.487933333333334,-210,1,1,238,231,7
BR1_2731459832,5,False,0,1,0,15778,194,48,6.8,False,5,True,0,0,0,16024,226,56,7.2,True,25.579283333333333,-246,0,0,242,282,-40
BR1_2731585723,2,True,1,1,0,14521,174,55,6.6,True,4,False,0,0,0,15883,218,60,6.6,False,26.163516666666666,-1362,-2,1,229,278,-49
BR1_2731554313,3,False,1,0,0,15893,232,49,7.2,False,6,True,0,1,0,18285,259,50,7.2,True,28.064316666666667,-2392,-3,1,281,309,-28
BR1_2731745343,9,True,1,0,0,17391,192,40,6.6,True,4,False,0,0,0,13824,174,31,6.2,False,26.7687,3567,5,1,232,205,27
BR1_2731716861,6,True,1,0,0,17427,221,64,7.2,True,3,False,0,1,0,16125,175,56,6.8,False,28.087883333333334,1302,3,1,285,231,54
BR1_2726057671,6,False,0,1,1,18632,219,48,7.2,True,3,True,0,0,0,14966,206,68,7.0,False,27.61081666666667,3666,3,0,267,274,-7
BR1_2722786061,6,True,1,1,0,16752,169,56,7.0,True,12,False,0,0,0,19048,207,50,7.6,False,29.11545,-2296,-6,1,225,257,-32
BR1_2731593231,10,False,1,1,0,17371,192,51,7.2,True,5,True,0,0,0,14870,176,60,6.2,False,26.694483333333334,2501,5,1,243,236,7
BR1_2731576236,7,True,0,0,0,16972,176,60,6.6,True,5,False,0,1,0,15737,160,56,6.6,False,27.145933333333332,1235,2,0,236,216,20
BR1_2677799178,6,True,1,0,0,17990,237,44,7.4,False,8,False,0,1,1,20569,238,67,7.6,True,28.11691666666667,-2579,-2,1,281,305,-24
BR1_2731044165,8,True,1,0,0,16048,198,48,6.8,True,6,False,0,1,0,16033,180,51,6.4,False,25.993216666666665,15,2,1,246,231,15
BR1_2731687616,7,True,0,1,0,16182,159,44,6.6,False,9,False,0,0,1,18443,165,51,7.0,True,27.406966666666666,-2261,-2,0,203,216,-13
BR1_2731861425,10,False,0,0,0,17477,174,72,7.0,False,10,True,1,0,0,17316,224,40,7.0,True,25.75075,161,0,-1,246,264,-18
BR1_2729132975,7,True,0,0,0,17892,192,48,7.0,False,10,False,1,0,0,17746,217,44,7.0,True,28.70735,146,-3,-1,240,261,-21
BR1_2715329005,16,True,0,0,0,20545,220,52,6.8,True,10,False,1,0,0,17236,153,40,6.4,False,26.968933333333332,3309,6,-1,272,193,79
BR1_2730886774,8,True,0,0,0,18588,200,52,7.2,False,7,False,0,0,0,16974,189,48,6.8,True,27.876583333333333,1614,1,0,252,237,15
BR1_2730289621,8,False,1,0,0,15631,179,48,7.0,False,7,True,0,0,0,16391,221,38,6.6,True,26.79765,-760,1,1,227,259,-32
BR1_2725238513,9,True,0,1,0,17873,181,51,6.8,True,9,False,1,0,0,18846,200,60,7.2,False,27.522566666666666,-973,0,-1,232,260,-28
BR1_2724875135,12,True,0,0,0,18081,198,36,6.6,True,7,False,0,0,0,15153,150,44,6.2,False,26.454883333333335,2928,5,0,234,194,40
BR1_2729497472,13,True,1,0,0,18074,157,52,6.2,True,6,False,0,0,0,14979,166,44,6.2,False,25.908566666666665,3095,7,1,209,210,-1
BR1_2729468975,10,True,0,0,0,18754,210,47,7.2,False,6,False,1,1,0,16742,177,40,7.0,True,29.582283333333333,2012,4,-1,257,217,40
BR1_2729201664,9,False,0,0,1,19960,172,48,7.4,False,12,True,1,1,0,20028,189,64,7.2,True,28.06325,-68,-3,-1,220,253,-33
BR1_2731338732,8,True,0,0,0,16032,173,40,6.8,False,4,False,0,0,0,15783,193,60,6.8,True,26.28226666666667,249,4,0,213,253,-40
BR1_2731580446,11,True,1,0,0,19562,219,60,7.2,False,7,False,0,0,0,16929,212,44,7.0,True,29.015966666666667,2633,4,1,279,256,23
BR1_2730706184,3,False,0,0,0,14941,203,48,6.8,False,4,True,0,0,0,15070,184,52,6.6,True,27.352816666666666,-129,-1,0,251,236,15
BR1_2730678795,11,False,0,0,0,18191,199,44,7.2,False,7,True,0,0,0,17418,190,72,7.0,True,27.953766666666667,773,4,0,243,262,-19
BR1_2730655768,10,False,0,0,0,17973,189,43,7.0,False,6,True,0,0,0,17866,213,40,7.2,True,29.157816666666665,107,4,0,232,253,-21
BR1_2731184734,4,False,0,0,0,15530,183,48,7.4,False,6,True,1,1,0,17972,266,62,7.4,True,28.19375,-2442,-2,-1,231,328,-97
BR1_2673367527,5,True,0,0,0,16187,186,56,7.0,True,5,False,1,0,0,16585,194,60,7.2,False,28.234166666666667,-398,0,-1,242,254,-12
BR1_2673314903,13,True,0,0,0,19066,177,44,6.8,True,8,False,1,0,0,15829,172,52,7.0,False,25.990966666666665,3237,5,-1,221,224,-3
BR1_2731540950,10,True,1,0,0,18581,194,52,7.4,True,6,False,0,0,0,16316,214,52,7.0,False,29.036083333333334,2265,4,1,246,266,-20
BR1_2731229712,10,True,0,0,0,19300,247,52,7.4,True,4,False,0,0,0,16290,194,44,7.0,False,29.907516666666666,3010,6,0,299,238,61
BR1_2731208345,4,True,0,0,0,15456,185,40,6.4,True,13,False,0,0,0,18981,200,40,7.0,False,25.644283333333334,-3525,-9,0,225,240,-15
BR1_2691512567,6,True,1,1,0,16488,220,52,7.0,True,3,False,0,0,0,14651,198,60,6.6,False,27.3062,1837,3,1,272,258,14
BR1_2729785718,9,True,0,0,0,17572,219,48,6.8,True,5,False,1,0,0,15255,202,48,6.6,False,27.12848333333333,2317,4,-1,267,250,17
BR1_2727462468,7,False,1,0,0,15677,165,48,6.6,True,8,True,0,0,0,16874,176,44,6.6,False,25.381666666666668,-1197,-1,1,213,220,-7
BR1_2731834948,5,False,1,0,0,15881,184,56,6.6,True,9,True,0,0,0,15700,163,40,6.2,False,26.024516666666667,181,-4,1,240,203,37
BR1_2730260404,3,False,0,0,0,13745,148,44,6.4,False,9,True,1,0,0,17787,191,56,7.2,True,26.675883333333335,-4042,-6,-1,192,247,-55
BR1_2730642754,4,True,0,0,0,14047,166,35,6.4,False,6,False,1,1,0,16888,180,56,7.0,True,26.28845,-2841,-2,-1,201,236,-35
BR1_2730172813,5,False,0,0,0,15161,191,48,6.8,True,8,True,0,0,0,16073,205,36,6.8,False,27.009316666666667,-912,-3,0,239,241,-2
BR1_2720718903,10,False,0,0,0,17948,152,52,7.0,False,14,True,1,1,0,20992,193,48,7.2,True,27.690283333333333,-3044,-4,-1,204,241,-37
BR1_2730000872,17,True,1,1,0,19986,166,76,7.4,True,7,False,0,0,0,16461,183,60,7.0,False,27.928466666666665,3525,10,1,242,243,-1
BR1_2691973772,13,True,1,0,0,19383,200,60,7.6,True,9,False,0,1,0,17382,167,52,6.8,False,29.315283333333333,2001,4,1,260,219,41
BR1_2707985301,5,True,1,1,0,15984,181,52,6.6,False,4,False,0,0,0,16661,217,64,7.2,True,29.614316666666667,-677,1,1,233,281,-48
BR1_2689641970,4,False,0,0,0,14380,182,56,6.8,False,8,True,1,0,0,17295,205,48,6.8,True,25.197183333333335,-2915,-4,-1,238,253,-15
BR1_2681986636,2,True,0,0,0,14407,201,68,6.8,False,8,False,1,0,0,16097,189,65,7.2,True,26.867483333333332,-1690,-6,-1,269,254,15
BR1_2730788861,8,False,1,0,0,15773,202,36,6.6,False,13,True,0,0,0,19288,195,44,7.0,True,29.60435,-3515,-5,1,238,239,-1
BR1_2670758183,6,False,0,1,0,17662,218,68,7.4,True,4,True,1,0,0,16700,256,63,7.4,False,28.543283333333335,962,2,-1,286,319,-33
BR1_2670732782,4,True,0,0,0,15334,211,52,6.8,False,6,False,1,1,0,15769,198,64,7.4,True,25.32415,-435,-2,-1,263,262,1
BR1_2687578546,11,True,0,1,0,18394,161,56,6.8,True,5,False,0,0,0,15475,173,42,7.0,False,28.656933333333335,2919,6,0,217,215,2
BR1_2687530540,5,False,0,1,0,16486,191,64,7.6,False,3,True,0,0,0,15614,234,48,7.0,True,27.8267,872,2,0,255,282,-27
BR1_2707005376,4,True,0,1,0,15293,180,64,7.0,True,7,False,1,0,0,17785,212,72,7.4,False,27.410416666666666,-2492,-3,-1,244,284,-40
BR1_2725234017,9,False,1,0,0,17575,177,50,7.0,True,13,True,0,1,0,22019,203,70,7.6,False,28.79845,-4444,-4,1,227,273,-46
BR1_2731609151,3,True,0,0,0,14757,185,44,6.8,False,9,False,1,1,0,19680,249,64,7.6,True,28.352633333333333,-4923,-6,-1,229,313,-84
BR1_2718261638,8,True,0,0,0,17987,204,60,7.0,True,8,False,1,0,0,17967,204,59,7.0,False,28.715566666666668,20,0,-1,264,263,1
BR1_2726194223,5,True,0,0,0,16213,168,51,7.0,False,9,False,1,0,0,17128,202,55,7.2,True,29.91465,-915,-4,-1,219,257,-38
BR1_2726168361,4,True,1,0,0,15385,191,48,6.6,False,7,False,0,0,0,15990,182,48,6.8,True,26.563666666666666,-605,-3,1,239,230,9
BR1_2723821491,8,True,0,0,0,14825,135,48,6.0,False,12,False,1,1,0,16402,146,43,6.2,True,26.928633333333334,-1577,-4,-1,183,189,-6
BR1_2730027130,11,True,1,1,0,19518,226,72,7.4,True,8,False,0,0,0,18234,211,60,7.4,False,28.71595,1284,3,1,298,271,27
BR1_2730878762,7,True,0,1,0,17035,202,60,7.0,True,7,False,0,0,0,14162,151,40,6.2,False,25.460316666666667,2873,0,0,262,191,71
BR1_2731751472,6,False,1,0,0,18246,211,56,7.2,False,10,True,0,0,0,19052,189,60,7.2,True,29.57375,-806,-4,1,267,249,18
BR1_2731539437,8,False,1,0,0,16357,212,45,7.0,True,3,True,0,0,0,15005,188,70,7.0,False,26.477,1352,5,1,257,258,-1
BR1_2671091103,5,True,0,0,0,17011,230,52,6.8,True,4,False,1,0,0,14695,183,55,6.4,False,25.096533333333333,2316,1,-1,282,238,44
BR1_2731803145,8,True,0,1,0,19192,237,72,7.2,True,3,False,0,0,0,16278,224,52,7.0,False,28.08415,2914,5,0,309,276,33
BR1_2712362320,9,True,1,0,0,17609,159,69,7.0,True,5,False,0,0,0,15509,193,48,6.8,False,25.693633333333334,2100,4,1,228,241,-13
BR1_2707306707,14,False,1,0,0,21006,234,40,7.6,True,6,True,0,0,0,17366,218,56,6.8,False,28.195933333333333,3640,8,1,274,274,0
BR1_2691685043,4,False,0,0,0,15575,216,51,7.0,False,10,True,1,0,0,18000,204,52,7.0,True,29.954733333333333,-2425,-6,-1,267,256,11
BR1_2728908498,7,False,0,0,0,18300,191,56,7.2,True,9,True,0,0,0,18982,226,55,7.4,False,28.639716666666665,-682,-2,0,247,281,-34
BR1_2729959509,6,False,0,0,0,13624,146,44,6.4,False,12,True,0,0,0,19076,192,56,7.0,True,25.174916666666668,-5452,-6,0,190,248,-58
BR1_2729936859,7,True,1,1,0,17087,172,52,6.8,False,6,False,0,0,0,15270,169,44,7.0,True,26.319816666666668,1817,1,1,224,213,11
BR1_2726800794,5,False,0,0,0,16553,195,44,6.6,False,12,True,0,1,0,18190,229,52,7.0,True,26.780116666666668,-1637,-7,0,239,281,-42
BR1_2673200816,6,False,0,1,0,15699,177,52,7.2,True,7,True,0,0,0,15757,163,43,7.0,False,26.5253,-58,-1,0,229,206,23
BR1_2731613806,9,True,1,1,0,18318,221,44,7.0,True,5,False,0,0,0,16449,197,48,7.0,False,29.394116666666665,1869,4,1,265,245,20
BR1_2690842230,8,True,1,0,0,16440,195,60,7.0,True,5,False,0,0,0,14369,183,38,6.6,False,26.396816666666666,2071,3,1,255,221,34
BR1_2690301852,10,True,1,0,0,17926,207,40,7.2,True,2,False,0,1,0,15633,197,40,6.8,False,28.598083333333335,2293,8,1,247,237,10
BR1_2705586786,13,True,1,0,0,19532,211,39,7.0,False,10,False,0,0,0,19511,198,48,7.2,True,28.2583,21,3,1,250,246,4
BR1_2689036835,3,False,1,1,0,16333,222,56,7.4,False,4,True,0,0,0,16318,225,60,7.6,True,28.1071,15,-1,1,278,285,-7
BR1_2696775259,3,False,1,0,0,14142,176,60,6.6,False,9,True,0,0,0,16877,197,44,6.6,True,27.18565,-2735,-6,1,236,241,-5
BR1_2718672871,15,False,1,1,0,20752,198,64,7.4,True,5,True,0,0,0,17167,215,56,6.8,False,29.712416666666666,3585,10,1,262,271,-9
BR1_2718628158,12,False,0,0,0,17402,198,48,6.8,False,12,True,1,0,0,18268,170,56,6.8,True,26.624433333333332,-866,0,-1,246,226,20
BR1_2682456141,6,True,0,0,0,15328,183,48,6.6,True,4,False,0,0,0,14899,189,48,6.8,False,26.1028,429,2,0,231,237,-6
BR1_2727551112,6,False,1,0,0,16892,224,60,7.6,True,2,True,0,1,0,16384,242,56,7.4,False,27.8859,508,4,1,284,298,-14
BR1_2727525776,6,True,1,0,0,15812,188,64,7.2,True,1,False,0,1,0,14470,239,44,6.8,False,25.452483333333333,1342,5,1,252,283,-31
BR1_2726917648,8,True,0,0,0,18194,235,68,7.6,True,6,False,0,0,0,17541,229,68,7.4,False,28.5406,653,2,0,303,297,6
BR1_2730065371,6,True,0,0,0,14834,167,36,6.6,False,8,False,1,0,0,16901,194,60,6.8,True,26.028066666666668,-2067,-2,-1,203,254,-51
BR1_2714683791,4,True,0,0,0,15006,179,56,6.6,False,8,False,1,0,0,16486,191,59,7.0,True,27.053,-1480,-4,-1,235,250,-15
BR1_2726233041,9,True,1,0,1,18076,221,42,7.2,True,2,False,0,0,0,13133,158,48,6.6,False,26.299083333333332,4943,7,1,263,206,57
BR1_2730980825,7,True,1,0,0,15453,185,56,6.6,True,5,False,0,1,0,14622,136,44,6.2,False,26.10246666666667,831,2,1,241,180,61
BR1_2731595541,7,True,0,1,0,17606,197,52,7.0,False,10,False,0,0,0,18100,187,52,7.0,True,28.140483333333332,-494,-3,0,249,239,10
BR1_2731594716,10,False,0,1,0,18496,177,57,7.2,True,5,True,1,0,0,16119,172,68,7.2,False,29.0165,2377,5,-1,234,240,-6
BR1_2730939968,14,False,1,0,0,20053,218,60,7.6,True,6,True,1,1,0,15677,165,51,7.0,False,29.58705,4376,8,0,278,216,62
BR1_2673813854,6,False,0,0,0,14407,141,44,6.2,False,5,True,1,0,0,16124,198,76,7.2,True,25.930616666666666,-1717,1,-1,185,274,-89
BR1_2703278523,6,True,0,0,0,15275,183,48,6.4,False,8,False,1,0,0,16434,185,48,6.6,True,25.667583333333333,-1159,-2,-1,231,233,-2
BR1_2703039632,7,True,0,0,0,16610,200,60,6.4,False,12,False,1,1,0,18581,180,56,7.0,True,26.209533333333333,-1971,-5,-1,260,236,24
BR1_2728857653,9,True,0,0,0,19119,234,68,7.4,True,7,False,1,0,0,18069,209,52,7.0,False,29.1057,1050,2,-1,302,261,41
BR1_2728577874,13,True,0,0,0,18954,179,69,7.2,True,5,False,0,0,0,14510,169,50,6.4,False,27.47735,4444,8,0,248,219,29
BR1_2727539230,4,False,0,1,0,16783,212,48,7.2,True,12,True,1,0,0,19477,206,60,7.6,False,28.384066666666666,-2694,-8,-1,260,266,-6
BR1_2730970314,8,False,0,0,0,17535,204,48,7.6,False,6,True,1,1,0,17477,202,56,7.2,True,29.057266666666667,58,2,-1,252,258,-6
BR1_2725711564,3,False,0,0,0,14250,187,40,6.6,False,9,True,1,0,0,17426,183,52,6.6,True,26.913933333333333,-3176,-6,-1,227,235,-8
BR1_2717915171,12,True,0,0,0,21935,204,67,7.6,False,14,False,1,1,0,21541,215,80,7.2,True,28.0577,394,-2,-1,271,295,-24
BR1_2717890647,3,False,0,0,0,13852,174,60,6.8,False,4,True,1,0,0,17085,226,60,7.2,True,25.83515,-3233,-1,-1,234,286,-52
BR1_2717873483,7,False,1,0,0,16931,206,60,7.2,True,8,True,0,0,0,15893,183,52,7.0,False,26.19086666666667,1038,-1,1,266,235,31
BR1_2731146883,8,False,0,1,1,20053,250,42,7.2,True,10,True,1,0,0,19236,194,73,7.0,False,28.67181666666667,817,-2,-1,292,267,25
BR1_2725980103,4,False,0,0,0,16417,236,54,7.0,False,9,True,1,1,0,19455,202,76,7.4,True,28.57196666666667,-3038,-5,-1,290,278,12
BR1_2731713442,13,True,1,1,0,21275,232,60,7.6,True,6,False,0,0,0,16335,192,52,7.0,False,27.905683333333332,4940,7,1,292,244,48
BR1_2731689273,9,True,1,1,0,18093,188,52,6.8,True,9,False,0,0,0,17812,178,52,6.6,False,27.02285,281,0,1,240,230,10
BR1_2731191045,3,True,1,0,0,14659,182,56,6.6,False,10,False,0,1,0,17243,193,36,6.6,True,25.73295,-2584,-7,1,238,229,9
BR1_2730738146,15,True,1,0,0,20028,213,48,7.0,True,6,False,0,0,0,15030,176,47,6.8,False,26.629683333333332,4998,9,1,261,223,38
BR1_2728723620,6,False,0,1,0,16925,218,52,6.8,False,6,True,0,0,0,16842,207,64,6.8,True,26.191783333333333,83,0,0,270,271,-1
BR1_2728715342,7,True,1,0,0,16237,168,51,6.6,True,4,False,0,0,0,14703,170,44,6.4,False,25.633733333333332,1534,3,1,219,214,5
BR1_2731095751,14,True,0,0,0,19264,200,39,6.8,False,7,False,0,0,0,15942,164,56,6.4,True,27.412133333333333,3322,7,0,239,220,19
BR1_2731729413,8,True,1,1,0,17334,197,52,7.2,False,8,False,0,0,0,17238,210,56,7.2,True,26.841216666666668,96,0,1,249,266,-17
BR1_2729361738,8,True,1,0,0,16321,182,44,7.0,True,10,False,0,0,0,18191,204,68,7.8,False,27.792466666666666,-1870,-2,1,226,272,-46
BR1_2727149063,11,True,0,0,0,18572,182,48,7.2,False,8,False,0,0,0,18128,198,60,7.2,True,29.611933333333333,444,3,0,230,258,-28
BR1_2730221793,11,True,1,1,0,19826,216,44,7.2,True,6,False,0,0,0,16759,170,55,6.8,False,29.680533333333333,3067,5,1,260,225,35
BR1_2730098080,3,True,0,0,0,14937,200,45,7.0,False,6,False,0,1,0,17858,201,59,7.2,True,29.120083333333334,-2921,-3,0,245,260,-15
BR1_2730383948,11,False,0,1,0,17458,175,60,7.0,True,5,True,1,0,0,14356,165,36,6.4,False,26.816916666666668,3102,6,-1,235,201,34
BR1_2717034191,10,True,0,0,0,17757,173,40,6.6,False,14,False,1,0,0,20083,181,64,7.0,True,27.6261,-2326,-4,-1,213,245,-32
BR1_2717016016,8,True,0,1,0,18613,221,48,7.0,False,9,False,1,0,0,17978,162,52,7.4,True,27.864316666666667,635,-1,-1,269,214,55
BR1_2729251939,14,False,1,0,1,21501,222,68,7.4,True,8,True,0,0,0,17840,146,44,6.6,False,29.025866666666666,3661,6,1,290,190,100
BR1_2726286963,6,True,1,0,0,15436,170,52,6.8,True,5,False,0,0,0,14757,178,48,6.8,False,25.530516666666667,679,1,1,222,226,-4
BR1_2723712709,4,True,0,0,0,14170,164,47,6.4,False,4,False,0,0,0,15976,214,47,6.8,True,27.13015,-1806,0,0,211,261,-50
BR1_2672299812,4,False,0,0,0,16464,192,52,7.2,True,5,True,0,0,0,16370,199,52,7.4,False,27.5334,94,-1,0,244,251,-7
BR1_2670779955,7,False,1,0,0,15356,172,48,6.8,True,8,True,0,1,0,16550,168,48,7.0,False,26.797333333333334,-1194,-1,1,220,216,4
BR1_2730627571,7,True,0,0,0,17308,234,44,7.4,True,6,False,0,1,0,17760,214,52,7.2,False,28.540616666666665,-452,1,0,278,266,12
BR1_2717159549,12,False,0,0,0,19127,191,60,6.8,True,12,True,1,0,0,18571,166,44,6.2,False,26.953033333333334,556,0,-1,251,210,41
BR1_2706149748,11,True,0,1,1,20300,220,47,7.6,True,5,False,1,0,0,17031,202,68,7.4,False,28.213466666666665,3269,6,-1,267,270,-3
BR1_2731717916,3,False,0,0,0,13719,150,48,6.2,False,4,True,1,0,0,14423,173,56,6.2,True,25.822133333333333,-704,-1,-1,198,229,-31
BR1_2730759335,7,False,1,0,0,15606,166,71,7.0,True,2,True,0,0,0,13666,195,56,6.8,False,25.994333333333334,1940,5,1,237,251,-14
BR1_2730733184,9,False,0,0,0,16758,156,44,7.0,False,8,True,1,0,0,16648,183,52,6.8,True,27.465233333333334,110,1,-1,200,235,-35
BR1_2721020595,10,False,0,1,0,19118,178,52,7.0,True,13,True,1,0,0,18758,201,44,7.2,False,28.314316666666667,360,-3,-1,230,245,-15
BR1_2720541138,4,False,1,1,0,13049,122,44,6.0,False,9,True,0,0,0,17778,175,44,6.6,True,26.94461666666667,-4729,-5,1,166,219,-53
BR1_2698152301,7,False,0,0,0,16226,192,48,6.4,False,16,True,1,0,0,20255,173,51,6.6,True,27.020816666666665,-4029,-9,-1,240,224,16
BR1_2726267191,4,False,1,0,0,14769,211,50,6.8,True,6,True,0,1,0,17358,240,40,6.8,False,26.607266666666668,-2589,-2,1,261,280,-19
BR1_2725765066,13,True,0,0,0,20645,251,64,7.4,True,5,False,0,0,0,14912,198,44,6.6,False,26.9301,5733,8,0,315,242,73
BR1_2719719032,10,True,1,0,0,17596,171,56,6.6,True,4,False,0,0,0,14700,165,56,6.2,False,25.1817,2896,6,1,227,221,6
BR1_2719343905,7,True,0,0,0,17978,208,48,7.2,True,7,False,1,0,0,17271,197,56,7.2,False,29.485016666666667,707,0,-1,256,253,3
BR1_2727466454,7,True,1,0,0,17504,246,52,7.4,True,4,False,0,0,0,16090,181,68,7.6,False,29.350616666666667,1414,3,1,298,249,49
BR1_2731045571,5,False,1,0,0,16659,207,56,7.2,True,7,True,0,0,0,17017,189,40,7.2,False,29.747283333333332,-358,-2,1,263,229,34
BR1_2717854416,1,False,0,0,0,13717,202,47,6.6,False,5,True,1,0,0,15548,195,59,6.8,True,25.978433333333335,-1831,-4,-1,249,254,-5
BR1_2717834802,9,False,1,0,0,17771,182,52,7.2,True,6,True,0,0,0,16351,191,40,7.2,False,29.7124,1420,3,1,234,231,3
BR1_2730522483,8,True,0,0,0,16732,182,40,6.6,False,11,False,0,0,0,18432,178,52,7.0,True,27.3505,-1700,-3,0,222,230,-8
BR1_2730494871,11,False,0,0,0,17498,190,68,7.0,False,9,True,0,0,0,18340,209,60,7.0,True,27.10465,-842,2,0,258,269,-11
BR1_2725034744,3,False,0,1,0,13775,186,48,6.4,True,4,True,1,0,0,14289,165,57,6.6,False,27.1245,-514,-1,-1,234,222,12
BR1_2725007795,3,False,0,0,0,15524,190,63,7.2,False,6,True,1,1,0,18003,219,68,7.4,True,29.069966666666666,-2479,-3,-1,253,287,-34
BR1_2724586697,8,False,1,0,0,17461,175,52,7.0,False,10,True,0,0,0,17774,188,44,7.0,True,27.73375,-313,-2,1,227,232,-5
BR1_2724539495,5,False,0,0,0,16488,198,68,7.2,False,6,True,0,0,0,17122,227,60,7.2,True,29.47875,-634,-1,0,266,287,-21
BR1_2719031542,4,False,0,0,0,15828,189,48,6.6,False,11,True,0,0,0,20023,233,44,7.6,True,29.57605,-4195,-7,0,237,277,-40
BR1_2687861786,14,False,1,1,0,21491,212,80,7.8,True,3,True,0,0,0,15121,177,60,6.8,False,29.141566666666666,6370,11,1,292,237,55
BR1_2686965729,5,True,0,0,0,14026,138,49,6.6,False,3,False,0,0,0,15760,222,46,7.0,True,25.214966666666665,-1734,2,0,187,268,-81
BR1_2731432986,4,False,0,1,0,16916,205,60,7.2,False,11,True,1,0,0,19949,192,68,6.8,True,27.625516666666666,-3033,-7,-1,265,260,5
BR1_2730765121,4,False,0,0,0,14411,194,40,6.6,False,9,True,1,1,0,16986,169,64,6.6,True,25.53135,-2575,-5,-1,234,233,1
BR1_2712749448,8,True,1,0,0,18669,230,72,7.6,True,5,False,0,1,0,16671,214,60,7.2,False,28.839166666666667,1998,3,1,302,274,28
BR1_2712740316,4,False,0,0,0,13909,158,36,6.4,False,6,True,1,1,0,17160,218,67,7.2,True,25.486816666666666,-3251,-2,-1,194,285,-91
BR1_2722433867,3,False,0,0,0,14464,183,44,6.8,False,8,True,0,0,0,17230,212,56,7.0,True,25.370566666666665,-2766,-5,0,227,268,-41
BR1_2721991450,7,False,1,0,0,15976,220,68,7.2,True,4,True,0,0,0,14670,170,51,7.0,False,27.130566666666667,1306,3,1,288,221,67
BR1_2725100330,14,True,0,1,0,19710,177,52,7.2,True,9,False,1,0,0,18770,206,48,7.0,False,28.297666666666668,940,5,-1,229,254,-25
BR1_2721611657,8,False,0,0,0,17540,198,64,7.0,True,3,True,1,0,0,15171,221,54,6.8,False,25.250433333333334,2369,5,-1,262,275,-13
BR1_2721595327,1,False,1,0,0,13577,182,64,6.6,False,5,True,0,0,0,16001,182,52,7.0,True,25.00405,-2424,-4,1,246,234,12
BR1_2705374293,4,True,0,1,0,17949,245,84,7.6,True,1,False,1,0,0,14142,187,60,7.2,False,29.051216666666665,3807,3,-1,329,247,82
BR1_2729381304,10,False,1,1,0,20063,218,64,7.8,True,7,True,0,0,0,18513,230,51,7.6,False,28.14475,1550,3,1,282,281,1
BR1_2729459980,6,False,0,0,0,16864,199,52,7.4,False,12,True,1,0,1,20426,211,52,7.4,True,27.941783333333333,-3562,-6,-1,251,263,-12
BR1_2728678248,2,False,0,0,0,13541,191,48,6.8,False,9,True,1,1,0,17824,187,64,7.2,True,25.613683333333334,-4283,-7,-1,239,251,-12
BR1_2726263627,6,True,0,0,0,15719,177,54,6.8,False,7,False,1,0,0,16420,207,69,7.2,True,25.501733333333334,-701,-1,-1,231,276,-45
BR1_2731792076,2,False,0,0,0,13833,170,64,7.0,False,9,True,1,1,0,19054,204,60,7.0,True,27.043116666666666,-5221,-7,-1,234,264,-30
BR1_2731550816,15,False,1,1,0,19511,159,58,7.0,True,8,True,0,0,0,17787,183,54,6.8,False,27.996716666666668,1724,7,1,217,237,-20
BR1_2731468550,8,True,1,0,0,16232,183,52,6.8,True,9,False,0,1,0,16928,153,56,6.8,False,26.537566666666667,-696,-1,1,235,209,26
BR1_2730434482,2,False,0,1,0,14066,195,52,7.0,False,3,True,1,0,0,14994,206,60,7.0,True,25.557483333333334,-928,-1,-1,247,266,-19
BR1_2716176237,3,True,0,0,0,16113,207,72,7.0,True,5,False,0,0,0,16882,245,44,7.2,False,29.68415,-769,-2,0,279,289,-10
BR1_2715698811,9,False,1,0,0,16688,176,52,6.8,True,4,True,0,0,0,15280,199,44,6.4,False,26.33665,1408,5,1,228,243,-15
BR1_2714528832,7,True,0,0,0,16663,195,47,6.8,True,2,False,0,0,0,14042,183,44,6.8,False,25.5579,2621,5,0,242,227,15
BR1_2729447820,12,True,1,0,0,18193,143,59,6.6,True,5,False,0,0,0,14007,125,59,5.4,False,25.670583333333333,4186,7,1,202,184,18
BR1_2731691726,6,False,1,0,0,16496,229,56,7.6,False,2,True,0,0,0,15403,227,64,7.4,True,29.10545,1093,4,1,285,291,-6
BR1_2731764288,9,False,1,0,0,17459,176,60,7.0,False,7,True,0,0,0,15624,173,40,6.4,True,26.796983333333333,1835,2,1,236,213,23
BR1_2686745539,6,False,1,0,0,15122,171,55,6.6,True,8,True,0,1,0,16053,169,52,6.6,False,26.973183333333335,-931,-2,1,226,221,5
BR1_2723530391,2,False,1,1,0,13424,172,52,6.6,False,12,True,0,0,0,19453,212,71,7.0,True,26.623566666666665,-6029,-10,1,224,283,-59
BR1_2728747176,7,False,0,0,0,15379,155,39,6.4,False,9,True,0,1,0,17153,162,48,6.8,True,25.93055,-1774,-2,0,194,210,-16
BR1_2716337159,7,True,1,0,0,18416,222,54,7.4,True,1,False,0,0,0,14793,231,41,7.0,False,29.590183333333332,3623,6,1,276,272,4
BR1_2729224616,8,True,1,0,0,15549,171,60,6.4,True,5,False,0,0,0,14357,161,52,6.4,False,25.558683333333335,1192,3,1,231,213,18
BR1_2729214794,7,True,0,1,0,16013,162,46,6.4,False,7,False,1,0,0,16219,176,55,6.8,True,25.558683333333335,-206,0,-1,208,231,-23
BR1_2728757490,7,True,0,0,0,17001,172,55,6.6,False,8,False,1,0,0,18129,211,52,7.2,True,28.645533333333333,-1128,-1,-1,227,263,-36
BR1_2703666601,5,True,1,0,0,15610,200,52,6.8,True,7,False,0,0,0,16434,212,48,7.0,False,27.30615,-824,-2,1,252,260,-8
BR1_2728758295,7,True,0,0,0,15617,167,44,6.8,False,4,False,1,0,0,14005,149,52,6.2,True,27.223333333333333,1612,3,-1,211,201,10
BR1_2728744449,5,True,1,0,0,15629,210,39,6.8,True,5,False,0,1,0,13939,142,54,6.6,False,25.221133333333334,1690,0,1,249,196,53
BR1_2731253696,3,False,0,1,0,16145,184,64,7.4,False,9,True,0,0,0,17783,219,40,7.6,True,29.11945,-1638,-6,0,248,259,-11
BR1_2729588786,8,False,0,0,0,16006,192,36,6.8,True,5,True,0,0,0,15987,226,48,6.6,False,27.094833333333334,19,3,0,228,274,-46
BR1_2730352684,7,False,1,0,0,16225,198,52,6.4,True,3,True,0,0,0,13951,160,48,6.6,False,25.811966666666667,2274,4,1,250,208,42
BR1_2711292806,8,False,0,1,0,16943,201,66,7.2,True,3,True,0,0,0,14102,196,48,6.6,False,25.159783333333333,2841,5,0,267,244,23
BR1_2721004119,9,True,1,0,0,17290,199,48,7.0,True,7,False,0,1,0,15968,175,60,7.0,False,29.3421,1322,2,1,247,235,12
BR1_2720990809,3,False,0,0,0,14026,153,52,6.2,False,13,True,1,0,1,20422,172,60,7.2,True,26.849183333333333,-6396,-10,-1,205,232,-27
BR1_2731863108,14,True,1,0,0,18711,205,56,7.0,True,4,False,0,0,0,13681,166,40,6.4,False,26.982333333333333,5030,10,1,261,206,55
BR1_2731539711,9,True,0,0,0,17116,157,48,6.4,False,11,False,0,1,0,18920,187,52,7.0,True,26.46905,-1804,-2,0,205,239,-34
BR1_2729708465,14,False,1,0,0,20555,214,60,7.4,True,5,True,0,0,0,16073,197,48,6.8,False,29.545916666666667,4482,9,1,274,245,29
BR1_2731871061,6,False,1,0,0,15549,186,56,6.4,True,5,True,0,1,0,14111,137,40,6.2,False,25.14245,1438,1,1,242,177,65
BR1_2731305831,7,False,0,0,0,15705,138,32,6.2,True,10,True,1,0,0,18688,210,52,6.8,False,27.3369,-2983,-3,-1,170,262,-92
BR1_2731785033,7,False,1,1,0,16692,211,64,7.2,True,2,True,0,0,0,13227,160,46,6.6,False,25.447483333333334,3465,5,1,275,206,69
BR1_2731464598,7,False,0,0,0,16645,152,52,6.6,False,10,True,1,0,0,18484,209,56,6.6,True,25.31785,-1839,-3,-1,204,265,-61
BR1_2731449908,3,False,0,0,0,15262,188,56,7.0,False,8,True,1,1,0,18433,230,52,7.6,True,28.186133333333334,-3171,-5,-1,244,282,-38
BR1_2695540556,9,True,0,0,0,18769,240,44,7.0,True,9,False,1,1,0,19075,201,52,7.0,False,28.24895,-306,0,-1,284,253,31
BR1_2697148474,10,True,1,0,0,18257,178,60,7.2,True,3,False,0,0,0,13519,170,48,6.4,False,25.587983333333334,4738,7,1,238,218,20
BR1_2729872644,7,True,1,1,0,17162,210,60,7.0,True,1,False,0,0,0,13395,181,56,6.6,False,25.643283333333333,3767,6,1,270,237,33
BR1_2729407770,7,False,1,0,0,17395,218,68,7.4,True,4,True,0,1,0,16369,213,56,7.4,False,28.88445,1026,3,1,286,269,17
BR1_2727496976,2,True,1,0,0,16607,250,70,7.6,True,4,False,0,1,0,17226,253,60,7.6,False,28.215133333333334,-619,-2,1,320,313,7
BR1_2729283662,6,True,1,1,0,13761,119,63,6.6,False,13,False,0,0,0,18291,214,40,7.0,True,26.687183333333333,-4530,-7,1,182,254,-72
BR1_2728287361,5,True,0,0,0,16668,211,44,7.0,True,2,False,1,0,0,14743,218,56,6.6,False,27.076516666666667,1925,3,-1,255,274,-19
BR1_2697809459,4,True,0,0,0,14515,220,20,6.2,False,5,False,1,1,0,14973,162,55,6.6,True,25.337283333333332,-458,-1,-1,240,217,23
BR1_2731769279,9,False,1,1,0,20368,250,76,7.6,True,6,True,0,0,0,17679,211,72,7.4,False,29.933133333333334,2689,3,1,326,283,43
BR1_2730740705,12,False,0,1,0,19830,205,60,7.0,False,15,True,0,0,0,21154,234,51,7.2,True,29.636683333333334,-1324,-3,0,265,285,-20
BR1_2723048214,4,False,1,0,0,14811,173,58,6.4,False,14,True,0,1,0,19275,163,60,7.0,True,25.7088,-4464,-10,1,231,223,8
BR1_2722829129,10,True,0,0,0,17935,199,32,6.8,False,10,False,1,0,0,19028,193,64,7.4,True,29.29755,-1093,0,-1,231,257,-26
BR1_2724585221,5,False,0,0,0,17403,220,44,6.6,False,10,True,1,1,0,19421,197,58,7.0,True,27.613116666666667,-2018,-5,-1,264,255,9
BR1_2730287115,6,True,0,0,0,14929,170,28,6.6,False,11,False,0,0,0,16168,169,40,6.4,True,27.13815,-1239,-5,0,198,209,-11
BR1_2731305552,10,True,1,1,0,19543,254,52,7.6,True,4,False,0,0,0,15664,161,53,7.2,False,29.179633333333335,3879,6,1,306,214,92
BR1_2726588345,5,True,0,0,0,14228,152,56,6.8,False,4,False,0,0,0,15705,199,48,7.0,True,26.709883333333334,-1477,1,0,208,247,-39
BR1_2731445664,4,True,1,0,0,16159,189,60,7.2,False,8,False,0,0,0,18256,220,68,7.2,True,29.197916666666668,-2097,-4,1,249,288,-39
BR1_2722451313,9,False,1,0,0,17916,201,52,7.0,True,4,True,0,0,0,15007,166,48,6.4,False,26.131433333333334,2909,5,1,253,214,39
BR1_2731434890,7,True,0,0,0,16256,163,44,6.6,False,9,False,1,0,0,17130,165,64,7.2,True,28.06165,-874,-2,-1,207,229,-22
BR1_2698414441,14,True,0,1,0,20672,209,64,7.8,True,4,False,1,0,0,15619,196,48,6.6,False,27.661683333333333,5053,10,-1,273,244,29
BR1_2698364320,13,True,0,0,0,19122,176,48,7.4,False,9,False,1,0,0,18245,188,67,7.0,True,28.5322,877,4,-1,224,255,-31
BR1_2698325159,9,False,1,1,1,20916,255,44,7.4,True,6,True,0,0,0,15932,186,44,7.2,False,28.930883333333334,4984,3,1,299,230,69
BR1_2720720687,0,False,0,0,0,13010,171,60,6.6,False,9,True,1,0,0,16634,186,72,7.0,True,25.659066666666668,-3624,-9,-1,231,258,-27
BR1_2724627364,9,True,0,1,0,17598,186,56,6.4,False,11,False,1,0,0,17732,186,40,7.0,True,25.340566666666668,-134,-2,-1,242,226,16
BR1_2729546131,7,True,1,0,0,16628,131,56,6.4,False,2,False,0,1,0,15111,186,64,6.6,True,28.5088,1517,5,1,187,250,-63
BR1_2730751241,5,True,0,0,0,15553,166,64,7.2,False,6,False,1,1,0,17612,202,60,7.4,True,28.8385,-2059,-1,-1,230,262,-32
BR1_2730594666,9,False,1,0,0,18164,198,44,6.6,True,12,True,0,1,0,20965,213,45,7.2,False,29.46015,-2801,-3,1,242,258,-16
BR1_2731869396,2,False,1,1,0,15477,217,60,7.2,False,7,True,0,0,0,17161,210,68,7.0,True,29.870716666666667,-1684,-5,1,277,278,-1
BR1_2731645138,4,False,1,0,0,14777,188,40,6.2,True,9,True,0,0,0,16422,166,44,6.4,False,26.130816666666668,-1645,-5,1,228,210,18
BR1_2731008788,5,True,0,1,0,15328,203,54,6.8,False,8,False,1,0,0,16443,178,52,6.8,True,27.463833333333334,-1115,-3,-1,257,230,27
BR1_2730292606,7,True,1,0,0,17360,232,56,7.6,True,3,False,0,0,0,15739,242,36,7.4,False,28.078733333333332,1621,4,1,288,278,10
BR1_2692033338,3,True,1,1,0,15913,219,68,7.2,True,2,False,0,0,0,16502,237,68,7.4,False,29.282066666666665,-589,1,1,287,305,-18
BR1_2730353640,9,True,1,1,0,19443,219,44,7.2,True,5,False,0,0,0,16408,224,64,7.6,False,28.804216666666665,3035,4,1,263,288,-25
BR1_2724533046,8,True,0,1,0,17331,187,40,6.8,True,3,False,1,0,0,13183,147,60,6.2,False,26.8429,4148,5,-1,227,207,20
BR1_2722948176,11,True,1,0,0,19084,223,50,7.2,False,6,False,0,1,0,18500,199,84,7.4,True,29.263966666666665,584,5,1,273,283,-10
BR1_2722786403,5,False,0,1,0,16805,185,64,6.6,True,6,True,0,0,0,15173,160,40,6.4,False,26.929183333333334,1632,-1,0,249,200,49
BR1_2723759633,16,True,0,1,0,20088,194,52,7.2,True,8,False,0,0,0,17999,199,40,6.8,False,29.56095,2089,8,0,246,239,7
BR1_2730988044,7,True,1,1,0,18926,240,76,7.8,True,3,False,0,0,0,15334,229,48,7.4,False,27.754616666666667,3592,4,1,316,277,39
BR1_2731257480,10,True,0,1,0,19360,231,52,7.2,True,4,False,1,0,0,15547,195,44,7.0,False,29.413683333333335,3813,6,-1,283,239,44
BR1_2731319301,4,False,0,0,0,15301,185,44,6.8,False,10,True,0,0,0,18725,220,52,7.4,True,27.814233333333334,-3424,-6,0,229,272,-43
BR1_2731295678,10,True,0,1,0,19230,205,46,7.2,True,5,False,1,0,0,16210,163,60,7.0,False,28.598466666666667,3020,5,-1,251,223,28
BR1_2731273538,8,True,0,0,0,17006,188,60,7.0,True,2,False,1,0,0,14189,191,40,6.6,False,27.107333333333333,2817,6,-1,248,231,17
BR1_2731662818,2,False,0,1,0,15235,209,48,7.2,False,7,True,1,0,0,16374,203,48,7.4,True,29.68015,-1139,-5,-1,257,251,6
BR1_2731714163,6,True,0,0,1,19210,214,44,7.2,False,8,False,1,1,0,19031,224,56,7.4,True,28.129083333333334,179,-2,-1,258,280,-22
BR1_2731653981,9,True,0,0,0,16506,134,40,6.6,False,9,False,0,0,0,15896,167,44,6.6,True,26.211683333333333,610,0,0,174,211,-37
BR1_2730045847,4,False,0,0,0,14259,161,52,6.8,False,6,True,1,0,0,16901,230,56,7.0,True,26.75,-2642,-2,-1,213,286,-73
BR1_2730357326,6,True,0,0,0,15061,142,38,5.4,False,9,False,1,0,1,19456,195,64,7.6,True,29.519716666666667,-4395,-3,-1,180,259,-79
BR1_2686780061,5,True,0,0,0,14024,144,44,6.8,False,4,False,0,0,0,14816,199,56,6.8,True,26.344733333333334,-792,1,0,188,255,-67
BR1_2685620523,6,True,0,1,0,15699,188,40,7.0,True,3,False,0,0,0,14614,204,43,6.8,False,26.4071,1085,3,0,228,247,-19
BR1_2719962086,5,False,0,0,0,15090,164,52,6.6,False,10,True,1,0,0,18324,191,48,6.8,True,25.172616666666666,-3234,-5,-1,216,239,-23
BR1_2730123288,5,False,0,0,0,16075,186,48,6.8,False,9,True,0,0,0,17956,204,48,7.0,True,29.744566666666667,-1881,-4,0,234,252,-18
BR1_2726186467,7,True,0,1,0,16892,198,52,6.8,True,8,False,0,0,0,16159,166,55,6.6,False,26.0068,733,-1,0,250,221,29
BR1_2726021045,7,True,0,0,0,15243,176,16,5.6,False,2,False,1,0,0,14661,184,60,6.6,True,25.545483333333333,582,5,-1,192,244,-52
BR1_2710700071,11,False,1,0,0,17608,209,35,6.8,True,2,True,0,1,0,14124,201,60,6.6,False,26.633416666666665,3484,9,1,244,261,-17
BR1_2710630352,9,True,1,0,0,18541,239,76,7.2,False,6,False,0,0,0,16764,215,44,7.2,True,29.97295,1777,3,1,315,259,56
BR1_2726143096,11,False,0,0,0,17955,202,44,6.8,False,10,True,0,0,0,16905,168,40,6.6,True,26.428016666666668,1050,1,0,246,208,38
BR1_2731747152,7,False,1,1,0,16998,201,52,7.0,True,6,True,0,0,0,16230,234,36,6.6,False,26.410833333333333,768,1,1,253,270,-17
BR1_2703014518,11,False,1,1,0,18589,162,56,7.0,False,10,True,0,0,0,18544,184,56,6.8,True,28.65726666666667,45,1,1,218,240,-22
BR1_2702973260,11,True,1,1,0,19206,186,56,7.0,False,8,False,0,0,0,18956,217,64,7.0,True,28.692783333333335,250,3,1,242,281,-39
BR1_2665445453,5,False,0,1,0,18634,223,56,7.4,True,12,True,0,0,0,19907,214,44,8.0,False,27.671433333333333,-1273,-7,0,279,258,21
BR1_2665421219,10,True,1,1,0,19558,224,51,7.6,True,6,False,0,0,0,16892,229,59,7.2,False,28.168366666666667,2666,4,1,275,288,-13
BR1_2730793202,9,True,0,0,0,17628,166,44,6.8,False,11,False,0,0,0,19382,238,60,7.8,True,27.508983333333333,-1754,-2,0,210,298,-88
BR1_2727375811,8,False,0,0,0,15788,159,36,6.4,False,16,True,1,0,0,19470,190,60,7.0,True,27.294283333333333,-3682,-8,-1,195,250,-55
BR1_2731300903,14,True,0,0,0,19872,202,56,7.4,True,6,False,1,0,0,16798,196,64,7.2,False,25.0718,3074,8,-1,258,260,-2
BR1_2723209203,5,False,0,0,0,15528,208,48,6.4,False,11,True,1,0,0,18864,223,52,7.0,True,25.043633333333332,-3336,-6,-1,256,275,-19
BR1_2709076876,4,True,0,0,0,17318,231,60,7.0,False,3,False,1,0,0,16049,216,52,6.8,True,29.112683333333333,1269,1,-1,291,268,23
BR1_2698081898,9,True,1,0,0,16273,163,56,7.0,True,8,False,0,0,0,18736,196,56,6.6,False,29.502483333333334,-2463,1,1,219,252,-33
BR1_2729513640,7,True,0,0,0,16997,190,42,7.4,False,6,False,1,1,0,17327,180,72,7.6,True,27.9825,-330,1,-1,232,252,-20
BR1_2728058525,11,False,0,0,0,20262,207,60,7.0,True,14,True,1,0,0,20898,209,44,6.8,False,29.431016666666668,-636,-3,-1,267,253,14
BR1_2726007914,8,True,0,1,0,17602,203,56,7.0,False,7,False,1,0,0,17782,243,68,7.4,True,28.034516666666665,-180,1,-1,259,311,-52
BR1_2725998292,8,True,0,0,0,18302,235,61,7.6,True,7,False,1,0,0,17422,198,60,7.6,False,29.24053333333333,880,1,-1,296,258,38
BR1_2728860287,5,False,1,0,0,16288,208,36,6.8,True,9,True,0,0,0,18329,234,60,7.6,False,29.5092,-2041,-4,1,244,294,-50
BR1_2726276827,4,False,0,0,0,16379,244,48,7.4,False,9,True,1,1,0,19520,224,64,7.0,True,29.299483333333335,-3141,-5,-1,292,288,4
BR1_2731853787,13,False,0,1,0,19754,172,42,7.0,False,13,True,1,0,0,20972,219,56,7.0,True,29.718616666666666,-1218,0,-1,214,275,-61
BR1_2724565141,4,False,1,0,0,15971,197,48,7.0,False,14,True,0,1,0,21745,234,60,7.8,True,28.990383333333334,-5774,-10,1,245,294,-49
BR1_2731814402,6,False,0,1,0,15050,182,44,7.0,True,3,True,1,0,0,14764,190,51,6.8,False,26.73785,286,3,-1,226,241,-15
BR1_2731761493,7,False,0,0,0,17566,199,58,7.2,True,19,True,1,0,0,21696,188,56,7.4,False,28.707233333333335,-4130,-12,-1,257,244,13
BR1_2728484519,5,True,0,0,0,15952,223,24,7.0,False,3,False,1,0,0,15729,228,66,7.0,True,29.250466666666668,223,2,-1,247,294,-47
BR1_2728459527,6,True,0,0,0,16136,169,56,7.2,True,3,False,0,0,0,14013,136,56,6.6,False,27.482066666666668,2123,3,0,225,192,33
BR1_2731525619,7,False,1,1,0,18710,219,56,7.4,True,13,True,0,0,0,20233,215,44,7.4,False,27.596683333333335,-1523,-6,1,275,259,16
BR1_2731579379,15,True,0,0,0,20694,199,48,7.4,False,7,False,0,0,0,17600,179,52,7.0,True,29.453333333333333,3094,8,0,247,231,16
BR1_2731267857,10,False,0,1,0,20499,203,52,7.4,True,6,True,0,0,0,16938,223,48,7.0,False,27.674766666666667,3561,4,0,255,271,-16
BR1_2731761224,6,True,0,0,0,17211,224,56,7.2,True,6,False,1,0,0,16078,182,48,6.8,False,28.593583333333335,1133,0,-1,280,230,50
BR1_2731704827,9,True,0,0,0,18293,213,48,7.4,True,9,False,0,0,0,18810,209,60,7.2,False,29.930866666666667,-517,0,0,261,269,-8
BR1_2731829185,11,True,1,1,0,19611,207,66,7.0,True,1,False,0,0,0,15470,221,52,7.2,False,28.287633333333332,4141,10,1,273,273,0
BR1_2731753681,9,False,1,0,0,18915,214,66,7.6,True,4,True,0,1,0,15856,219,52,7.0,False,28.459783333333334,3059,5,1,280,271,9
BR1_2668743694,5,False,1,0,0,15995,191,52,6.6,True,3,True,0,0,0,14433,179,60,6.4,False,25.455266666666667,1562,2,1,243,239,4
BR1_2668679159,9,True,1,1,0,17513,174,48,6.8,True,11,False,0,0,0,16027,137,33,6.8,False,25.8304,1486,-2,1,222,170,52
BR1_2702534682,10,True,0,0,0,17038,160,44,6.8,False,9,False,0,0,0,16465,188,44,6.6,True,25.975916666666667,573,1,0,204,232,-28
BR1_2730276232,11,True,1,0,0,19583,226,72,7.8,True,5,False,0,0,0,16593,179,56,7.2,False,28.211483333333334,2990,6,1,298,235,63
BR1_2730122008,5,False,0,0,0,14687,152,44,6.6,False,3,True,0,0,0,14532,179,55,7.0,True,25.0354,155,2,0,196,234,-38
BR1_2717165270,10,False,1,0,0,17298,203,30,7.0,False,7,True,0,1,0,18000,223,58,7.0,True,28.9101,-702,3,1,233,281,-48
BR1_2728515719,8,False,1,0,0,18071,240,55,7.8,True,7,True,0,0,0,18255,246,61,7.4,False,29.3941,-184,1,1,295,307,-12
BR1_2728490720,12,True,0,1,0,20553,221,68,7.4,True,6,False,0,0,0,17149,207,48,7.0,False,28.795283333333334,3404,6,0,289,255,34
BR1_2731829620,14,True,0,1,0,21447,197,44,7.6,True,5,False,0,0,0,16066,198,30,6.6,False,29.028783333333333,5381,9,0,241,228,13
BR1_2731765802,5,False,0,1,0,16739,212,48,7.2,False,7,True,1,0,0,18061,256,48,7.4,True,27.707,-1322,-2,-1,260,304,-44
BR1_2731856280,12,True,1,1,0,19231,141,56,6.8,False,11,False,0,0,1,19999,192,28,6.8,True,28.710066666666666,-768,1,1,197,220,-23
BR1_2697981268,13,False,1,1,0,19876,176,52,7.4,True,7,True,0,0,0,17049,188,60,7.0,False,28.934783333333332,2827,6,1,228,248,-20
BR1_2697921320,4,False,0,0,0,14447,179,44,6.4,False,5,True,0,0,0,14463,162,44,6.8,True,25.956016666666667,-16,-1,0,223,206,17
BR1_2697899479,8,False,0,1,0,17892,212,48,7.2,False,6,True,1,0,0,16167,186,32,6.8,True,29.581083333333332,1725,2,-1,260,218,42
BR1_2697865758,3,False,0,0,0,13106,130,41,5.8,False,3,True,1,0,0,14703,182,57,6.4,True,26.5952,-1597,0,-1,171,239,-68
BR1_2724318387,15,True,1,1,1,20298,142,59,6.8,True,5,False,0,0,0,15260,139,52,6.0,False,25.16421666666667,5038,10,1,201,191,10
BR1_2707056450,5,True,1,0,0,15666,204,52,6.4,False,4,False,0,1,0,15283,179,57,6.6,True,26.345716666666668,383,1,1,256,236,20
BR1_2725785785,1,False,0,0,0,14592,161,60,7.0,False,8,True,1,0,0,16661,163,68,7.2,True,28.109383333333334,-2069,-7,-1,221,231,-10
BR1_2723042458,4,True,0,0,0,14933,205,44,6.8,False,7,False,1,0,0,15258,142,55,6.6,True,27.16358333333333,-325,-3,-1,249,197,52
BR1_2727661072,2,False,1,0,0,13721,191,56,6.6,False,5,True,0,1,0,16179,205,52,7.0,True,25.991333333333333,-2458,-3,1,247,257,-10
BR1_2727302213,8,False,0,0,0,15701,132,42,6.4,False,9,True,1,1,0,17595,193,68,7.0,True,27.102033333333335,-1894,-1,-1,174,261,-87
BR1_2730531269,1,False,0,0,0,13011,154,64,6.6,False,5,True,1,0,0,16585,215,60,7.2,True,25.625783333333334,-3574,-4,-1,218,275,-57
BR1_2731704717,8,True,1,0,0,18222,188,60,7.6,True,2,False,0,0,0,14977,223,60,7.2,False,29.518966666666667,3245,6,1,248,283,-35
BR1_2731723718,7,True,0,1,0,18273,218,56,7.4,True,7,False,1,0,0,16891,186,52,7.2,False,29.963116666666668,1382,0,-1,274,238,36
BR1_2731700261,9,True,0,0,0,18146,171,43,7.0,True,14,False,0,0,0,21759,148,53,7.2,False,29.34958333333333,-3613,-5,0,214,201,13
BR1_2731355680,7,False,0,0,0,15524,148,31,5.8,False,6,True,0,0,0,15480,186,49,6.2,True,25.715666666666667,44,1,0,179,235,-56
BR1_2718935087,9,False,0,0,0,17405,188,56,7.2,False,8,True,1,0,0,17074,167,44,6.8,True,26.39005,331,1,-1,244,211,33
BR1_2718901493,6,False,0,1,0,17127,203,50,7.2,True,6,True,1,0,0,17148,209,65,7.2,False,28.6421,-21,0,-1,253,274,-21
BR1_2718835560,6,True,0,0,0,15331,160,48,6.6,True,0,False,1,0,0,12948,173,56,6.6,False,25.375816666666665,2383,6,-1,208,229,-21
BR1_2731265067,11,False,0,1,0,20532,237,64,7.4,True,10,True,1,0,0,20627,208,56,7.6,False,28.4916,-95,1,-1,301,264,37
BR1_2731077734,7,False,0,1,0,16448,175,60,6.6,False,7,True,1,0,0,16701,193,44,6.6,True,26.346283333333332,-253,0,-1,235,237,-2
BR1_2715033312,11,True,0,0,0,17317,165,48,6.6,True,10,False,1,0,0,17432,209,48,6.8,False,26.054133333333333,-115,1,-1,213,257,-44
BR1_2712047871,10,True,0,1,0,18783,195,56,7.2,True,10,False,1,0,0,18619,220,52,7.2,False,27.993166666666667,164,0,-1,251,272,-21
BR1_2731788176,8,True,1,0,0,17877,233,56,7.2,True,7,False,0,0,0,16989,228,56,7.2,False,29.129483333333333,888,1,1,289,284,5
BR1_2731483663,10,True,1,0,0,17488,188,48,7.0,True,4,False,0,1,0,16954,205,56,7.0,False,28.1265,534,6,1,236,261,-25
BR1_2695644799,10,True,0,0,0,16730,133,58,6.6,False,6,False,0,1,0,15870,158,49,6.6,True,26.334133333333334,860,4,0,191,207,-16
BR1_2718061197,7,True,0,0,0,15132,166,48,6.4,False,12,False,1,0,1,19185,199,47,7.0,True,27.147183333333334,-4053,-5,-1,214,246,-32
BR1_2724210025,8,False,1,1,0,19301,217,60,7.2,True,4,True,0,0,0,15685,207,56,7.4,False,28.026233333333334,3616,4,1,277,263,14
BR1_2707643355,5,False,0,0,0,15518,182,56,6.6,True,6,True,0,0,0,15129,160,48,6.6,False,27.211983333333333,389,-1,0,238,208,30
BR1_2730168033,6,False,0,0,0,18318,211,56,7.2,False,12,True,1,1,1,21321,254,60,7.4,True,28.397183333333334,-3003,-6,-1,267,314,-47
BR1_2729410315,7,True,1,0,0,16881,182,52,7.0,True,5,False,0,0,0,17157,209,56,7.2,False,28.993316666666665,-276,2,1,234,265,-31
BR1_2726046149,7,True,1,0,0,16603,197,56,7.0,True,1,False,0,0,0,13103,163,44,6.4,False,27.408166666666666,3500,6,1,253,207,46
BR1_2728891140,6,False,1,1,0,18550,188,72,7.0,False,10,True,0,0,0,19400,211,68,7.6,True,27.958316666666665,-850,-4,1,260,279,-19
BR1_2731796914,9,True,1,0,0,17304,219,54,7.2,True,1,False,0,0,0,13006,156,62,6.6,False,25.802616666666665,4298,8,1,273,218,55
BR1_2730054919,9,True,0,0,0,17522,177,59,7.2,False,7,False,1,0,0,17513,187,48,7.0,True,28.49275,9,2,-1,236,235,1
BR1_2731173019,7,True,1,0,0,16221,181,60,7.0,True,5,False,0,0,0,16711,202,60,7.2,False,29.640083333333333,-490,2,1,241,262,-21
BR1_2731277732,2,False,0,0,0,13489,166,36,6.4,False,9,True,1,1,0,17316,184,56,6.8,True,25.106416666666668,-3827,-7,-1,202,240,-38
BR1_2692234286,5,False,0,1,0,17504,225,60,7.4,False,9,True,1,0,0,18103,208,70,7.6,True,27.62165,-599,-4,-1,285,278,7
BR1_2692223665,2,False,1,0,0,14135,191,59,6.6,True,7,True,0,0,0,16677,216,48,6.8,False,25.925266666666666,-2542,-5,1,250,264,-14
BR1_2730728859,3,False,0,0,0,14566,201,48,6.6,False,11,True,1,1,0,18546,213,40,6.8,True,27.19558333333333,-3980,-8,-1,249,253,-4
BR1_2725227299,7,False,0,0,0,15767,149,40,6.2,False,11,True,1,0,1,20840,247,64,7.2,True,27.2363,-5073,-4,-1,189,311,-122
BR1_2725147221,5,True,0,1,0,16519,206,52,7.2,False,5,False,1,0,0,17071,207,64,7.2,True,28.9947,-552,0,-1,258,271,-13
BR1_2724848705,5,True,0,1,0,18232,254,60,7.4,True,5,False,1,0,0,15864,199,64,7.0,False,28.483433333333334,2368,0,-1,314,263,51
BR1_2731857287,10,True,0,0,0,19163,222,64,7.2,False,4,False,0,0,0,15241,171,40,6.8,True,28.290166666666668,3922,6,0,286,211,75
BR1_2731838250,3,False,0,1,0,14550,187,56,6.6,False,6,True,1,0,0,15262,206,40,6.8,True,27.091783333333332,-712,-3,-1,243,246,-3
BR1_2729808042,5,True,0,0,0,16882,191,52,7.2,True,4,False,1,0,0,16245,253,26,7.0,False,29.68095,637,1,-1,243,279,-36
BR1_2729787000,6,True,1,1,0,16241,206,40,7.0,True,5,False,0,0,0,15513,218,44,6.8,False,27.492183333333333,728,1,1,246,262,-16
BR1_2729779617,9,True,1,0,0,15970,165,44,6.8,False,8,False,0,0,0,16514,184,64,7.0,True,26.53635,-544,1,1,209,248,-39
BR1_2729470097,8,True,0,0,0,16150,169,48,6.6,True,2,False,1,1,0,14160,180,60,6.8,False,26.869633333333333,1990,6,-1,217,240,-23
BR1_2728945203,5,False,0,0,0,16590,188,59,7.0,False,8,True,1,0,0,18983,249,48,7.4,True,28.438866666666666,-2393,-3,-1,247,297,-50
BR1_2728917854,5,False,0,1,0,17052,194,60,7.0,False,9,True,1,0,0,18434,193,64,7.2,True,29.886183333333335,-1382,-4,-1,254,257,-3
BR1_2728639603,13,True,1,0,0,20746,219,40,7.0,True,8,False,0,1,0,17222,180,60,7.2,False,29.8074,3524,5,1,259,240,19
BR1_2725122366,2,False,1,1,0,14917,192,72,7.4,True,4,True,0,0,0,16339,218,60,7.4,False,28.60395,-1422,-2,1,264,278,-14
BR1_2714382082,10,True,1,1,0,18434,201,44,7.4,True,5,False,0,0,0,15872,202,48,7.2,False,29.522183333333334,2562,5,1,245,250,-5
BR1_2714367153,4,True,0,0,0,16293,216,52,6.6,False,9,False,1,0,0,18017,185,56,7.2,True,28.084216666666666,-1724,-5,-1,268,241,27
BR1_2701194998,7,True,0,0,0,17209,188,52,7.0,True,6,False,0,0,0,16018,176,60,6.8,False,27.080233333333332,1191,1,0,240,236,4
BR1_2701174012,2,True,1,0,0,14496,227,56,6.8,True,4,False,0,0,0,14123,163,48,6.6,False,26.0436,373,-2,1,283,211,72
BR1_2731638098,5,False,1,0,0,14352,180,56,6.6,True,7,True,0,0,0,17174,228,40,6.8,False,26.321616666666667,-2822,-2,1,236,268,-32
BR1_2731642035,9,False,1,0,0,16734,166,50,6.6,True,6,True,0,0,0,16019,206,54,6.8,False,26.738,715,3,1,216,260,-44
BR1_2728757910,13,True,1,0,0,18092,190,42,7.0,True,5,False,0,0,0,14585,173,52,6.6,False,26.6614,3507,8,1,232,225,7
BR1_2726052740,4,True,0,0,0,15598,196,44,6.8,True,7,False,1,0,0,16405,189,48,6.4,False,26.089483333333334,-807,-3,-1,240,237,3
BR1_2718860125,12,True,0,1,1,19699,192,52,7.0,True,4,False,1,0,0,14904,188,48,6.4,False,26.14845,4795,8,-1,244,236,8
BR1_2715320308,9,True,1,0,1,20408,275,60,7.8,True,5,False,0,0,0,15885,186,56,7.4,False,28.35775,4523,4,1,335,242,93
BR1_2730781380,5,True,0,1,0,17009,208,60,7.4,False,8,False,1,0,0,18293,201,68,7.2,True,29.441783333333333,-1284,-3,-1,268,269,-1
BR1_2731694515,10,False,1,0,0,16221,174,48,6.8,True,5,True,0,0,0,15558,154,56,6.6,False,26.01825,663,5,1,222,210,12
BR1_2731655510,9,True,1,0,0,16876,211,52,7.0,True,4,False,0,0,0,14267,167,56,6.4,False,25.088016666666668,2609,5,1,263,223,40
BR1_2731609402,3,False,1,0,0,14417,166,60,6.4,False,16,True,0,0,0,21747,203,64,7.6,True,27.541966666666667,-7330,-13,1,226,267,-41
BR1_2729959269,1,False,0,1,0,13301,158,60,6.4,False,14,True,1,0,0,18181,203,52,7.0,True,27.063583333333334,-4880,-13,-1,218,255,-37
BR1_2726410728,4,True,0,0,0,16440,220,56,7.4,True,5,False,0,0,0,16019,209,76,7.6,False,28.766816666666667,421,-1,0,276,285,-9
BR1_2725877017,9,True,0,1,0,17962,209,52,7.2,False,3,False,1,0,0,15479,199,68,7.2,True,29.551983333333332,2483,6,-1,261,267,-6
BR1_2725833857,4,False,0,1,0,16101,168,75,7.2,False,5,True,1,0,0,16762,225,40,7.0,True,29.529133333333334,-661,-1,-1,243,265,-22
BR1_2731487936,10,True,0,0,0,18477,218,48,7.0,True,5,False,1,0,0,15488,188,60,6.4,False,26.429166666666667,2989,5,-1,266,248,18
BR1_2727376213,4,True,0,0,0,14254,180,44,6.8,False,3,False,1,1,0,15157,208,68,6.8,True,25.79445,-903,1,-1,224,276,-52
BR1_2731354521,4,False,1,0,0,16693,223,64,7.4,False,7,True,0,1,0,17724,223,67,7.4,True,29.64845,-1031,-3,1,287,290,-3
BR1_2731684337,6,True,0,0,0,15890,196,48,6.8,False,5,False,1,0,0,14796,130,64,6.4,True,26.639466666666667,1094,1,-1,244,194,50
BR1_2731662172,11,True,1,0,0,18551,168,42,6.8,True,10,False,0,1,0,18395,165,71,6.8,False,26.92975,156,1,1,210,236,-26
BR1_2721914315,8,True,0,1,0,16472,168,52,6.8,False,11,False,1,0,0,17757,189,44,6.8,True,26.3896,-1285,-3,-1,220,233,-13
BR1_2717791078,10,True,1,0,0,18345,210,60,7.2,True,0,False,0,1,0,12799,167,52,6.6,False,26.619916666666665,5546,10,1,270,219,51
BR1_2717117780,6,False,0,0,0,15535,175,60,6.6,True,8,True,1,1,0,16257,169,44,6.6,False,26.1613,-722,-2,-1,235,213,22
BR1_2729974572,7,True,0,1,0,17423,179,60,6.4,True,8,False,0,0,0,16215,164,36,6.4,False,26.09845,1208,-1,0,239,200,39
BR1_2729481575,11,True,0,1,0,19922,210,55,7.0,True,9,False,1,0,0,17712,136,56,6.2,False,27.996016666666666,2210,2,-1,265,192,73
BR1_2726872911,6,True,0,1,0,15849,192,52,6.8,False,4,False,1,0,0,16639,211,58,7.4,True,29.000383333333332,-790,2,-1,244,269,-25
BR1_2731725761,6,False,1,0,0,15087,139,49,6.2,True,10,True,0,0,0,17238,153,52,6.4,False,26.798016666666665,-2151,-4,1,188,205,-17
BR1_2731879409,9,False,1,0,0,17003,185,60,7.0,False,14,True,0,1,0,19869,216,40,7.4,True,28.370533333333334,-2866,-5,1,245,256,-11
BR1_2730504128,6,False,0,1,1,19330,220,60,7.6,True,3,True,1,0,0,16442,209,60,7.4,False,29.374783333333333,2888,3,-1,280,269,11
BR1_2729269974,10,False,1,0,0,17237,160,48,6.8,False,9,True,0,0,0,17111,223,48,7.0,True,26.0207,126,1,1,208,271,-63
BR1_2726682075,7,False,1,0,0,16551,167,52,7.4,False,6,True,0,0,0,18169,255,52,7.4,True,29.9619,-1618,1,1,219,307,-88
BR1_2728696924,8,False,1,0,0,17745,221,56,7.4,True,5,True,0,1,0,15835,205,46,7.2,False,28.562866666666668,1910,3,1,277,251,26
BR1_2727188628,5,True,1,0,0,17242,235,64,7.8,True,6,False,0,1,1,18847,213,56,7.4,False,28.676166666666667,-1605,-1,1,299,269,30
BR1_2726866044,5,False,1,0,0,14787,162,42,6.4,False,14,True,0,0,0,19197,204,52,7.0,True,27.100516666666667,-4410,-9,1,204,256,-52
BR1_2717498626,13,True,1,1,0,20114,190,52,7.0,True,4,False,0,0,0,15639,181,56,7.0,False,29.8328,4475,9,1,242,237,5
BR1_2731724400,3,False,1,1,0,15640,211,56,7.2,True,9,True,0,0,0,19137,221,80,7.4,False,27.542,-3497,-6,1,267,301,-34
BR1_2707699467,3,False,0,0,0,15229,185,64,6.8,False,14,True,1,0,0,20478,200,60,7.4,True,29.090733333333333,-5249,-11,-1,249,260,-11
BR1_2694263701,6,False,1,0,0,15843,172,44,6.8,False,6,True,0,0,0,17158,199,44,7.0,True,29.048566666666666,-1315,0,1,216,243,-27
BR1_2694247852,7,False,0,1,0,16315,163,50,6.6,False,10,True,1,0,0,17944,173,54,6.6,True,25.552066666666665,-1629,-3,-1,213,227,-14
BR1_2724013898,7,False,0,1,0,18372,218,68,7.6,True,5,True,0,0,0,16802,240,43,7.4,False,28.783466666666666,1570,2,0,286,283,3
BR1_2730631707,6,False,1,0,0,16054,202,24,6.8,False,16,True,0,0,0,20847,212,48,7.2,True,29.65855,-4793,-10,1,226,260,-34
BR1_2730744369,8,True,0,1,0,18172,180,72,7.0,True,7,False,0,0,0,18546,238,36,7.2,False,29.2369,-374,1,0,252,274,-22
BR1_2683500734,2,True,0,1,0,14400,171,56,6.6,True,2,False,0,0,0,13335,170,44,6.8,False,26.894233333333332,1065,0,0,227,214,13
BR1_2683473991,10,True,0,0,0,15771,150,40,6.4,True,6,False,0,0,0,14784,172,36,6.6,False,27.093616666666666,987,4,0,190,208,-18
BR1_2714383456,8,True,0,0,0,15971,159,32,6.4,False,15,False,0,0,0,20344,219,50,7.2,True,28.057016666666666,-4373,-7,0,191,269,-78
BR1_2731257850,5,True,1,0,0,14471,152,48,6.4,True,4,False,0,0,0,14155,171,36,6.8,False,26.551233333333332,316,1,1,200,207,-7
BR1_2685922776,6,True,0,0,0,16047,172,28,6.8,False,11,False,1,0,0,17824,152,28,6.6,True,29.3889,-1777,-5,-1,200,180,20
BR1_2722738272,9,False,0,0,0,18426,203,56,7.2,False,9,True,0,0,0,17772,209,40,6.6,True,28.6438,654,0,0,259,249,10
BR1_2708515524,6,True,1,0,0,18043,236,48,7.0,False,4,False,0,0,0,16147,236,52,7.4,True,28.970016666666666,1896,2,1,284,288,-4
BR1_2730476814,12,False,0,1,0,20893,218,68,7.4,True,8,True,1,0,0,17260,192,40,6.6,False,28.790783333333334,3633,4,-1,286,232,54
BR1_2731359044,8,False,1,0,0,17202,185,48,6.4,False,9,True,0,1,0,17782,214,44,7.2,True,29.695166666666665,-580,-1,1,233,258,-25
BR1_2731429921,2,True,0,0,0,13440,145,48,6.6,False,4,False,0,1,0,16417,221,56,6.8,True,27.35765,-2977,-2,0,193,277,-84
BR1_2731400867,3,True,1,0,0,15096,199,56,6.8,False,0,False,0,0,0,13385,212,44,6.8,True,26.33525,1711,3,1,255,256,-1
BR1_2706141851,6,True,0,0,0,17453,240,48,7.2,False,9,False,0,1,0,18477,211,44,7.2,True,29.673066666666667,-1024,-3,0,288,255,33
BR1_2703282095,8,False,1,1,0,17651,184,64,7.0,True,5,True,0,0,0,14052,173,48,6.6,False,25.764783333333334,3599,3,1,248,221,27
BR1_2730153140,5,False,1,0,0,16313,207,64,7.6,True,2,True,0,1,0,16439,213,64,7.4,False,29.847083333333334,-126,3,1,271,277,-6
BR1_2723317275,4,False,0,1,0,16373,207,73,7.2,False,6,True,1,0,0,17759,220,51,7.4,True,28.778616666666668,-1386,-2,-1,280,271,9
BR1_2731704536,6,False,0,1,0,18514,224,75,7.6,False,9,True,1,0,1,20718,223,64,7.2,True,29.742966666666668,-2204,-3,-1,299,287,12
BR1_2718779023,10,True,0,0,0,15870,142,32,6.4,False,8,False,0,1,0,15915,155,40,6.8,True,26.625833333333333,-45,2,0,174,195,-21
BR1_2722321635,5,False,0,0,0,15453,192,52,6.8,True,5,True,1,0,0,15728,195,56,6.8,False,26.783133333333332,-275,0,-1,244,251,-7
BR1_2730726029,7,False,1,1,0,16228,128,68,7.0,False,8,True,0,0,0,18016,185,56,7.2,True,27.676166666666667,-1788,-1,1,196,241,-45
BR1_2730633983,9,True,0,1,0,18526,189,48,7.0,False,10,False,1,0,0,18842,179,66,7.0,True,28.977833333333333,-316,-1,-1,237,245,-8
BR1_2729609630,13,False,0,1,0,20141,204,44,7.4,False,13,True,1,0,0,19747,177,58,7.2,True,29.157466666666668,394,0,-1,248,235,13
BR1_2730829429,4,False,0,0,0,14432,188,52,6.4,False,12,True,1,0,0,18298,199,48,6.8,True,26.584233333333334,-3866,-8,-1,240,247,-7
BR1_2730801827,5,False,0,0,0,16564,192,64,7.4,False,9,True,1,1,0,19545,232,56,7.4,True,29.2611,-2981,-4,-1,256,288,-32
BR1_2715365197,12,True,1,0,0,20025,256,71,7.6,True,5,False,0,0,0,16399,195,53,7.0,False,29.457366666666665,3626,7,1,327,248,79
BR1_2694546252,8,False,1,0,0,17092,195,60,7.0,True,3,True,0,0,0,14186,180,46,6.4,False,26.882133333333332,2906,5,1,255,226,29
BR1_2693719584,8,True,1,1,0,17982,162,60,7.0,False,9,False,0,0,0,17661,199,50,7.0,True,28.954666666666668,321,-1,1,222,249,-27
BR1_2729717620,1,False,0,0,0,13963,217,40,6.6,False,4,True,1,0,0,15011,196,60,7.0,True,25.398866666666667,-1048,-3,-1,257,256,1
BR1_2725870971,3,False,0,0,0,13131,153,42,6.4,False,13,True,1,0,0,19597,197,54,7.0,True,26.931833333333334,-6466,-10,-1,195,251,-56
BR1_2729390438,10,False,0,0,0,19480,230,48,7.2,True,7,True,0,1,0,16947,186,52,7.2,False,28.436666666666667,2533,3,0,278,238,40
BR1_2729299939,8,False,1,0,0,17016,178,52,7.4,False,10,True,0,0,0,19172,231,56,7.2,True,29.036383333333333,-2156,-2,1,230,287,-57
BR1_2700156109,6,False,0,1,0,17248,187,52,7.2,True,10,True,1,0,0,19485,230,44,7.0,False,28.401883333333334,-2237,-4,-1,239,274,-35
BR1_2698073275,10,False,1,0,0,19719,231,63,7.4,False,7,True,0,0,0,16517,186,28,6.8,True,29.06175,3202,3,1,294,214,80
BR1_2697579000,7,True,0,0,0,16447,198,64,6.8,True,3,False,0,0,0,14651,202,60,6.6,False,25.586616666666668,1796,4,0,262,262,0
BR1_2730888104,3,True,0,0,0,15487,186,62,7.2,False,6,False,0,0,0,16041,176,52,7.2,True,28.437616666666667,-554,-3,0,248,228,20
BR1_2731821458,3,False,0,0,0,16602,207,56,7.0,False,12,True,0,0,0,19994,236,64,7.6,True,29.235783333333334,-3392,-9,0,263,300,-37
BR1_2722920913,16,True,1,0,0,21209,198,52,7.2,False,9,False,0,1,0,18776,190,68,7.2,True,29.223316666666665,2433,7,1,250,258,-8
BR1_2730828538,5,False,0,1,0,17449,196,80,7.0,False,11,True,1,0,0,19525,189,52,7.2,True,28.492966666666668,-2076,-6,-1,276,241,35
BR1_2730263226,5,True,0,0,0,15803,199,44,6.6,True,8,False,1,1,0,16488,152,52,6.8,False,26.104466666666667,-685,-3,-1,243,204,39
BR1_2731298861,10,False,0,0,0,16562,194,47,6.8,False,10,True,0,0,0,17954,171,40,6.6,True,25.826216666666667,-1392,0,0,241,211,30
BR1_2708616581,7,True,0,0,0,16358,187,40,6.4,True,11,False,0,0,0,17794,186,43,7.0,False,26.23121666666667,-1436,-4,0,227,229,-2
BR1_2708145957,10,True,1,0,0,17087,199,56,7.0,True,3,False,0,0,0,13945,144,60,6.6,False,26.034233333333333,3142,7,1,255,204,51
BR1_2729485088,6,True,0,1,0,16973,212,52,7.4,True,7,False,1,0,0,16828,183,52,7.4,False,29.150983333333333,145,-1,-1,264,235,29
BR1_2729848735,4,False,0,0,0,14921,163,56,6.8,False,7,True,1,0,0,15808,157,48,7.2,True,27.337866666666667,-887,-3,-1,219,205,14
BR1_2713269572,7,True,0,0,0,17568,180,64,7.4,True,4,False,0,0,0,16541,215,44,6.8,False,27.636883333333333,1027,3,0,244,259,-15
BR1_2705338945,6,True,1,0,0,17085,184,52,7.2,False,5,False,0,1,0,16358,204,52,6.8,True,29.69815,727,1,1,236,256,-20
BR1_2731874139,9,False,0,1,0,19430,212,64,6.8,True,7,True,1,0,0,17303,207,60,7.2,False,29.153566666666666,2127,2,-1,276,267,9
BR1_2728542393,8,True,0,1,0,17139,150,48,6.6,True,3,False,0,0,0,14126,182,52,6.6,False,27.1797,3013,5,0,198,234,-36
BR1_2726924060,8,False,0,1,0,19169,232,64,7.2,True,7,True,1,0,0,17113,227,56,7.6,False,27.626616666666667,2056,1,-1,296,283,13
BR1_2712412251,6,False,0,0,0,14887,140,35,6.8,False,8,True,0,0,0,18426,228,60,7.2,True,27.745316666666668,-3539,-2,0,175,288,-113
BR1_2729086621,10,True,1,0,0,17113,183,52,6.8,True,7,False,0,1,0,16618,189,44,6.6,False,26.6495,495,3,1,235,233,2
BR1_2729065167,10,True,1,0,0,17854,205,68,7.0,True,7,False,0,0,0,16640,232,48,6.6,False,26.1558,1214,3,1,273,280,-7
BR1_2726843571,1,False,0,1,0,13642,189,58,6.6,False,2,True,1,0,0,14726,204,62,6.8,True,26.21526666666667,-1084,-1,-1,247,266,-19
BR1_2725379634,8,False,0,0,0,14962,162,44,6.8,False,5,True,0,0,0,15831,222,44,6.8,True,27.209766666666667,-869,3,0,206,266,-60
BR1_2722358296,7,True,0,0,0,18321,248,56,7.0,False,9,False,1,0,0,18051,193,60,7.2,True,28.11863333333333,270,-2,-1,304,253,51
BR1_2691202031,6,True,1,1,0,15716,191,56,7.0,False,4,False,0,0,0,15313,205,48,6.8,True,25.900116666666666,403,2,1,247,253,-6
BR1_2719862791,4,False,0,1,0,14165,135,52,6.6,True,6,True,1,0,0,16080,200,56,6.8,False,25.767333333333333,-1915,-2,-1,187,256,-69
BR1_2719668266,14,True,0,0,0,18415,195,42,6.8,True,4,False,0,0,0,13972,156,30,6.0,False,25.9612,4443,10,0,237,186,51
BR1_2728691317,4,False,0,0,0,15262,177,48,6.8,True,4,True,0,0,0,15554,241,36,6.8,False,25.626816666666667,-292,0,0,225,277,-52
BR1_2731118991,4,True,0,0,0,14055,168,44,6.6,False,6,False,1,1,0,16417,186,52,6.8,True,26.992766666666668,-2362,-2,-1,212,238,-26
BR1_2731105503,9,True,1,0,0,17949,193,56,6.4,True,10,False,0,0,0,17391,156,52,6.8,False,25.027,558,-1,1,249,208,41
BR1_2724894286,3,False,0,1,0,17366,244,56,7.6,True,8,True,0,0,0,17968,209,72,7.8,False,28.13585,-602,-5,0,300,281,19
BR1_2724793955,10,True,1,0,0,18276,198,54,7.2,True,11,False,0,0,0,21152,232,70,7.6,False,29.464916666666667,-2876,-1,1,252,302,-50
BR1_2715789543,5,True,1,1,0,15844,205,52,6.8,True,7,False,0,0,0,15050,186,40,6.8,False,25.594166666666666,794,-2,1,257,226,31
BR1_2729707553,12,False,0,0,0,17951,199,44,6.8,True,12,True,0,0,0,18494,167,34,6.8,False,25.846166666666665,-543,0,0,243,201,42
BR1_2729616948,8,False,0,0,0,16993,172,60,6.6,False,11,True,0,0,0,20853,232,43,7.4,True,28.6739,-3860,-3,0,232,275,-43
BR1_2705326863,7,False,0,0,0,16609,173,44,7.0,False,9,True,0,0,0,17189,198,34,7.0,True,28.092366666666667,-580,-2,0,217,232,-15
BR1_2731370462,6,False,1,1,0,16399,187,56,6.8,True,4,True,0,0,0,14755,174,48,6.4,False,26.165266666666668,1644,2,1,243,222,21
BR1_2730897977,6,False,0,0,0,15648,195,48,6.6,False,9,True,0,0,0,16946,178,32,6.6,True,26.912866666666666,-1298,-3,0,243,210,33
BR1_2731632734,2,True,1,1,0,15700,207,68,7.2,True,3,False,0,0,0,15932,204,56,7.2,False,28.9579,-232,-1,1,275,260,15
BR1_2728518726,7,False,1,0,0,15464,166,39,6.6,False,15,True,0,0,0,20970,195,60,7.2,True,29.4571,-5506,-8,1,205,255,-50
BR1_2731363004,9,True,0,0,0,17972,191,52,7.0,True,4,False,0,0,0,14885,166,44,6.4,False,26.285816666666665,3087,5,0,243,210,33
BR1_2696569263,13,False,0,0,0,18296,178,52,7.2,True,14,True,1,0,0,19496,197,48,7.2,False,28.11415,-1200,-1,-1,230,245,-15
BR1_2696535942,4,True,0,1,0,15710,183,55,7.0,False,4,False,0,0,0,16503,207,51,7.0,True,28.577866666666665,-793,0,0,238,258,-20
BR1_2707876012,11,True,1,1,0,20667,252,52,7.8,True,5,False,0,0,0,17167,227,76,7.2,False,28.492683333333332,3500,6,1,304,303,1
BR1_2707016774,7,False,0,0,0,16550,210,44,7.0,False,5,True,1,0,0,16038,216,64,6.8,True,26.3887,512,2,-1,254,280,-26
BR1_2696832136,5,False,0,1,0,19262,249,66,7.6,False,6,True,0,0,0,16917,219,75,7.8,True,29.589166666666667,2345,-1,0,315,294,21
BR1_2728926131,5,False,1,0,0,16617,185,64,7.2,False,4,True,0,0,0,16583,215,60,7.2,True,29.959833333333332,34,1,1,249,275,-26
BR1_2727473230,10,False,0,0,0,18270,172,67,7.4,True,12,True,1,0,0,20998,217,60,7.6,False,27.9575,-2728,-2,-1,239,277,-38
BR1_2731105798,4,True,0,1,0,14851,191,46,6.8,True,1,False,1,0,0,13801,212,49,6.4,False,27.25335,1050,3,-1,237,261,-24
BR1_2730668118,9,True,0,0,0,18032,199,53,7.0,True,10,False,1,0,0,18367,197,54,7.4,False,28.25345,-335,-1,-1,252,251,1
BR1_2730771319,4,False,1,0,0,17224,219,56,7.2,True,4,True,0,0,0,16983,231,56,7.4,False,29.7466,241,0,1,275,287,-12
BR1_2730734938,1,False,0,0,0,14208,166,60,6.8,False,9,True,1,0,0,19237,232,60,7.6,True,29.27391666666667,-5029,-8,-1,226,292,-66
BR1_2706552822,5,False,0,1,0,16554,190,60,7.4,True,6,True,1,0,0,16959,189,60,7.0,False,28.168,-405,-1,-1,250,249,1
BR1_2706519906,6,True,0,0,0,15721,224,36,7.0,True,2,False,0,0,0,14125,163,68,6.8,False,25.145116666666667,1596,4,0,260,231,29
BR1_2731214355,7,False,1,1,0,16102,156,56,6.8,False,8,True,0,0,0,16888,194,48,6.8,True,26.190133333333332,-786,-1,1,212,242,-30
BR1_2729247085,8,True,0,0,0,16990,169,55,6.6,True,10,False,1,0,0,17188,164,56,7.0,False,26.51631666666667,-198,-2,-1,224,220,4
BR1_2723460379,6,False,0,0,0,14367,138,44,6.6,False,6,True,0,0,0,15054,193,36,6.4,True,25.694533333333332,-687,0,0,182,229,-47
BR1_2730781744,3,True,0,0,0,14065,165,56,6.8,False,9,False,0,0,0,16836,176,68,7.0,True,25.615633333333335,-2771,-6,0,221,244,-23
BR1_2731136704,6,True,0,0,0,15818,199,44,6.6,True,4,False,0,0,0,14531,151,56,6.4,False,25.27075,1287,2,0,243,207,36
BR1_2731630312,7,False,0,0,0,16688,180,50,6.8,True,7,True,0,0,0,15475,143,44,6.4,False,27.353166666666667,1213,0,0,230,187,43
BR1_2711658925,6,False,0,0,0,16291,203,53,6.8,False,6,True,1,1,0,15948,198,60,6.8,True,27.235233333333333,343,0,-1,256,258,-2
BR1_2679605269,12,False,0,0,0,18404,168,52,6.8,False,12,True,1,0,0,19362,176,44,6.4,True,25.069666666666667,-958,0,-1,220,220,0
BR1_2731797059,8,True,1,0,0,17003,228,48,7.0,True,6,False,0,0,0,15180,167,44,6.6,False,26.548933333333334,1823,2,1,276,211,65
BR1_2731725943,8,False,0,1,0,17848,197,52,7.0,False,12,True,1,0,0,19212,188,56,7.2,True,28.777266666666666,-1364,-4,-1,249,244,5
BR1_2731779973,1,False,0,0,0,14407,202,48,7.0,False,3,True,1,0,0,15558,216,60,7.4,True,29.63085,-1151,-2,-1,250,276,-26
BR1_2731764065,3,False,0,0,0,13808,184,56,6.8,False,6,True,0,0,0,15245,177,46,6.8,True,27.2664,-1437,-3,0,240,223,17
BR1_2727880484,7,False,0,0,0,13911,160,31,6.2,False,10,True,0,0,0,16911,182,44,7.0,True,27.08805,-3000,-3,0,191,226,-35
BR1_2730777022,8,False,1,0,0,16683,183,36,6.4,False,11,True,0,0,0,17413,137,60,6.6,True,25.860283333333335,-730,-3,1,219,197,22
BR1_2730106349,6,False,1,1,0,18505,239,60,7.4,False,3,True,0,0,0,15631,198,80,7.2,True,29.32955,2874,3,1,299,278,21
BR1_2729925666,12,True,0,0,0,19929,205,52,7.0,False,5,False,1,0,0,17234,192,71,7.0,True,28.74365,2695,7,-1,257,263,-6
BR1_2706139273,3,True,0,1,0,14291,147,48,6.4,False,7,False,1,0,0,15838,167,44,6.8,True,25.493333333333332,-1547,-4,-1,195,211,-16
BR1_2731856170,3,False,0,1,0,15905,165,72,7.0,True,3,True,1,0,0,15311,199,58,7.0,False,29.392533333333333,594,0,-1,237,257,-20
BR1_2730245225,5,True,1,0,0,16332,189,72,7.4,False,5,False,0,1,0,17495,183,64,7.2,True,28.853383333333333,-1163,0,1,261,247,14
BR1_2729707103,4,False,0,0,0,15321,183,55,6.8,False,10,True,1,0,0,19562,233,60,7.4,True,29.88005,-4241,-6,-1,238,293,-55
BR1_2729303510,4,False,1,0,0,17219,242,60,7.4,True,2,True,0,0,0,15078,196,50,7.0,False,27.697466666666667,2141,2,1,302,246,56
BR1_2731646012,10,False,0,1,0,18171,199,52,7.0,True,3,True,0,0,0,14908,171,52,6.4,False,25.971566666666668,3263,7,0,251,223,28
BR1_2725789399,6,True,1,1,0,17599,229,81,7.2,True,3,False,0,0,0,13831,175,33,6.8,False,26.966616666666667,3768,3,1,310,208,102
BR1_2731802008,11,True,1,1,0,17860,175,56,6.4,True,6,False,0,0,0,15878,183,53,6.4,False,25.073483333333332,1982,5,1,231,236,-5
BR1_2731737155,3,True,0,0,0,17376,274,56,7.6,True,5,False,0,0,0,17312,239,68,7.4,False,28.52765,64,-2,0,330,307,23
BR1_2726191495,7,True,0,0,0,17311,202,52,7.4,False,6,False,1,0,0,17870,259,80,8.0,True,28.53761666666667,-559,1,-1,254,339,-85
BR1_2731626677,3,False,0,0,0,15403,181,54,7.2,True,11,True,0,1,1,21092,197,60,7.0,False,29.1128,-5689,-8,0,235,257,-22
BR1_2694477299,4,False,0,0,0,15179,203,44,6.8,False,8,True,1,1,0,16485,181,60,7.2,True,25.08435,-1306,-4,-1,247,241,6
BR1_2694446365,7,False,0,0,0,17770,200,44,7.0,False,10,True,0,1,0,19643,208,64,7.2,True,29.49285,-1873,-3,0,244,272,-28
BR1_2694258698,6,True,1,0,0,16224,170,32,6.8,False,9,False,0,0,0,19663,232,60,7.6,True,28.003166666666665,-3439,-3,1,202,292,-90
BR1_2727303694,4,True,0,1,0,16613,166,72,6.8,True,10,False,0,0,0,19380,242,56,7.4,False,27.990066666666667,-2767,-6,0,238,298,-60
BR1_2681469442,9,False,0,0,0,16273,149,52,7.0,True,7,True,0,0,0,16737,185,48,6.8,False,26.560766666666666,-464,2,0,201,233,-32
BR1_2724569713,10,True,1,0,0,16552,166,39,6.2,True,6,False,0,1,0,16256,182,56,6.6,False,26.889116666666666,296,4,1,205,238,-33
BR1_2723980069,5,True,0,0,0,15757,221,52,7.0,True,1,False,0,0,0,13015,181,48,6.6,False,25.051,2742,4,0,273,229,44
BR1_2724258262,10,True,1,1,0,19706,234,56,7.4,True,6,False,0,0,0,17084,175,56,7.2,False,29.891366666666666,2622,4,1,290,231,59
BR1_2724254201,6,False,0,1,0,17172,198,56,7.6,False,9,True,1,0,0,19294,218,64,7.6,True,29.085533333333334,-2122,-3,-1,254,282,-28
BR1_2731628778,14,False,1,1,1,21054,204,52,7.2,False,9,True,0,0,0,19158,192,52,7.2,True,28.214816666666668,1896,5,1,256,244,12
BR1_2690356840,8,False,0,0,0,15818,184,56,6.6,False,10,True,1,1,0,18216,188,52,6.6,True,26.992183333333333,-2398,-2,-1,240,240,0
BR1_2731806378,1,False,1,0,0,13538,192,48,6.8,False,3,True,0,0,0,14757,192,56,6.6,True,25.995983333333335,-1219,-2,1,240,248,-8
BR1_2731750177,10,False,1,0,0,18089,195,52,6.8,False,9,True,0,0,0,16810,164,56,6.6,True,27.43085,1279,1,1,247,220,27
BR1_2681720644,5,False,1,0,0,14878,179,52,6.6,True,6,True,0,1,0,16459,211,56,7.0,False,26.6361,-1581,-1,1,231,267,-36
BR1_2680113058,4,True,1,1,0,15634,194,48,7.0,True,3,False,0,0,0,14415,170,68,6.6,False,26.860883333333334,1219,1,1,242,238,4
BR1_2680003266,8,False,0,1,0,16597,175,47,7.0,True,7,True,1,0,0,15345,145,56,6.8,False,25.7648,1252,1,-1,222,201,21
BR1_2679943985,10,True,1,0,0,18787,208,56,7.6,True,7,False,0,1,0,17558,174,60,7.2,False,28.919016666666668,1229,3,1,264,234,30
BR1_2731806868,9,True,0,0,0,18917,237,52,7.4,True,7,False,0,1,0,17467,235,52,7.4,False,27.572283333333335,1450,2,0,289,287,2
BR1_2730355867,3,True,0,0,0,15720,193,52,6.8,False,8,False,1,0,0,17579,237,48,7.4,True,27.659533333333332,-1859,-5,-1,245,285,-40
BR1_2716958402,6,True,0,1,0,15533,172,54,7.4,True,3,False,0,0,0,13297,180,49,6.8,False,26.970316666666665,2236,3,0,226,229,-3
BR1_2731745127,11,True,0,1,0,20162,223,60,7.0,True,9,False,0,0,0,17540,181,48,6.8,False,28.65045,2622,2,0,283,229,54
BR1_2731772297,9,False,0,0,0,18380,225,60,7.4,False,11,True,0,0,0,19855,246,56,7.6,True,28.622933333333332,-1475,-2,0,285,302,-17
BR1_2731707742,3,False,0,0,0,13206,144,52,6.8,False,3,True,1,0,0,15272,192,64,7.0,True,26.116066666666665,-2066,0,-1,196,256,-60
BR1_2712300860,9,True,1,1,0,18874,235,60,7.4,True,8,False,0,0,0,17022,216,48,7.8,False,29.968333333333334,1852,1,1,295,264,31
BR1_2727224573,10,True,1,0,0,18951,212,59,7.2,True,6,False,0,1,0,16916,213,65,7.2,False,28.659416666666665,2035,4,1,271,278,-7
BR1_2721749354,9,False,1,0,0,18607,217,52,7.2,False,7,True,0,0,0,18605,199,52,7.0,True,27.730533333333334,2,2,1,269,251,18
BR1_2721224490,10,False,0,0,0,17832,211,60,7.4,False,10,True,0,1,0,20243,215,72,7.6,True,28.482133333333334,-2411,0,0,271,287,-16
BR1_2724574492,7,False,1,0,0,18199,232,56,7.2,True,4,True,0,0,0,16478,196,60,6.8,False,29.574483333333333,1721,3,1,288,256,32
BR1_2729556846,7,False,1,0,0,18237,214,28,7.6,True,11,True,0,0,0,18588,160,71,7.0,False,29.6273,-351,-4,1,242,231,11
BR1_2718000054,9,True,1,0,0,18606,229,52,7.4,True,4,False,0,1,0,15215,181,60,7.0,False,29.019233333333332,3391,5,1,281,241,40
BR1_2717970706,8,False,1,1,0,16702,139,36,6.6,False,13,True,0,0,0,19197,200,32,7.0,True,28.4979,-2495,-5,1,175,232,-57
BR1_2712449618,10,False,1,1,0,18401,173,48,6.6,False,14,True,0,0,0,20430,146,40,6.8,True,29.09423333333333,-2029,-4,1,221,186,35
BR1_2730361078,9,True,0,0,0,17434,161,53,7.0,False,7,False,0,0,0,16685,220,50,6.8,True,25.065616666666667,749,2,0,214,270,-56
BR1_2731875718,8,False,0,1,0,18150,212,60,7.4,True,13,True,1,0,0,20346,199,52,7.6,False,28.47995,-2196,-5,-1,272,251,21
BR1_2730032854,10,True,1,0,0,16440,182,36,7.0,True,4,False,0,0,0,15876,222,55,6.8,False,25.068,564,6,1,218,277,-59
BR1_2731710731,6,False,0,1,0,16368,159,68,7.0,True,9,True,0,0,0,17721,187,34,7.0,False,28.178466666666665,-1353,-3,0,227,221,6
BR1_2731747264,7,True,0,0,0,16009,160,52,6.6,False,8,False,0,0,0,16111,193,48,6.8,True,25.65605,-102,-1,0,212,241,-29
BR1_2730235352,13,False,0,1,0,18824,145,42,7.2,False,12,True,0,0,1,20318,210,50,7.4,True,28.772883333333333,-1494,1,0,187,260,-73
BR1_2729265802,5,True,0,1,0,17336,206,64,7.6,False,4,False,1,0,0,16999,209,64,7.4,True,27.58965,337,1,-1,270,273,-3
BR1_2731075570,12,False,0,0,0,19247,176,60,6.8,True,8,True,0,1,0,17940,180,48,7.2,False,27.60025,1307,4,0,236,228,8
BR1_2731813996,7,True,1,0,0,16744,188,44,6.4,False,9,False,0,1,0,19167,233,56,7.2,True,29.289233333333332,-2423,-2,1,232,289,-57
BR1_2730784031,7,False,0,1,0,18840,246,80,7.6,True,7,True,1,0,0,18273,205,56,7.4,False,28.141166666666667,567,0,-1,326,261,65
BR1_2725017725,8,True,1,0,0,18621,259,56,7.6,True,5,False,0,0,0,18197,266,68,7.2,False,29.277783333333332,424,3,1,315,334,-19
BR1_2730544135,8,False,1,0,0,16839,213,54,6.8,True,9,True,0,0,0,17955,212,45,6.6,False,27.308683333333335,-1116,-1,1,267,257,10
BR1_2731812133,6,False,0,0,0,16236,193,60,7.0,True,8,True,1,0,0,16804,187,56,6.6,False,25.705983333333332,-568,-2,-1,253,243,10
BR1_2731738049,7,True,1,0,0,18035,240,47,7.8,False,3,False,0,1,0,17557,254,71,7.4,True,29.46085,478,4,1,287,325,-38
BR1_2730419772,5,False,0,0,0,16940,223,53,7.2,False,6,True,1,1,0,18403,229,76,7.2,True,28.514216666666666,-1463,-1,-1,276,305,-29
BR1_2730782162,8,True,0,0,0,18634,211,78,7.4,False,9,False,1,1,0,19971,255,76,8.0,True,28.441466666666667,-1337,-1,-1,289,331,-42
BR1_2725114574,7,False,0,0,0,19933,227,72,7.4,True,3,True,1,0,0,16087,215,52,6.8,False,28.5917,3846,4,-1,299,267,32
BR1_2731701868,2,False,0,0,0,13341,157,57,6.0,False,8,True,1,0,0,17473,205,63,7.0,True,27.005266666666667,-4132,-6,-1,214,268,-54
BR1_2731675191,10,True,1,0,0,18680,200,44,7.0,False,11,False,0,0,0,19381,249,51,7.0,True,28.016683333333333,-701,-1,1,244,300,-56
BR1_2726794681,7,True,1,1,0,17522,210,72,7.0,True,2,False,0,0,0,13856,192,52,6.8,False,27.03686666666667,3666,5,1,282,244,38
BR1_2731055422,5,False,0,0,0,17231,219,56,7.0,False,13,True,1,1,0,19913,236,60,7.4,True,29.7019,-2682,-8,-1,275,296,-21
BR1_2731034803,9,False,0,0,0,17249,195,44,7.0,False,13,True,0,1,0,18455,170,47,6.6,True,26.636616666666665,-1206,-4,0,239,217,22
BR1_2731839247,6,True,0,0,0,15263,184,48,6.6,False,2,False,0,0,0,14840,199,60,6.8,True,27.463033333333332,423,4,0,232,259,-27
BR1_2726023977,3,True,1,0,0,16302,223,58,7.4,True,5,False,0,0,0,17360,236,66,7.4,False,29.221933333333332,-1058,-2,1,281,302,-21
BR1_2725655577,1,False,0,0,0,13827,229,52,7.0,True,1,True,1,0,0,14349,255,52,7.0,False,27.08663333333333,-522,0,-1,281,307,-26
BR1_2729024941,2,False,0,1,0,14475,216,56,6.8,True,7,True,1,0,0,16686,220,56,7.2,False,27.151216666666667,-2211,-5,-1,272,276,-4
BR1_2731269451,8,True,0,1,0,19903,246,63,7.2,True,3,False,0,0,0,16675,239,55,7.0,False,28.773066666666665,3228,5,0,309,294,15
BR1_2731031656,12,True,0,0,0,20569,235,53,7.2,True,9,False,0,0,0,18725,218,57,7.2,False,27.731533333333335,1844,3,0,288,275,13
BR1_2731012459,12,False,0,0,0,19295,208,54,7.0,False,13,True,1,0,0,20457,243,53,7.4,True,29.969083333333334,-1162,-1,-1,262,296,-34
BR1_2729406862,8,True,0,0,0,17686,232,46,7.0,False,5,False,0,0,0,15679,189,58,6.6,True,27.063583333333334,2007,3,0,278,247,31
BR1_2729389142,11,False,0,0,0,18383,172,60,7.0,True,6,True,0,0,0,17255,238,32,7.0,False,28.27995,1128,5,0,232,270,-38
BR1_2729698756,8,True,1,0,0,17717,203,60,7.0,True,4,False,0,0,0,15455,196,48,7.0,False,26.11105,2262,4,1,263,244,19
BR1_2729224621,7,True,0,1,0,18565,222,49,7.4,True,6,False,1,0,0,17189,213,78,7.4,False,28.45865,1376,1,-1,271,291,-20
BR1_2730194837,9,False,1,0,0,17565,197,52,7.0,False,11,True,0,0,0,19846,201,67,7.4,True,28.70395,-2281,-2,1,249,268,-19
BR1_2699934898,8,True,0,1,0,20022,250,60,7.4,False,14,False,1,0,0,20621,235,68,7.8,True,27.687733333333334,-599,-6,-1,310,303,7
BR1_2684850841,2,False,0,0,0,15161,201,60,7.2,False,9,True,1,1,0,19872,232,62,7.8,True,28.98121666666667,-4711,-7,-1,261,294,-33
BR1_2684825783,7,False,0,0,0,17118,219,60,7.2,False,8,True,0,0,0,17013,209,36,6.6,True,27.345716666666668,105,-1,0,279,245,34
BR1_2728384936,5,False,1,0,0,16390,214,52,7.2,False,6,True,0,0,0,17061,213,52,7.2,True,29.7425,-671,-1,1,266,265,1
BR1_2728363871,4,False,1,0,0,15319,204,60,6.8,False,7,True,0,0,0,17170,212,55,7.0,True,25.006483333333332,-1851,-3,1,264,267,-3
BR1_2721224186,12,True,0,0,0,19586,217,48,7.2,True,6,False,1,1,0,15759,179,48,6.4,False,25.036216666666668,3827,6,-1,265,227,38
BR1_2731330174,11,False,0,1,0,20317,236,64,7.8,True,4,True,1,0,0,16109,220,48,7.0,False,29.27865,4208,7,-1,300,268,32
BR1_2731614698,6,False,0,0,0,17400,209,64,7.0,True,10,True,1,0,0,20920,236,60,7.4,False,29.48445,-3520,-4,-1,273,296,-23
BR1_2710066104,9,False,0,0,0,15288,114,64,6.0,True,6,True,0,0,1,17556,188,48,6.4,False,26.53865,-2268,3,0,178,236,-58
BR1_2730761245,9,True,0,1,0,18557,210,48,7.4,True,5,False,1,0,0,16120,208,52,7.2,False,27.58095,2437,4,-1,258,260,-2
BR1_2709262526,4,False,0,0,0,14683,182,56,6.6,False,8,True,1,1,0,17556,211,60,7.0,True,25.15973333333333,-2873,-4,-1,238,271,-33
BR1_2731751543,10,False,0,0,0,18005,192,56,7.0,True,5,True,0,0,0,16208,188,52,6.4,False,27.135,1797,5,0,248,240,8
BR1_2730272657,10,False,0,1,0,19709,216,44,7.2,True,13,True,1,0,0,21358,253,60,7.4,False,29.519766666666666,-1649,-3,-1,260,313,-53
BR1_2731814746,9,False,0,1,0,18711,197,60,7.0,True,9,True,0,0,0,19547,237,56,7.4,False,28.94845,-836,0,0,257,293,-36
BR1_2731371983,5,True,0,0,0,15690,223,38,6.6,False,5,False,1,0,0,15791,192,68,6.6,True,25.5202,-101,0,-1,261,260,1
BR1_2717898945,16,True,0,1,0,22022,214,78,7.6,True,6,False,0,0,0,17941,192,40,7.0,False,29.389866666666666,4081,10,0,292,232,60
BR1_2717725768,3,True,1,0,0,16264,214,37,7.0,True,11,False,0,1,0,20404,231,62,7.4,False,29.490983333333332,-4140,-8,1,251,293,-42
BR1_2717711703,7,False,1,0,0,16733,229,51,6.8,True,1,True,0,0,0,13052,160,53,6.6,False,25.763633333333335,3681,6,1,280,213,67
BR1_2731061249,9,False,1,0,0,17305,224,46,6.8,True,3,True,0,0,0,13710,165,44,6.4,False,27.1299,3595,6,1,270,209,61
BR1_2711896020,8,False,1,1,0,17317,223,52,7.0,True,4,True,0,0,0,14855,212,44,6.6,False,26.702183333333334,2462,4,1,275,256,19
BR1_2730757936,14,True,0,0,0,19809,190,48,6.8,True,2,False,0,0,0,13994,187,52,6.6,False,26.24651666666667,5815,12,0,238,239,-1
BR1_2730691072,9,False,0,1,1,20706,220,44,7.2,True,10,True,1,0,0,18001,188,48,6.8,False,28.535166666666665,2705,-1,-1,264,236,28
BR1_2731320431,14,True,1,0,0,21221,193,73,7.2,True,14,False,0,1,1,23252,208,58,7.4,False,29.20115,-2031,0,1,266,266,0
BR1_2731826545,6,True,0,0,0,17841,198,56,7.6,True,7,False,1,0,0,17470,172,80,7.2,False,27.592166666666667,371,-1,-1,254,252,2
BR1_2723721901,15,True,1,1,0,21563,239,48,7.2,True,12,False,0,0,0,19082,169,55,6.8,False,29.48185,2481,3,1,287,224,63
BR1_2723710848,6,False,0,0,0,15726,174,40,6.4,False,12,True,1,0,0,19605,210,48,6.8,True,25.1043,-3879,-6,-1,214,258,-44
BR1_2725898757,5,True,0,1,0,17186,198,64,7.0,True,5,False,1,0,0,17768,266,63,7.4,False,28.9856,-582,0,-1,262,329,-67
BR1_2722192431,10,True,1,0,0,16369,188,52,6.8,True,7,False,0,0,0,16261,201,40,6.8,False,27.062283333333333,108,3,1,240,241,-1
BR1_2721988116,6,True,1,0,0,17073,201,56,7.0,False,12,False,0,1,0,20679,238,64,7.6,True,28.312466666666666,-3606,-6,1,257,302,-45
BR1_2721896709,9,False,0,1,0,17659,213,48,7.4,True,6,True,0,0,0,16372,215,68,7.2,False,26.2746,1287,3,0,261,283,-22
BR1_2729095150,3,False,0,1,0,16077,242,52,7.0,True,4,True,0,0,0,15060,206,46,7.0,False,26.171733333333332,1017,-1,0,294,252,42
BR1_2729065987,5,True,0,0,0,17063,249,64,7.4,False,6,False,1,1,0,18672,256,64,7.8,True,27.630166666666668,-1609,-1,-1,313,320,-7
BR1_2729041987,2,True,0,0,0,14795,213,48,6.8,True,1,False,1,1,0,14016,213,60,6.8,False,26.86703333333333,779,1,-1,261,273,-12
BR1_2731656781,6,True,0,0,0,16383,196,55,6.4,True,6,False,0,0,0,15951,201,47,6.6,False,25.361633333333334,432,0,0,251,248,3
BR1_2731155443,7,False,0,0,0,17151,203,48,7.0,True,10,True,0,0,0,19528,263,64,7.6,False,28.817233333333334,-2377,-3,0,251,327,-76
BR1_2731685274,7,False,1,0,0,17021,240,52,7.2,True,3,True,0,0,0,15603,254,44,6.8,False,25.6813,1418,4,1,292,298,-6
BR1_2722885674,2,True,1,0,0,13653,196,48,6.8,False,5,False,0,1,0,16135,198,52,6.8,True,25.05795,-2482,-3,1,244,250,-6
BR1_2731663934,11,True,0,1,1,20675,214,56,7.4,False,10,False,1,0,0,18842,178,71,7.6,True,29.73315,1833,1,-1,270,249,21
BR1_2731641897,12,True,1,0,0,20042,199,52,7.2,True,2,False,0,0,0,15424,216,56,6.8,False,27.62,4618,10,1,251,272,-21
BR1_2730826576,7,False,0,0,0,16144,152,48,6.2,True,11,True,1,0,0,17527,172,43,6.6,False,25.5624,-1383,-4,-1,200,215,-15
BR1_2724897313,4,False,0,0,0,15839,240,44,7.0,False,7,True,0,0,0,18259,225,84,7.6,True,27.892216666666666,-2420,-3,0,284,309,-25
BR1_2712905064,7,True,0,1,1,17816,177,64,6.8,True,5,False,1,0,0,15784,195,60,6.8,False,27.26245,2032,2,-1,241,255,-14
BR1_2730679331,10,False,0,0,0,19337,216,48,7.0,False,10,True,1,0,0,19678,243,80,7.6,True,28.97795,-341,0,-1,264,323,-59
BR1_2721364542,8,False,0,0,0,17810,175,59,7.2,True,11,True,0,0,0,19335,186,64,6.8,False,27.756766666666667,-1525,-3,0,234,250,-16
BR1_2731770229,9,True,1,0,0,18132,210,62,7.4,False,5,False,0,0,0,17124,264,44,7.4,True,29.002633333333332,1008,4,1,272,308,-36
BR1_2731681107,7,False,0,0,0,17422,213,58,7.4,True,10,True,0,0,0,17663,181,61,7.4,False,29.96535,-241,-3,0,271,242,29
BR1_2731279315,13,True,1,0,1,20478,228,60,7.2,False,11,False,0,1,0,21757,246,64,7.6,True,28.48875,-1279,2,1,288,310,-22
BR1_2730135806,7,True,0,0,0,18263,234,51,7.2,True,7,False,1,1,0,18001,213,63,7.2,False,29.662016666666666,262,0,-1,285,276,9
BR1_2730308817,13,True,0,0,0,18450,201,36,6.8,False,9,False,0,1,0,17029,156,68,6.8,True,26.110233333333333,1421,4,0,237,224,13
BR1_2718317160,8,False,1,0,0,17485,163,72,7.0,False,7,True,0,0,0,19002,217,48,7.0,True,29.349216666666667,-1517,1,1,235,265,-30
BR1_2729175147,12,False,1,0,0,18768,207,55,7.0,True,6,True,0,0,0,15296,157,39,6.2,False,25.550933333333333,3472,6,1,262,196,66
BR1_2731017707,3,False,1,0,0,14877,219,52,6.6,False,13,True,0,0,0,19208,208,72,7.2,True,25.121433333333332,-4331,-10,1,271,280,-9
BR1_2730821660,10,True,0,0,0,19378,238,32,7.2,False,7,False,1,0,0,17683,176,60,7.0,True,28.425383333333333,1695,3,-1,270,236,34
BR1_2731548229,5,False,0,1,1,17080,244,72,7.0,False,10,True,1,0,0,21801,257,52,7.4,True,29.96335,-4721,-5,-1,316,309,7
BR1_2731574456,7,True,0,0,0,17503,197,56,6.8,False,9,False,1,0,0,19579,234,67,7.6,True,28.324533333333335,-2076,-2,-1,253,301,-48
BR1_2731558694,7,False,1,0,0,18524,230,60,7.6,True,6,True,0,1,0,17908,212,56,7.2,False,28.5942,616,1,1,290,268,22
BR1_2730036199,10,True,0,1,0,18407,230,44,7.4,False,6,False,0,0,0,17918,248,60,7.4,True,28.490483333333334,489,4,0,274,308,-34
BR1_2731791695,4,False,0,1,0,16104,203,52,7.0,False,7,True,1,0,0,16649,199,52,7.0,True,26.78836666666667,-545,-3,-1,255,251,4
BR1_2709187728,9,False,0,0,0,17750,221,48,6.4,True,7,True,0,0,0,16978,206,52,6.8,False,26.009783333333335,772,2,0,269,258,11
BR1_2731725371,10,False,0,0,0,17053,148,40,6.6,False,11,True,1,0,0,18000,195,60,6.8,True,26.73865,-947,-1,-1,188,255,-67
BR1_2730515384,5,True,0,0,0,18019,273,64,7.4,True,5,False,1,1,0,16625,236,64,7.6,False,28.0272,1394,0,-1,337,300,37
BR1_2714712080,9,True,0,0,0,17887,224,52,6.8,True,3,False,1,0,0,14077,169,56,6.2,False,26.868866666666666,3810,6,-1,276,225,51
BR1_2730290492,7,False,0,0,0,16769,208,44,6.8,True,10,True,0,0,0,17305,178,50,6.6,False,25.03595,-536,-3,0,252,228,24
BR1_2725757157,10,False,0,0,0,17883,199,55,6.6,True,10,True,0,0,0,18407,183,47,6.8,False,27.223366666666667,-524,0,0,254,230,24
BR1_2731825180,8,True,0,0,0,15797,198,32,6.6,True,5,False,0,0,0,15824,196,47,7.0,False,27.401583333333335,-27,3,0,230,243,-13
BR1_2731078368,6,False,0,0,0,17240,229,48,7.4,False,8,True,1,1,0,19297,222,64,7.4,True,28.550466666666665,-2057,-2,-1,277,286,-9
BR1_2703697212,13,True,0,0,0,19959,232,47,7.2,False,10,False,1,0,0,18612,193,64,7.0,True,29.04915,1347,3,-1,279,257,22
BR1_2703376476,11,False,1,0,0,19829,230,78,7.6,True,5,True,0,1,0,16654,218,61,7.0,False,28.086316666666665,3175,6,1,308,279,29
BR1_2731601205,14,True,1,1,1,22255,258,76,7.6,False,5,False,0,0,0,16474,211,56,7.2,True,29.713266666666666,5781,9,1,334,267,67
BR1_2731279158,3,True,0,0,0,14353,180,52,6.6,False,4,False,1,0,0,15486,211,60,7.0,True,27.401,-1133,-1,-1,232,271,-39
BR1_2660730273,4,False,0,0,0,16028,217,44,7.0,True,10,True,1,0,0,20023,266,68,8.0,False,28.712766666666667,-3995,-6,-1,261,334,-73
BR1_2731124937,11,True,0,1,0,19133,205,56,7.4,True,5,False,0,0,0,14036,126,45,6.0,False,25.635516666666668,5097,6,0,261,171,90
BR1_2731618418,3,True,0,1,0,14424,176,44,6.4,False,6,False,1,0,0,15868,199,64,6.6,True,27.410116666666667,-1444,-3,-1,220,263,-43
BR1_2692928518,12,False,0,0,0,19572,244,51,7.4,True,11,True,0,0,0,18540,189,56,7.0,False,28.0303,1032,1,0,295,245,50
BR1_2692914192,10,False,0,0,0,17498,212,53,7.0,True,4,True,0,0,0,15748,200,48,6.6,False,25.73356666666667,1750,6,0,265,248,17
BR1_2731788934,11,True,1,0,0,17757,174,52,7.0,False,6,False,0,0,0,19071,251,52,7.4,True,28.553383333333333,-1314,5,1,226,303,-77
BR1_2714629094,6,False,1,0,0,16828,196,52,7.0,True,4,True,0,0,0,15699,215,51,7.0,False,28.586466666666666,1129,2,1,248,266,-18
BR1_2731294336,12,False,0,0,0,19766,182,42,7.2,False,12,True,1,1,0,19410,179,44,7.4,True,29.860583333333334,356,0,-1,224,223,1
BR1_2693564732,6,False,0,0,0,16328,204,53,6.8,False,10,True,1,1,0,17825,189,58,6.6,True,26.493933333333334,-1497,-4,-1,257,247,10
BR1_2706285929,11,False,1,0,0,18910,192,64,7.0,True,3,True,0,0,0,14721,175,55,6.2,False,25.986116666666668,4189,8,1,256,230,26
BR1_2706255403,7,True,1,0,0,18255,244,68,7.6,False,6,False,0,1,0,18462,243,56,7.4,True,28.559233333333335,-207,1,1,312,299,13
BR1_2706165568,9,True,1,0,0,16874,209,32,6.6,False,4,False,0,0,0,15235,205,48,6.6,True,25.482033333333334,1639,5,1,241,253,-12
BR1_2723664085,5,True,1,0,0,15501,213,44,6.6,False,8,False,0,0,0,17510,227,76,7.2,True,26.566433333333332,-2009,-3,1,257,303,-46
BR1_2731445542,4,False,1,0,0,15505,191,52,6.4,True,13,True,0,0,0,19036,188,52,6.8,False,26.775516666666668,-3531,-9,1,243,240,3
BR1_2731411026,5,False,0,1,0,17228,232,50,7.4,True,6,True,1,0,0,17496,242,54,7.2,False,28.447033333333334,-268,-1,-1,282,296,-14
BR1_2731729278,12,False,0,0,0,18442,198,56,6.6,True,12,True,0,0,0,18121,169,44,6.6,False,26.144016666666666,321,0,0,254,213,41
BR1_2731226583,7,False,0,0,0,18092,222,56,7.2,True,8,True,1,0,0,17554,217,59,7.2,False,28.623583333333332,538,-1,-1,278,276,2
BR1_2730315781,8,True,1,1,0,17027,195,64,7.0,True,3,False,0,0,0,13656,173,44,6.8,False,27.115983333333332,3371,5,1,259,217,42
BR1_2728986880,9,True,1,0,0,20532,245,64,7.6,True,8,False,0,1,0,17929,227,54,7.6,False,27.845183333333335,2603,1,1,309,281,28
BR1_2728509040,11,True,0,1,0,20366,252,68,8.0,True,7,False,1,0,0,18199,213,56,7.2,False,29.061583333333335,2167,4,-1,320,269,51
BR1_2731723887,6,False,0,0,1,19214,240,39,7.4,False,9,True,1,1,0,19486,206,67,7.6,True,28.581983333333334,-272,-3,-1,279,273,6
BR1_2731815370,4,False,1,0,0,14752,204,45,6.6,True,2,True,0,1,0,14613,193,72,6.8,False,27.06485,139,2,1,249,265,-16
BR1_2731818941,10,False,1,0,0,20358,261,60,7.6,True,7,True,0,0,0,17375,229,56,7.0,False,28.452566666666666,2983,3,1,321,285,36
BR1_2730669809,11,True,0,0,0,20347,196,52,7.4,True,8,False,1,1,0,18792,229,56,7.4,False,29.06725,1555,3,-1,248,285,-37
BR1_2725711037,13,False,0,0,0,18436,163,44,6.4,True,10,True,1,0,0,16281,148,48,6.0,False,27.05295,2155,3,-1,207,196,11
BR1_2716342186,6,False,0,0,0,15918,210,59,6.6,True,6,True,1,0,0,16470,219,40,6.8,False,25.186016666666667,-552,0,-1,269,259,10
BR1_2731455349,5,True,0,0,0,17552,236,37,7.2,True,13,False,1,1,0,20049,231,35,7.6,False,29.854683333333334,-2497,-8,-1,273,266,7
BR1_2731770645,8,True,0,1,0,19324,247,76,8.0,True,1,False,1,0,0,16937,269,72,7.4,False,28.57275,2387,7,-1,323,341,-18
BR1_2731745703,13,True,1,0,0,19962,207,60,7.0,True,11,False,0,0,0,19771,200,68,7.4,False,29.903883333333333,191,2,1,267,268,-1
BR1_2731839032,5,True,1,1,0,17655,200,68,7.0,False,7,False,0,0,0,18483,231,56,7.4,True,29.010616666666667,-828,-2,1,268,287,-19
BR1_2730094398,3,True,0,0,0,15106,224,56,6.4,True,1,False,1,1,0,14314,234,51,6.8,False,26.56335,792,2,-1,280,285,-5
BR1_2726125685,7,True,1,0,0,15850,169,68,6.4,False,7,False,0,0,0,16722,207,44,6.8,True,26.910083333333333,-872,0,1,237,251,-14
BR1_2724607482,10,True,0,0,0,19289,248,52,7.6,False,10,False,0,0,0,18680,249,48,7.4,True,28.486066666666666,609,0,0,300,297,3
BR1_2723235252,7,True,0,0,0,15467,167,59,6.8,True,6,False,1,0,0,16725,179,52,6.4,False,27.205333333333332,-1258,1,-1,226,231,-5
BR1_2723211116,6,False,1,0,0,15652,188,52,6.8,False,5,True,0,0,0,15837,190,56,6.4,True,26.949283333333334,-185,1,1,240,246,-6
BR1_2731797877,5,True,0,0,0,17120,225,48,7.0,False,11,False,1,0,0,20325,251,67,7.8,True,29.661383333333333,-3205,-6,-1,273,318,-45
BR1_2729888177,9,True,0,1,0,20382,262,84,7.6,True,6,False,1,0,0,17012,229,44,7.4,False,27.576333333333334,3370,3,-1,346,273,73
BR1_2729394649,7,False,0,0,0,18526,232,52,7.6,False,5,True,1,0,0,16631,197,48,6.8,True,29.127266666666667,1895,2,-1,284,245,39
BR1_2729743396,8,True,1,0,0,19455,225,56,7.0,True,13,False,0,1,0,20232,248,52,7.0,False,28.396316666666667,-777,-5,1,281,300,-19
BR1_2729726150,4,False,0,0,0,15218,194,52,6.6,False,7,True,0,0,0,17150,220,52,6.6,True,26.001266666666666,-1932,-3,0,246,272,-26
BR1_2731253900,7,False,0,0,0,16496,205,48,6.4,True,7,True,0,0,0,15871,176,56,6.2,False,27.0924,625,0,0,253,232,21
BR1_2707903617,4,True,1,0,0,14738,224,52,6.6,True,3,False,0,0,0,15020,210,60,6.6,False,26.186366666666668,-282,1,1,276,270,6
BR1_2731783683,8,True,0,1,0,18524,205,56,7.6,False,9,False,1,0,0,18289,197,63,7.6,True,28.114983333333335,235,-1,-1,261,260,1
BR1_2731587367,9,False,0,1,0,17234,187,56,7.0,True,5,True,0,0,0,15875,206,60,7.0,False,25.0035,1359,4,0,243,266,-23
BR1_2731111630,12,False,0,0,0,19532,198,48,7.0,True,10,True,1,1,1,21455,195,60,6.8,False,28.0854,-1923,2,-1,246,255,-9
BR1_2720535986,7,True,0,1,0,18431,212,75,7.2,False,6,False,0,0,0,17764,241,48,7.4,True,28.19965,667,1,0,287,289,-2
BR1_2731359607,4,False,0,0,0,15101,190,64,6.8,False,8,True,1,0,0,16759,218,52,6.8,True,27.162566666666667,-1658,-4,-1,254,270,-16
BR1_2723841262,8,True,1,0,0,18030,213,59,7.2,True,7,False,0,1,0,17728,251,60,7.4,False,29.071516666666668,302,1,1,272,311,-39
BR1_2723825700,6,False,0,0,0,16606,203,52,6.6,False,11,True,1,0,0,18336,221,48,7.0,True,25.131416666666667,-1730,-5,-1,255,269,-14
BR1_2723818253,15,True,0,0,0,20977,226,45,6.8,True,7,False,0,1,0,14779,137,41,6.2,False,27.4943,6198,8,0,271,178,93
BR1_2720595457,6,True,1,0,0,16273,235,52,6.8,True,0,False,0,1,0,13178,192,60,6.4,False,26.63308333333333,3095,6,1,287,252,35
BR1_2731240627,10,True,1,0,0,17974,236,48,6.8,True,2,False,0,0,0,14951,232,64,6.8,False,27.401483333333335,3023,8,1,284,296,-12
BR1_2731165070,6,True,0,0,0,16009,204,40,6.6,False,8,False,1,0,0,16932,194,60,7.0,True,25.810433333333332,-923,-2,-1,244,254,-10
BR1_2730853453,10,False,0,1,0,20048,206,68,7.4,True,11,True,0,0,0,19799,195,56,7.2,False,29.129516666666667,249,-1,0,274,251,23
BR1_2725014298,11,False,1,1,0,21044,240,64,7.8,True,9,True,0,0,0,18619,219,60,7.6,False,28.40795,2425,2,1,304,279,25
BR1_2731193759,10,False,0,0,0,16696,167,48,6.4,False,10,True,0,0,0,18429,192,56,6.6,True,27.31335,-1733,0,0,215,248,-33
BR1_2713697209,6,True,0,1,0,17986,226,56,7.6,True,6,False,1,0,0,16961,207,72,7.4,False,28.87698333333333,1025,0,-1,282,279,3
BR1_2731490632,5,False,0,1,0,17185,227,63,7.4,False,10,True,1,0,0,19905,241,52,7.4,True,29.16645,-2720,-5,-1,290,293,-3
BR1_2717759812,4,False,0,0,0,17275,230,72,7.0,False,5,True,1,1,0,17591,240,68,7.4,True,28.190383333333333,-316,-1,-1,302,308,-6
BR1_2729360862,11,False,0,0,0,18721,227,38,7.6,True,4,True,0,1,0,16792,207,62,7.2,False,28.8632,1929,7,0,265,269,-4
BR1_2729339431,5,False,0,0,0,17697,245,52,7.4,False,5,True,1,0,0,18052,253,67,7.6,True,29.234566666666666,-355,0,-1,297,320,-23
BR1_2729294892,3,False,0,0,0,13839,183,39,6.6,False,7,True,1,1,0,16768,189,62,6.6,True,26.610416666666666,-2929,-4,-1,222,251,-29
BR1_2729261013,15,True,1,0,0,22060,250,60,7.8,True,5,False,0,1,0,17509,221,56,7.2,False,28.317983333333334,4551,10,1,310,277,33
BR1_2723058404,9,False,0,0,1,18629,170,46,7.0,False,20,True,1,1,0,25622,241,74,8.0,True,29.222716666666667,-6993,-11,-1,216,315,-99
BR1_2718550829,3,False,0,0,0,15150,200,56,7.4,False,11,True,1,1,0,20967,253,56,7.4,True,29.271516666666667,-5817,-8,-1,256,309,-53
BR1_2730741674,7,False,1,0,0,18925,249,60,7.8,False,7,True,0,0,0,18328,213,68,7.2,True,29.830466666666666,597,0,1,309,281,28
BR1_2711622929,6,True,0,0,0,17315,247,46,7.4,True,6,False,1,0,0,16162,181,60,7.0,False,29.72845,1153,0,-1,293,241,52
BR1_2711597514,11,False,0,0,0,19458,204,44,7.0,False,14,True,1,0,0,21127,217,75,7.6,True,28.637366666666665,-1669,-3,-1,248,292,-44
BR1_2714922304,9,True,0,1,0,19085,239,70,7.6,False,6,False,1,0,0,18215,243,46,7.4,True,29.023516666666666,870,3,-1,309,289,20
BR1_2702501405,7,True,0,1,0,19038,221,64,7.2,True,6,False,0,0,0,17106,200,52,7.2,False,29.048583333333333,1932,1,0,285,252,33
BR1_2702445207,4,True,1,0,0,15574,214,60,7.0,True,3,False,0,1,0,14864,178,76,7.0,False,26.8937,710,1,1,274,254,20
BR1_2702389164,7,False,1,0,0,17008,202,56,7.0,True,5,True,0,0,0,16362,240,52,6.8,False,26.914783333333332,646,2,1,258,292,-34
BR1_2731771750,5,False,1,0,0,17533,256,52,7.4,True,4,True,0,1,0,16345,237,64,7.4,False,28.4082,1188,1,1,308,301,7
BR1_2730587677,6,False,0,0,0,15766,194,48,7.0,False,12,True,0,0,0,19529,247,40,7.0,True,27.1039,-3763,-6,0,242,287,-45
BR1_2730050881,7,True,1,1,0,16141,202,48,6.8,True,4,False,0,0,0,14713,179,44,6.6,False,26.63295,1428,3,1,250,223,27
BR1_2714174621,5,False,0,0,0,15357,193,52,7.0,False,7,True,1,1,0,16905,215,64,7.0,True,26.42585,-1548,-2,-1,245,279,-34
BR1_2730363892,6,True,1,0,0,16657,206,44,6.6,True,6,False,0,0,0,15236,199,55,6.8,False,26.842383333333334,1421,0,1,250,254,-4
BR1_2731658399,11,True,1,1,0,17422,181,48,6.6,True,6,False,0,0,0,14751,154,42,6.2,False,25.91235,2671,5,1,229,196,33
BR1_2731282153,1,False,0,1,0,16375,277,64,7.6,False,3,True,1,0,0,16349,263,68,7.4,True,28.829783333333335,26,-2,-1,341,331,10
BR1_2730140144,7,True,0,0,0,17963,208,52,6.6,False,8,False,1,0,0,18001,183,64,6.8,True,28.038833333333333,-38,-1,-1,260,247,13
BR1_2723493350,6,True,0,1,0,17821,210,60,6.8,True,9,False,1,0,0,18283,192,44,7.0,False,29.37255,-462,-3,-1,270,236,34
BR1_2730772338,9,True,1,0,0,17577,198,44,6.8,True,4,False,0,0,0,15332,200,47,6.8,False,25.909816666666668,2245,5,1,242,247,-5
BR1_2727186054,5,False,0,0,0,17994,247,60,7.4,False,8,True,0,0,0,18935,207,63,7.4,True,28.56225,-941,-3,0,307,270,37
BR1_2727171799,13,True,0,0,1,19429,204,52,6.4,True,11,False,1,0,0,17264,179,48,6.4,False,27.45725,2165,2,-1,256,227,29
BR1_2692657326,1,False,0,0,0,13683,219,48,6.6,False,7,True,0,0,0,16981,198,52,7.0,True,26.621316666666665,-3298,-6,0,267,250,17
BR1_2691671951,5,True,0,0,0,16942,223,56,7.2,False,6,False,1,1,1,19468,241,60,7.4,True,28.559183333333333,-2526,-1,-1,279,301,-22
BR1_2730630197,3,False,1,0,0,16745,236,52,7.4,True,3,True,0,1,0,16069,207,64,7.4,False,29.447533333333332,676,0,1,288,271,17
BR1_2720781198,5,False,0,0,0,17961,229,80,7.8,False,7,True,1,0,0,17676,240,52,7.4,True,27.60625,285,-2,-1,309,292,17
BR1_2720755365,12,False,1,0,0,20577,208,52,7.2,False,14,True,0,1,0,21304,212,60,7.4,True,29.151133333333334,-727,-2,1,260,272,-12
BR1_2728788017,7,False,0,1,0,16176,204,55,7.0,False,7,True,1,0,0,17887,231,69,7.0,True,26.688333333333333,-1711,0,-1,259,300,-41
BR1_2731109703,10,True,0,0,0,17336,213,48,6.8,False,8,False,1,0,0,17210,209,51,6.8,True,26.737933333333334,126,2,-1,261,260,1
BR1_2731496519,8,False,1,1,0,18542,236,48,7.2,True,9,True,0,0,0,18122,158,52,7.0,False,28.0591,420,-1,1,284,210,74
BR1_2731278414,11,False,0,0,0,18437,206,36,6.8,True,5,True,0,0,0,15550,198,64,6.4,False,26.0863,2887,6,0,242,262,-20
BR1_2731367299,9,False,1,1,0,18484,171,64,7.0,True,7,True,0,0,0,16484,212,48,6.6,False,26.057433333333332,2000,2,1,235,260,-25
BR1_2731879511,4,False,0,0,0,15758,193,64,6.8,False,8,True,1,0,0,18252,246,76,7.2,True,27.027833333333334,-2494,-4,-1,257,322,-65
BR1_2731290986,6,True,1,0,0,16649,196,48,7.0,True,3,False,0,0,0,14608,195,60,7.0,False,27.4519,2041,3,1,244,255,-11
BR1_2730813548,13,True,1,0,0,20640,220,48,7.2,True,8,False,0,1,0,16453,183,44,7.2,False,28.738366666666668,4187,5,1,268,227,41
BR1_2730210079,8,True,1,0,0,17411,199,64,7.0,True,5,False,0,0,0,15370,181,56,6.6,False,25.750016666666667,2041,3,1,263,237,26
BR1_2729876714,7,False,0,0,0,17662,192,66,7.2,False,8,True,1,1,0,20119,220,60,7.6,True,28.027783333333332,-2457,-1,-1,258,280,-22
BR1_2730979488,12,True,1,1,0,18579,194,64,7.2,True,5,False,0,0,0,15041,186,52,6.6,False,25.912333333333333,3538,7,1,258,238,20
BR1_2731743483,9,True,1,0,0,18416,215,53,6.8,True,12,False,0,0,0,18680,226,56,7.2,False,29.531116666666666,-264,-3,1,268,282,-14
BR1_2724584463,1,False,0,0,0,12819,182,48,6.0,False,12,True,1,1,0,18489,214,52,6.8,True,27.17635,-5670,-11,-1,230,266,-36
BR1_2717957788,7,False,0,0,0,17878,197,60,7.4,True,9,True,0,0,0,18824,243,48,7.2,False,28.104533333333332,-946,-2,0,257,291,-34
BR1_2731320972,9,False,1,0,0,19455,258,72,7.8,True,3,True,0,0,0,16115,195,56,7.2,False,29.949,3340,6,1,330,251,79
BR1_2731306410,3,False,1,0,0,13637,157,56,6.6,True,4,True,0,0,0,15116,189,56,6.8,False,26.68935,-1479,-1,1,213,245,-32
BR1_2730685580,5,True,0,0,0,16013,209,56,6.8,False,8,False,0,0,0,17335,212,52,6.6,True,25.23485,-1322,-3,0,265,264,1
BR1_2731800594,5,False,0,1,0,16095,193,48,6.6,False,7,True,0,0,0,16963,209,52,6.8,True,27.171283333333335,-868,-2,0,241,261,-20
BR1_2731761625,8,False,0,0,0,17521,219,44,6.6,False,9,True,1,0,0,18200,223,68,7.0,True,27.1716,-679,-1,-1,263,291,-28
BR1_2731169174,12,True,1,0,0,20180,222,54,7.2,False,12,False,0,0,0,21839,222,66,7.4,True,28.458683333333333,-1659,0,1,276,288,-12
BR1_2728677972,5,False,0,0,0,18099,259,52,7.2,True,4,True,0,1,0,16813,244,46,7.0,False,28.821883333333332,1286,1,0,311,290,21
BR1_2731176661,5,False,0,0,0,17154,231,59,7.0,True,5,True,0,0,0,17791,274,60,7.8,False,27.716516666666667,-637,0,0,290,334,-44
BR1_2730227123,4,False,0,0,0,16204,213,42,6.8,False,7,True,1,0,0,18446,253,60,7.2,True,29.603516666666668,-2242,-3,-1,255,313,-58
BR1_2730198138,8,True,1,0,0,17181,212,52,7.0,False,9,False,0,1,0,19474,221,56,7.8,True,29.969433333333335,-2293,-1,1,264,277,-13
BR1_2721275511,10,True,1,1,0,18216,222,48,7.0,True,6,False,0,0,0,16869,216,60,6.8,False,25.251183333333334,1347,4,1,270,276,-6
BR1_2727833518,15,False,0,1,0,20630,205,64,7.4,True,9,True,0,0,0,18722,217,56,7.0,False,28.001116666666668,1908,6,0,269,273,-4
BR1_2697610808,6,False,0,0,0,16671,217,60,7.4,True,7,True,1,0,0,17004,187,68,7.4,False,27.5917,-333,-1,-1,277,255,22
BR1_2697595712,6,False,0,1,0,17314,180,60,6.8,False,12,True,1,0,0,20251,213,64,7.4,True,27.949033333333333,-2937,-6,-1,240,277,-37
BR1_2731812413,10,False,0,0,0,20376,239,60,7.6,True,9,True,0,0,0,18734,217,56,7.4,False,29.518166666666666,1642,1,0,299,273,26
BR1_2731783962,8,True,1,0,0,18329,232,52,7.4,True,8,False,0,0,0,18068,266,64,7.6,False,29.184783333333332,261,0,1,284,330,-46
BR1_2731590990,14,False,1,0,0,18732,164,56,7.2,False,10,True,0,1,0,18394,196,52,6.8,True,27.491433333333333,338,4,1,220,248,-28
BR1_2703596722,6,False,1,1,0,16441,169,60,7.0,True,9,True,0,0,0,18478,237,44,7.6,False,29.94483333333333,-2037,-3,1,229,281,-52
BR1_2719633559,12,False,0,1,1,21125,237,64,7.2,True,7,True,0,0,0,17165,189,60,6.8,False,27.70635,3960,5,0,301,249,52
BR1_2716596038,12,True,0,0,0,19823,208,60,7.2,False,15,False,1,0,1,22821,199,60,7.4,True,29.388116666666665,-2998,-3,-1,268,259,9
BR1_2730114686,7,True,1,0,0,14931,185,52,7.2,True,4,False,0,0,0,15700,191,52,7.0,False,26.93655,-769,3,1,237,243,-6
BR1_2718331328,7,True,0,0,0,15960,182,48,6.6,True,12,False,1,0,0,18910,187,56,6.6,False,25.3509,-2950,-5,-1,230,243,-13
BR1_2718305843,6,True,0,0,0,16079,198,50,6.8,False,7,False,0,1,0,17352,206,48,6.8,True,25.750333333333334,-1273,-1,0,248,254,-6
BR1_2705903647,8,True,1,1,0,18741,239,72,7.4,True,4,False,0,0,0,16584,245,59,7.4,False,29.544416666666667,2157,4,1,311,304,7
BR1_2731867954,6,True,0,0,0,15626,164,42,6.6,False,5,False,1,0,0,15385,188,53,6.8,True,27.084033333333334,241,1,-1,206,241,-35
BR1_2731351102,3,False,0,0,0,14397,188,52,6.6,False,10,True,0,0,0,18514,205,60,6.6,True,25.201866666666668,-4117,-7,0,240,265,-25
BR1_2730828969,8,True,1,0,0,18138,229,52,7.0,True,7,False,0,0,0,16627,214,44,6.6,False,27.35396666666667,1511,1,1,281,258,23
BR1_2730743952,8,True,0,1,0,17367,200,48,7.0,True,9,False,1,0,0,17858,214,64,7.0,False,26.945366666666665,-491,-1,-1,248,278,-30
BR1_2721381540,10,True,0,0,0,17445,154,48,6.4,False,10,False,0,0,0,18233,193,44,6.4,True,25.060933333333335,-788,0,0,202,237,-35
BR1_2728410087,12,False,0,1,0,21422,237,42,7.4,True,5,True,0,0,0,16908,186,69,6.8,False,28.61306666666667,4514,7,0,279,255,24
BR1_2731497382,4,False,1,0,0,17018,198,56,7.0,False,8,True,0,1,0,19719,253,80,7.4,True,28.437133333333332,-2701,-4,1,254,333,-79
BR1_2731481754,3,False,0,1,0,17587,283,64,7.6,True,3,True,1,0,0,15521,216,64,7.8,False,29.250683333333335,2066,0,-1,347,280,67
BR1_2730941293,8,True,0,0,0,15767,142,52,6.2,False,12,False,1,0,0,18784,208,52,6.8,True,26.095183333333335,-3017,-4,-1,194,260,-66
BR1_2726128625,9,True,1,0,0,16621,201,48,6.4,True,4,False,0,1,0,14773,178,51,6.4,False,25.5113,1848,5,1,249,229,20
BR1_2723112728,6,True,1,0,0,17930,225,59,7.4,False,4,False,0,1,0,16464,218,52,7.0,True,29.88895,1466,2,1,284,270,14
BR1_2731774272,7,True,1,1,0,18872,245,76,7.4,False,2,False,0,0,0,15686,214,60,7.4,True,28.015666666666668,3186,5,1,321,274,47
BR1_2731744386,8,False,1,0,0,17387,232,58,7.2,True,5,True,0,0,0,15537,203,44,6.8,False,25.134833333333333,1850,3,1,290,247,43
BR1_2731560071,10,False,0,0,0,18013,214,54,7.0,True,7,True,0,0,0,16902,201,54,7.0,False,26.631483333333332,1111,3,0,268,255,13
BR1_2662663620,7,False,0,0,0,16413,188,44,6.8,False,7,True,0,0,0,17135,220,51,7.0,True,26.350833333333334,-722,0,0,232,271,-39
BR1_2731100618,11,True,1,0,0,19973,233,52,7.2,True,5,False,0,0,0,16026,194,68,7.4,False,27.547766666666668,3947,6,1,285,262,23
BR1_2678454812,3,False,0,0,0,15159,220,60,6.8,True,4,True,0,0,0,14716,185,52,7.0,False,27.078383333333335,443,-1,0,280,237,43
BR1_2678444076,5,False,1,0,0,17611,270,48,7.8,True,6,True,0,0,0,18862,274,52,7.4,False,27.729266666666668,-1251,-1,1,318,326,-8
BR1_2730071139,6,True,0,0,0,17957,230,48,7.6,False,9,False,1,1,0,20039,272,53,7.8,True,27.572733333333332,-2082,-3,-1,278,325,-47
BR1_2727708939,5,False,0,0,0,16391,209,59,7.2,False,6,True,1,1,0,18514,222,62,7.2,True,29.677233333333334,-2123,-1,-1,268,284,-16
BR1_2726202361,5,False,0,0,0,16749,208,56,7.0,False,11,True,1,1,0,19268,202,64,7.4,True,29.291983333333334,-2519,-6,-1,264,266,-2
BR1_2686003700,8,True,0,0,0,18268,236,56,7.2,False,10,False,1,0,0,19937,237,40,7.4,True,27.920066666666667,-1669,-2,-1,292,277,15
BR1_2685998323,6,True,1,0,0,16653,234,44,7.0,True,3,False,0,0,0,14346,191,58,7.0,False,25.044866666666667,2307,3,1,278,249,29
BR1_2724559690,9,True,0,1,0,19379,228,60,7.8,False,7,False,0,0,0,17235,238,52,7.4,True,29.622516666666666,2144,2,0,288,290,-2
BR1_2730702097,6,False,0,0,0,15446,180,48,6.6,False,8,True,0,0,0,16890,199,44,7.0,True,27.441083333333335,-1444,-2,0,228,243,-15
BR1_2729656367,5,False,1,0,0,15643,223,64,6.8,False,5,True,0,0,0,14874,199,52,7.2,True,27.015216666666667,769,0,1,287,251,36
BR1_2715918062,14,False,1,0,0,20130,182,63,7.2,True,12,True,0,0,0,19416,193,43,7.2,False,27.61085,714,2,1,245,236,9
BR1_2730223342,7,False,0,0,0,18349,240,68,7.6,False,12,True,1,1,0,21149,243,72,7.6,True,28.383166666666668,-2800,-5,-1,308,315,-7
BR1_2731681307,7,False,0,0,0,17904,198,61,7.0,False,12,True,1,1,0,21336,271,56,7.6,True,29.059333333333335,-3432,-5,-1,259,327,-68
BR1_2728763716,9,True,0,0,0,16650,196,32,6.4,False,13,False,0,1,0,19288,193,64,7.0,True,25.852416666666667,-2638,-4,0,228,257,-29
BR1_2727333168,14,True,1,1,0,21735,242,56,7.6,True,8,False,0,0,0,19651,228,52,7.2,False,28.131866666666667,2084,6,1,298,280,18
BR1_2727189249,7,True,1,0,0,17010,207,56,6.6,True,6,False,0,0,0,15911,204,56,6.6,False,27.144833333333334,1099,1,1,263,260,3
BR1_2730971766,5,False,0,1,0,16636,185,60,7.0,False,10,True,1,0,0,18699,212,52,7.2,True,28.405533333333334,-2063,-5,-1,245,264,-19
BR1_2730960987,6,True,0,1,0,18964,260,60,7.4,True,4,False,1,0,0,17407,238,56,7.2,False,27.609033333333333,1557,2,-1,320,294,26
BR1_2731237417,8,True,1,0,0,16821,220,44,6.8,True,4,False,0,0,0,15367,217,56,6.8,False,25.925233333333335,1454,4,1,264,273,-9
BR1_2719619761,8,False,0,0,0,16392,190,44,6.6,True,5,True,1,0,0,15130,181,60,6.6,False,25.690566666666665,1262,3,-1,234,241,-7
BR1_2711261084,6,False,0,0,0,17748,229,56,7.0,False,11,True,1,1,0,21072,267,76,7.6,True,28.8255,-3324,-5,-1,285,343,-58
BR1_2720090836,4,True,0,0,0,15416,180,51,6.4,True,9,False,1,0,0,18166,232,52,6.6,False,26.1047,-2750,-5,-1,231,284,-53
BR1_2720083101,4,False,0,1,0,15868,188,60,6.8,False,5,True,0,0,0,15712,226,50,6.8,True,26.637883333333335,156,-1,0,248,276,-28
BR1_2730470375,7,True,0,0,0,16918,202,68,7.0,True,1,False,0,0,0,14953,220,71,7.0,False,25.39356666666667,1965,6,0,270,291,-21
BR1_2695191932,8,False,1,0,0,17305,190,44,6.8,False,3,True,0,0,0,15393,195,52,6.6,True,27.40785,1912,5,1,234,247,-13
BR1_2695174597,9,False,0,0,0,18230,218,60,7.2,True,7,True,0,0,0,17371,201,52,7.2,False,29.51655,859,2,0,278,253,25
BR1_2726600533,7,True,0,1,0,18102,237,63,7.4,True,10,False,1,0,0,19453,221,47,7.2,False,29.086316666666665,-1351,-3,-1,300,268,32
BR1_2692649268,8,True,0,0,0,16426,175,54,6.2,False,7,False,0,1,0,16758,207,44,6.8,True,25.07785,-332,1,0,229,251,-22
BR1_2730277929,9,True,0,1,0,18893,207,51,7.2,False,7,False,1,0,0,19514,250,68,7.6,True,28.973766666666666,-621,2,-1,258,318,-60
BR1_2731787762,6,False,0,0,0,16860,193,55,7.2,False,8,True,1,0,0,19920,258,40,7.4,True,29.7229,-3060,-2,-1,248,298,-50
BR1_2731740123,8,True,1,1,0,18661,220,56,7.6,True,5,False,0,0,0,16211,209,56,7.2,False,29.935716666666668,2450,3,1,276,265,11
BR1_2731249495,3,True,0,0,0,15538,222,68,7.0,False,4,False,1,0,0,15731,209,52,6.8,True,25.3948,-193,-1,-1,290,261,29
BR1_2727723434,3,False,0,0,0,14723,209,72,6.8,False,6,True,1,0,0,15739,200,60,6.6,True,25.508466666666667,-1016,-3,-1,281,260,21
BR1_2731604289,4,True,1,0,0,17487,273,64,7.6,False,5,False,0,1,0,17546,245,56,7.8,True,28.538333333333334,-59,-1,1,337,301,36
BR1_2731871202,10,True,1,0,0,18297,201,64,7.2,True,6,False,0,0,0,16054,188,48,6.6,False,25.418616666666665,2243,4,1,265,236,29
BR1_2731826628,11,True,1,0,0,20372,244,56,7.6,True,6,False,0,1,0,18536,247,68,7.6,False,28.776616666666666,1836,5,1,300,315,-15
BR1_2731254419,4,False,0,0,0,15189,180,44,6.8,False,9,True,0,1,0,17422,190,56,6.8,True,26.704316666666667,-2233,-5,0,224,246,-22
BR1_2701545223,10,True,1,0,0,18893,239,56,7.0,True,1,False,0,0,0,13625,182,52,6.4,False,25.137266666666665,5268,9,1,295,234,61
BR1_2700669211,6,False,1,0,0,16627,194,56,6.8,False,8,True,0,1,0,16856,190,56,6.8,True,25.691083333333335,-229,-2,1,250,246,4
BR1_2727682265,3,False,0,0,0,17252,250,69,7.6,False,9,True,0,1,0,18013,193,50,7.2,True,28.602916666666665,-761,-6,0,319,243,76
BR1_2723075448,6,False,0,0,0,16400,195,44,6.6,False,11,True,1,0,0,18500,222,48,6.8,True,25.078983333333333,-2100,-5,-1,239,270,-31
BR1_2730818894,6,False,1,0,0,16098,220,56,7.0,True,4,True,0,0,0,15765,204,67,6.8,False,25.648416666666666,333,2,1,276,271,5
BR1_2721083392,7,True,1,0,0,16241,198,56,6.4,True,9,False,0,0,0,17824,185,44,6.6,False,26.121616666666668,-1583,-2,1,254,229,25
BR1_2731726410,11,True,0,0,0,18860,227,36,7.2,True,4,False,1,1,0,16838,209,58,7.4,False,28.64115,2022,7,-1,263,267,-4
BR1_2731697595,8,True,1,1,0,19020,238,56,7.4,True,2,False,0,0,0,15180,212,44,6.8,False,28.098283333333335,3840,6,1,294,256,38
BR1_2727710885,5,False,0,1,0,16214,174,60,7.0,False,7,True,1,0,0,18838,241,56,7.6,True,29.625633333333333,-2624,-2,-1,234,297,-63
BR1_2688503710,5,True,1,0,0,16633,239,75,7.2,True,2,False,0,0,0,14826,247,52,7.0,False,26.6121,1807,3,1,314,299,15
BR1_2731696856,11,True,1,0,0,19252,156,52,6.2,True,6,False,0,0,0,15685,170,44,6.2,False,25.80125,3567,5,1,208,214,-6
BR1_2675417881,5,True,1,0,0,16032,195,43,6.4,False,14,False,0,0,0,19827,213,47,6.8,True,26.672033333333335,-3795,-9,1,238,260,-22
BR1_2723900545,7,True,1,0,0,18716,261,68,7.6,True,3,False,0,0,0,15152,193,48,6.6,False,29.47415,3564,4,1,329,241,88
BR1_2710235552,12,True,1,0,0,17906,206,52,7.0,True,5,False,0,0,0,15659,192,48,6.6,False,26.88585,2247,7,1,258,240,18
BR1_2710214696,6,False,1,1,0,18838,250,80,7.6,True,7,True,0,0,0,17752,207,64,7.4,False,28.264833333333332,1086,-1,1,330,271,59
BR1_2731368503,6,False,1,0,0,16480,162,84,6.6,True,8,True,0,0,0,15849,167,40,6.6,False,26.00871666666667,631,-2,1,246,207,39
BR1_2730366769,5,True,0,0,0,14616,179,52,6.4,False,5,False,0,0,0,16177,204,52,7.0,True,26.278,-1561,0,0,231,256,-25
BR1_2731137487,11,True,1,0,0,19416,196,56,6.6,True,15,False,0,0,0,19835,197,60,7.0,False,28.022783333333333,-419,-4,1,252,257,-5
BR1_2729854953,6,False,0,1,0,18126,239,80,7.6,False,6,True,1,0,0,18196,258,60,7.2,True,29.066983333333333,-70,0,-1,319,318,1
BR1_2714615311,4,True,0,0,0,17034,216,68,7.4,True,2,False,1,1,1,17343,252,52,7.2,False,27.795416666666668,-309,2,-1,284,304,-20
BR1_2707463264,2,False,0,1,0,16214,224,61,7.0,False,6,True,1,0,0,18230,265,50,7.4,True,28.6045,-2016,-4,-1,285,315,-30
BR1_2730777012,8,True,0,1,0,19212,232,60,7.0,True,4,False,1,0,0,14676,189,52,6.8,False,26.383416666666665,4536,4,-1,292,241,51
BR1_2730711899,6,False,1,0,0,16636,211,60,6.8,True,7,True,0,0,0,17582,232,40,6.8,False,26.627966666666666,-946,-1,1,271,272,-1
BR1_2729957860,11,False,0,0,0,20441,253,55,7.4,True,8,True,1,0,0,17514,191,52,7.0,False,27.559983333333335,2927,3,-1,308,243,65
BR1_2707428148,7,False,1,0,0,16729,227,64,7.0,True,7,True,0,1,0,15961,159,40,6.4,False,25.665016666666666,768,0,1,291,199,92
BR1_2707411303,5,False,1,0,0,17609,254,72,7.6,False,4,True,0,1,0,17074,211,56,7.2,True,29.910216666666667,535,1,1,326,267,59
BR1_2705860303,7,False,1,1,0,17226,173,79,7.4,False,8,True,0,0,0,18650,251,56,7.4,True,29.081966666666666,-1424,-1,1,252,307,-55
BR1_2699153819,13,True,1,1,1,22744,250,56,7.6,True,7,False,0,0,0,17434,217,56,7.2,False,29.547433333333334,5310,6,1,306,273,33
BR1_2727285481,4,False,0,0,0,13780,172,40,6.0,False,9,True,1,1,0,18237,211,72,7.2,True,25.318716666666667,-4457,-5,-1,212,283,-71
BR1_2730208152,8,False,1,0,0,18092,201,64,7.2,True,9,True,0,0,0,19286,241,48,7.0,False,28.558716666666665,-1194,-1,1,265,289,-24
BR1_2730956410,9,False,0,0,0,16889,175,54,7.2,False,7,True,0,0,0,17292,249,58,7.2,True,28.41825,-403,2,0,229,307,-78
BR1_2730936374,4,False,0,1,0,15920,209,60,7.0,True,4,True,1,0,0,16000,238,59,7.2,False,25.547133333333335,-80,0,-1,269,297,-28
BR1_2730904882,7,True,0,0,0,17001,227,48,7.0,False,6,False,0,1,0,15460,187,40,6.6,True,27.073216666666667,1541,1,0,275,227,48
BR1_2730722729,6,True,0,1,0,16110,179,64,7.0,True,4,False,1,0,0,14600,175,42,6.4,False,26.494583333333335,1510,2,-1,243,217,26
BR1_2690373190,11,True,1,0,0,19343,222,63,7.6,True,2,False,0,1,0,15541,218,52,7.2,False,29.2876,3802,9,1,285,270,15
BR1_2730704147,10,True,0,0,0,18962,221,48,7.4,True,9,False,1,0,0,18963,245,56,7.6,False,29.682983333333333,-1,1,-1,269,301,-32
BR1_2731582734,10,False,1,0,0,19513,247,56,7.4,True,4,True,0,0,0,15740,223,56,7.0,False,28.492383333333333,3773,6,1,303,279,24
BR1_2727962516,6,False,0,1,0,17764,227,64,7.4,False,5,True,1,0,0,16924,228,56,7.4,True,29.102566666666668,840,1,-1,291,284,7
BR1_2727935580,4,False,0,0,0,16607,217,51,7.0,True,6,True,1,0,0,16538,206,63,7.0,False,27.573516666666666,69,-2,-1,268,269,-1
BR1_2731580980,10,True,1,0,0,19483,222,71,7.2,True,11,False,0,1,0,19576,197,64,7.6,False,27.965766666666667,-93,-1,1,293,261,32
BR1_2730437987,6,True,0,0,0,17851,210,67,7.4,False,6,False,1,1,0,18317,219,60,7.4,True,29.739166666666666,-466,0,-1,277,279,-2
BR1_2729054884,5,True,1,0,0,17029,253,60,7.0,True,3,False,0,1,0,16419,248,64,6.8,False,26.972333333333335,610,2,1,313,312,1
BR1_2725794673,6,False,0,0,0,17255,189,52,7.0,False,14,True,1,1,0,20812,216,60,7.4,True,28.052483333333335,-3557,-8,-1,241,276,-35
BR1_2724521250,9,False,0,0,0,17663,176,48,6.6,False,13,True,0,0,0,17851,181,35,6.6,True,26.450733333333332,-188,-4,0,224,216,8
BR1_2724501134,5,False,0,0,0,16479,237,55,7.2,True,4,True,0,0,0,15321,222,56,7.0,False,25.747,1158,1,0,292,278,14
BR1_2730894200,14,True,1,1,0,19250,177,40,6.8,True,9,False,0,0,0,16872,195,44,6.4,False,27.4985,2378,5,1,217,239,-22
BR1_2731040180,3,True,1,0,0,14407,183,52,6.6,False,1,False,0,1,1,15906,218,48,6.8,True,26.480416666666667,-1499,2,1,235,266,-31
BR1_2730331199,8,False,0,0,0,16377,174,40,6.6,False,12,True,0,0,0,18864,229,40,7.0,True,26.577783333333333,-2487,-4,0,214,269,-55
BR1_2728522863,10,False,0,0,0,16381,125,41,6.4,False,11,True,1,0,0,18890,241,47,6.8,True,25.905416666666667,-2509,-1,-1,166,288,-122
BR1_2728429026,6,False,0,1,0,18195,236,60,7.4,True,4,True,0,0,0,16405,232,44,7.2,False,29.491866666666667,1790,2,0,296,276,20
BR1_2688419237,1,False,0,0,0,14987,223,41,7.0,False,11,True,1,0,0,20004,222,50,7.4,True,29.06673333333333,-5017,-10,-1,264,272,-8
BR1_2688304302,10,False,1,0,0,19141,225,54,7.4,False,9,True,0,0,0,18733,251,52,7.4,True,28.229933333333335,408,1,1,279,303,-24
BR1_2688287650,12,False,0,1,0,19743,199,52,7.2,True,11,True,0,0,0,20253,216,51,7.0,False,28.186633333333333,-510,1,0,251,267,-16
BR1_2731592004,9,False,1,0,0,18176,209,56,7.2,True,6,True,0,0,0,15433,183,56,6.8,False,25.297516666666667,2743,3,1,265,239,26
BR1_2708670311,7,True,0,1,0,16326,192,56,6.8,True,7,False,1,0,0,16795,196,52,6.8,False,27.229683333333334,-469,0,-1,248,248,0
BR1_2728573161,8,True,1,0,0,16227,197,36,6.6,True,7,False,0,0,0,16994,214,52,6.6,False,26.174833333333332,-767,1,1,233,266,-33
BR1_2731837460,4,False,0,0,0,15223,214,56,6.6,True,6,True,1,0,0,16876,189,64,6.8,False,27.324716666666667,-1653,-2,-1,270,253,17
BR1_2726555707,5,False,0,0,0,15711,215,60,6.6,False,6,True,1,0,0,15866,189,44,6.4,True,25.31725,-155,-1,-1,275,233,42
BR1_2728916151,8,False,0,0,0,16307,188,40,6.8,False,11,True,1,0,0,18658,212,44,6.8,True,25.205883333333333,-2351,-3,-1,228,256,-28
BR1_2695310259,7,True,0,0,0,16264,210,60,7.0,True,8,False,0,0,0,16657,186,60,6.8,False,27.0396,-393,-1,0,270,246,24
BR1_2731057974,10,False,0,0,0,17136,188,48,6.8,True,8,True,0,0,0,16748,204,48,6.8,False,26.0426,388,2,0,236,252,-16
BR1_2717984167,6,True,0,0,0,15185,184,44,6.2,False,8,False,0,0,0,17311,204,56,6.6,True,25.191666666666666,-2126,-2,0,228,260,-32
BR1_2717945259,6,False,0,1,0,18527,280,59,7.6,True,4,True,0,0,0,16616,263,52,7.4,False,27.566966666666666,1911,2,0,339,315,24
BR1_2717722559,7,True,0,0,0,19214,245,68,7.2,True,6,False,0,0,0,17828,229,64,7.6,False,27.680666666666667,1386,1,0,313,293,20
BR1_2730007701,8,False,0,0,0,16178,168,50,6.6,False,11,True,0,0,0,17919,181,52,6.6,True,26.964,-1741,-3,0,218,233,-15
BR1_2731378316,9,False,1,1,0,19712,264,52,7.6,True,4,True,0,0,0,15924,220,52,6.8,False,28.252466666666667,3788,5,1,316,272,44
BR1_2730047061,9,False,0,0,0,19528,238,52,7.8,True,8,True,1,0,0,19429,259,72,7.6,False,28.96335,99,1,-1,290,331,-41
BR1_2731851900,7,False,0,1,0,17701,230,46,7.2,False,12,True,1,0,1,22305,243,64,7.8,True,28.920833333333334,-4604,-5,-1,276,307,-31
BR1_2731295027,11,True,1,0,0,18131,217,44,6.8,True,2,False,0,0,0,14067,177,56,6.6,False,25.954883333333335,4064,9,1,261,233,28
BR1_2731190750,6,False,1,0,0,15407,186,48,6.6,False,6,True,0,1,0,16504,222,52,6.8,True,26.147166666666667,-1097,0,1,234,274,-40
BR1_2731163905,2,False,0,0,0,13831,182,44,6.2,False,5,True,1,0,0,16178,219,60,6.8,True,26.791233333333334,-2347,-3,-1,226,279,-53
BR1_2731813157,6,False,1,0,0,15704,189,45,6.6,False,10,True,0,0,0,18889,187,65,6.8,True,25.95035,-3185,-4,1,234,252,-18
BR1_2731254390,7,False,0,1,0,16950,199,51,7.0,False,6,True,1,0,0,18044,213,52,7.2,True,29.968133333333334,-1094,1,-1,250,265,-15
BR1_2731593914,9,True,1,0,0,18294,235,52,7.2,True,6,False,0,1,0,17705,211,60,7.0,False,28.718016666666667,589,3,1,287,271,16
BR1_2731239499,7,False,0,0,0,17586,226,47,7.4,False,10,True,1,1,0,19237,231,64,7.4,True,29.094333333333335,-1651,-3,-1,273,295,-22
BR1_2731214630,12,True,1,0,0,20793,239,60,7.2,True,3,False,0,1,0,17336,223,60,7.2,False,28.146133333333335,3457,9,1,299,283,16
BR1_2672875099,5,False,0,0,0,15597,182,56,6.8,False,11,True,1,0,0,20527,258,60,7.6,True,29.1868,-4930,-6,-1,238,318,-80
BR1_2731338084,9,True,0,0,0,18352,213,52,7.4,True,12,False,1,1,0,20023,205,76,7.8,False,28.590766666666667,-1671,-3,-1,265,281,-16
BR1_2731072458,3,True,0,0,0,13742,141,44,6.4,False,11,False,1,0,0,18635,209,56,7.0,True,26.8649,-4893,-8,-1,185,265,-80
BR1_2729305981,15,True,1,0,1,23049,257,52,7.6,True,1,False,0,0,0,14272,186,60,6.8,False,29.133916666666668,8777,14,1,309,246,63
BR1_2728455605,10,True,1,0,0,21117,258,76,7.6,True,5,False,0,1,0,17658,218,56,7.0,False,28.117066666666666,3459,5,1,334,274,60
BR1_2728427828,11,True,1,0,0,19613,250,37,6.8,True,3,False,0,0,0,14887,191,38,6.6,False,26.2821,4726,8,1,287,229,58
BR1_2730717805,3,False,0,0,0,15048,216,52,6.6,False,10,True,1,1,0,18660,236,61,7.0,True,26.52328333333333,-3612,-7,-1,268,297,-29
BR1_2730653106,4,False,0,0,0,15692,216,36,6.6,False,12,True,1,1,0,20722,211,79,7.4,True,29.619533333333333,-5030,-8,-1,252,290,-38
BR1_2729983669,7,True,1,0,0,17748,221,64,7.0,True,2,False,0,0,0,14502,227,56,6.8,False,25.41111666666667,3246,5,1,285,283,2
BR1_2726724296,7,True,0,0,0,18065,228,40,7.2,False,8,False,1,1,0,20319,248,68,7.6,True,27.897366666666667,-2254,-1,-1,268,316,-48
BR1_2731726035,8,True,0,1,0,17832,194,60,7.2,True,4,False,1,0,0,14540,163,52,6.4,False,26.760466666666666,3292,4,-1,254,215,39
BR1_2688770616,12,True,1,1,0,19782,246,52,7.0,True,7,False,0,0,0,17768,211,44,6.8,False,29.37535,2014,5,1,298,255,43
BR1_2688753511,2,False,1,0,0,13883,188,52,6.4,False,12,True,0,1,0,19394,214,72,7.2,True,25.893166666666666,-5511,-10,1,240,286,-46
BR1_2730143745,5,False,0,0,0,17315,245,44,7.4,True,6,True,0,1,0,17653,240,64,7.2,False,28.632033333333332,-338,-1,0,289,304,-15
BR1_2717455369,7,True,0,1,0,16595,191,56,6.6,False,8,False,1,0,0,15801,171,48,6.8,True,26.490966666666665,794,-1,-1,247,219,28
BR1_2716380759,9,False,0,1,0,18419,185,48,7.2,False,8,True,1,0,0,18720,224,56,7.4,True,29.582216666666667,-301,1,-1,233,280,-47
BR1_2731672747,8,False,0,0,2,18898,193,65,6.8,False,9,True,1,0,0,17012,173,59,6.4,True,26.549233333333333,1886,-1,-1,258,232,26
BR1_2721252204,11,False,1,0,0,19773,215,51,7.4,True,13,True,0,1,0,22335,255,80,8.0,False,27.666216666666667,-2562,-2,1,266,335,-69
BR1_2721227605,7,False,1,1,0,16358,203,56,6.6,True,9,True,0,0,0,18084,206,44,6.4,False,25.32875,-1726,-2,1,259,250,9
BR1_2729600782,5,False,1,1,0,17278,212,64,7.2,True,4,True,0,0,0,16585,232,52,7.2,False,28.991633333333333,693,1,1,276,284,-8
BR1_2720693294,7,False,0,1,0,17472,228,52,7.0,False,5,True,0,0,0,16055,200,56,6.8,True,27.182933333333335,1417,2,0,280,256,24
BR1_2720638920,11,True,0,0,0,20885,242,84,7.8,True,8,False,1,0,0,18173,222,52,7.2,False,28.088116666666668,2712,3,-1,326,274,52
BR1_2729548063,10,False,0,0,0,18440,211,28,7.0,False,11,True,1,0,0,18995,204,79,7.4,True,28.129633333333334,-555,-1,-1,239,283,-44
BR1_2729516519,10,True,1,0,0,18425,202,60,7.4,False,8,False,0,1,0,18499,204,72,7.4,True,29.623966666666668,-74,2,1,262,276,-14
BR1_2729445066,12,True,0,0,0,17991,178,36,6.8,True,11,False,1,0,0,17775,196,60,6.8,False,26.599016666666667,216,1,-1,214,256,-42
BR1_2731875651,10,True,1,0,0,17778,188,49,6.8,True,6,False,0,0,0,16154,184,52,6.6,False,25.7634,1624,4,1,237,236,1
BR1_2731739583,7,False,0,0,0,17014,207,48,7.6,True,4,True,0,1,0,16369,212,67,7.8,False,29.8871,645,3,0,255,279,-24
BR1_2731243047,7,True,1,1,1,19383,212,50,7.2,False,13,False,0,0,0,20722,227,62,7.6,True,28.548533333333335,-1339,-6,1,262,289,-27
BR1_2731376419,8,True,1,0,0,17189,190,48,6.8,True,4,False,0,0,0,15090,197,44,6.8,False,25.6119,2099,4,1,238,241,-3
BR1_2731373429,4,True,0,0,0,16047,220,68,7.0,False,5,False,0,0,0,15678,200,44,6.6,True,26.852216666666667,369,-1,0,288,244,44
BR1_2731216491,7,False,0,0,0,16813,191,48,7.2,False,15,True,1,1,0,22389,217,80,7.8,True,28.68245,-5576,-8,-1,239,297,-58
BR1_2731638079,4,False,1,0,0,14408,171,41,6.8,False,10,True,0,0,0,19273,243,58,7.0,True,26.43945,-4865,-6,1,212,301,-89
BR1_2731735210,8,True,0,0,0,18914,223,59,7.6,True,12,False,0,1,0,20556,235,64,7.8,False,27.514283333333335,-1642,-4,0,282,299,-17
BR1_2731675121,7,False,0,0,0,16963,204,56,7.2,False,9,True,0,0,0,18718,212,48,7.4,True,28.607,-1755,-2,0,260,260,0
BR1_2713857530,3,False,0,0,0,15113,195,56,6.6,True,5,True,0,1,0,16270,204,56,6.8,False,26.6806,-1157,-2,0,251,260,-9
BR1_2731723402,10,True,1,0,0,19648,228,56,7.4,True,8,False,0,1,0,17943,233,59,7.2,False,28.112133333333333,1705,2,1,284,292,-8
BR1_2731695170,7,False,0,0,0,17417,205,64,7.2,False,9,True,1,1,1,20033,225,56,7.4,True,29.954666666666668,-2616,-2,-1,269,281,-12
BR1_2731675032,2,False,0,0,0,13623,182,60,6.4,False,13,True,1,1,0,19859,213,48,7.2,True,26.659966666666666,-6236,-11,-1,242,261,-19
BR1_2709429235,8,False,0,0,0,19597,244,70,7.6,False,7,True,1,0,0,18843,253,64,7.2,True,27.625683333333335,754,1,-1,314,317,-3
BR1_2731837239,9,False,0,0,0,17871,193,44,7.0,False,7,True,1,0,0,17834,209,43,7.2,True,27.8063,37,2,-1,237,252,-15
BR1_2731769585,6,False,0,0,0,16970,242,48,7.4,False,11,True,1,1,0,20367,253,44,7.4,True,28.102116666666667,-3397,-5,-1,290,297,-7
BR1_2702049549,6,True,1,0,0,16686,221,68,7.0,False,8,False,0,0,1,19861,219,48,7.0,True,28.646466666666665,-3175,-2,1,289,267,22
BR1_2701989317,9,True,1,0,0,18803,224,48,7.2,True,10,False,0,0,0,17130,179,30,6.6,False,29.632883333333332,1673,-1,1,272,209,63
BR1_2730380530,6,True,0,0,0,14741,163,48,6.4,True,5,False,0,0,0,16177,211,60,6.6,False,26.721216666666667,-1436,1,0,211,271,-60
BR1_2731326843,3,True,0,0,0,14519,180,56,6.8,False,8,False,0,1,0,17158,217,56,7.0,True,25.59935,-2639,-5,0,236,273,-37
BR1_2729035423,9,True,0,0,0,16413,202,40,6.6,False,10,False,0,0,0,19959,202,44,7.0,True,26.6969,-3546,-1,0,242,246,-4
BR1_2707086344,7,False,0,0,0,18415,221,60,7.2,False,12,True,1,0,0,20376,258,58,7.4,True,28.650516666666668,-1961,-5,-1,281,316,-35
BR1_2730219980,10,False,0,0,0,17173,198,56,6.8,False,7,True,1,0,0,16967,189,48,6.8,True,26.52165,206,3,-1,254,237,17
BR1_2729952028,8,True,0,1,0,17619,233,44,7.0,True,6,False,1,0,0,15186,182,52,7.0,False,27.48605,2433,2,-1,277,234,43
BR1_2687227589,3,False,0,0,0,14068,204,32,6.8,True,4,True,0,0,0,15214,218,72,7.2,False,27.175866666666668,-1146,-1,0,236,290,-54
BR1_2731817241,6,False,1,0,0,15870,158,54,6.4,False,10,True,0,0,0,19055,226,60,6.8,True,26.2548,-3185,-4,1,212,286,-74
BR1_2730197287,3,True,1,0,0,14739,196,48,6.8,False,4,False,0,0,0,16780,238,72,7.0,True,25.084016666666667,-2041,-1,1,244,310,-66
BR1_2731814667,15,True,1,1,0,20767,260,55,7.4,True,7,False,0,0,0,17677,206,64,7.0,False,28.785566666666668,3090,8,1,315,270,45
BR1_2731730875,9,True,0,1,0,17021,192,40,6.8,False,7,False,0,0,0,16144,187,52,7.0,True,25.631433333333334,877,2,0,232,239,-7
BR1_2708766376,9,False,0,0,0,18515,213,56,7.0,True,10,True,1,0,0,19829,211,72,7.2,False,29.080766666666666,-1314,-1,-1,269,283,-14
BR1_2716356375,9,True,0,0,0,17822,206,44,7.0,True,5,False,0,1,0,15050,174,44,6.6,False,27.0227,2772,4,0,250,218,32
BR1_2716335206,7,False,0,0,0,15359,173,60,6.4,False,8,True,0,0,0,18454,215,52,6.6,True,25.874466666666667,-3095,-1,0,233,267,-34
BR1_2731717028,6,True,1,0,0,16557,225,52,6.6,True,5,False,0,1,0,15241,202,60,6.8,False,27.11805,1316,1,1,277,262,15
BR1_2730119087,7,True,0,0,0,16090,182,40,6.6,False,13,False,1,1,0,19555,195,52,6.8,True,25.471616666666666,-3465,-6,-1,222,247,-25
BR1_2730087698,6,True,1,0,0,16289,195,51,6.2,False,10,False,0,0,0,18119,208,60,7.2,True,26.459333333333333,-1830,-4,1,246,268,-22
BR1_2726920070,10,False,0,0,0,20943,260,63,7.8,True,7,True,1,0,0,17742,232,60,7.8,False,28.111666666666668,3201,3,-1,323,292,31
BR1_2730939450,1,False,0,0,0,15377,226,72,7.0,True,3,True,1,1,1,17568,222,56,7.2,False,28.8963,-2191,-2,-1,298,278,20
BR1_2731552767,10,True,0,1,0,19546,209,48,7.2,True,6,False,0,0,0,15714,190,56,7.0,False,25.428233333333335,3832,4,0,257,246,11
BR1_2731527133,5,False,1,0,0,15871,190,68,6.6,False,5,True,0,0,0,16015,188,52,6.8,True,25.103133333333332,-144,0,1,258,240,18
BR1_2731414113,8,False,1,1,0,18085,224,56,7.4,True,6,True,0,0,0,17783,222,76,7.4,False,29.0202,302,2,1,280,298,-18
BR1_2731253142,5,False,1,0,0,17655,266,68,7.6,True,2,True,0,0,0,16816,261,55,7.8,False,27.77675,839,3,1,334,316,18
BR1_2730285711,8,False,1,0,0,16749,195,48,7.0,True,7,True,0,0,0,16726,203,48,6.8,False,26.967783333333333,23,1,1,243,251,-8
BR1_2730470011,13,False,1,0,0,19140,212,52,7.2,True,5,True,0,0,0,15486,171,48,6.2,False,27.215483333333335,3654,8,1,264,219,45
BR1_2729712804,7,True,1,1,0,17286,189,54,6.8,False,9,False,0,0,0,17630,184,72,7.0,True,25.06035,-344,-2,1,243,256,-13
BR1_2729956046,10,True,0,1,0,17953,195,60,7.0,True,11,False,1,0,0,20430,232,52,7.4,False,27.54715,-2477,-1,-1,255,284,-29
BR1_2731704408,8,True,1,0,0,16833,194,60,7.0,True,8,False,0,0,0,16835,186,48,6.8,False,27.443066666666667,-2,0,1,254,234,20
BR1_2724025676,14,True,0,0,0,21679,239,55,7.6,True,10,False,1,0,0,19406,187,68,7.0,False,29.302016666666667,2273,4,-1,294,255,39
BR1_2730823767,5,True,1,0,0,16826,220,59,7.2,False,7,False,0,0,0,18178,216,60,7.4,True,28.316233333333333,-1352,-2,1,279,276,3
BR1_2730107939,9,False,0,1,0,20144,218,56,7.4,True,6,True,1,0,0,17321,222,60,7.0,False,27.558933333333332,2823,3,-1,274,282,-8
BR1_2731251305,13,True,1,0,0,20694,230,55,7.4,True,3,False,0,1,0,13438,128,38,6.0,False,25.64635,7256,10,1,285,166,119
BR1_2704342664,3,False,0,0,0,14830,212,47,7.2,False,4,True,1,0,0,15623,222,60,7.2,True,26.91955,-793,-1,-1,259,282,-23
BR1_2703896297,4,False,1,0,0,14199,176,55,6.6,False,6,True,0,0,0,15858,187,52,6.6,True,25.028683333333333,-1659,-2,1,231,239,-8
BR1_2703819154,6,True,0,0,0,16706,246,56,7.2,True,3,False,0,0,0,14730,171,59,6.6,False,27.1473,1976,3,0,302,230,72
BR1_2726510126,5,False,1,0,0,15843,214,61,6.8,True,2,True,0,0,0,14018,187,48,6.6,False,25.90555,1825,3,1,275,235,40
BR1_2731134299,5,False,0,0,0,16345,215,56,7.4,False,10,True,1,1,0,20071,230,60,7.6,True,28.246983333333333,-3726,-5,-1,271,290,-19
BR1_2730735039,2,False,0,0,0,15440,208,48,7.0,False,12,True,1,1,0,22019,251,88,8.0,True,27.608616666666666,-6579,-10,-1,256,339,-83
BR1_2728892079,7,True,1,0,0,18129,217,64,7.2,False,8,False,0,1,0,18830,208,68,7.0,True,28.198683333333335,-701,-1,1,281,276,5
BR1_2731576681,7,False,0,1,0,16833,177,36,6.2,False,11,True,1,0,0,18887,227,52,6.8,True,26.0601,-2054,-4,-1,213,279,-66
BR1_2731517465,9,True,1,1,0,19151,259,60,7.4,True,9,False,0,0,0,18417,231,64,7.6,False,28.861033333333335,734,0,1,319,295,24
BR1_2729621518,10,True,0,0,0,19797,246,56,7.8,True,8,False,1,0,0,18224,221,56,7.2,False,28.519083333333334,1573,2,-1,302,277,25
BR1_2721989261,13,True,1,1,0,20684,198,68,7.4,True,5,False,0,0,0,14747,158,44,6.6,False,29.645033333333334,5937,8,1,266,202,64
BR1_2731085769,8,True,1,0,0,15804,158,52,6.4,True,6,False,0,0,0,16290,181,52,6.6,False,25.0471,-486,2,1,210,233,-23
BR1_2730799702,15,False,0,0,1,22057,213,56,7.6,True,7,True,0,0,0,17103,206,64,7.0,False,29.21065,4954,8,0,269,270,-1
BR1_2730773537,2,False,1,0,0,15864,237,48,6.8,False,7,True,0,0,0,18052,225,56,7.6,True,29.302183333333332,-2188,-5,1,285,281,4
BR1_2730688660,7,True,1,1,0,16710,227,44,6.8,True,4,False,0,0,0,15379,224,56,7.2,False,25.880866666666666,1331,3,1,271,280,-9
BR1_2731252441,13,False,0,0,0,20707,220,60,7.0,False,10,True,0,0,0,19001,224,52,6.8,True,29.909,1706,3,0,280,276,4
BR1_2731707021,7,True,0,0,0,15748,189,48,6.4,True,4,False,0,0,0,15539,217,48,7.2,False,25.25965,209,3,0,237,265,-28
BR1_2731259951,3,False,1,0,0,15997,217,56,7.0,True,4,True,0,0,0,15360,188,60,6.8,False,26.086816666666667,637,-1,1,273,248,25
BR1_2731875811,7,False,1,0,1,20046,239,68,7.6,True,5,True,0,1,0,16811,196,52,7.2,False,29.610583333333334,3235,2,1,307,248,59
BR1_2731866980,11,True,1,0,0,20145,225,56,7.4,True,10,False,0,1,0,19248,243,42,7.4,False,28.34415,897,1,1,281,285,-4
BR1_2731767044,8,False,0,0,0,17650,226,36,7.0,True,11,True,1,0,0,19932,222,60,7.6,False,27.508983333333333,-2282,-3,-1,262,282,-20
BR1_2731290673,11,False,1,1,0,19638,228,71,7.8,True,4,True,0,0,0,16024,222,43,7.0,False,29.67716666666667,3614,7,1,299,265,34
BR1_2714899803,3,False,0,1,0,16268,237,48,7.2,True,6,True,1,0,0,17450,237,56,7.4,False,29.445716666666666,-1182,-3,-1,285,293,-8
BR1_2731693269,5,False,0,0,0,16610,196,48,7.0,False,6,True,0,0,0,17649,232,48,7.4,True,27.710816666666666,-1039,-1,0,244,280,-36
BR1_2731238948,5,False,0,1,0,16372,193,64,7.2,False,7,True,0,0,0,18531,255,60,7.8,True,28.152833333333334,-2159,-2,0,257,315,-58
BR1_2731221200,3,False,0,0,0,15132,212,56,6.8,True,2,True,1,0,0,14290,193,72,7.0,False,26.279366666666668,842,1,-1,268,265,3
BR1_2687598438,8,True,1,0,0,18264,219,60,7.6,True,3,False,0,0,0,16667,257,68,7.2,False,28.225616666666667,1597,5,1,279,325,-46
BR1_2700689959,7,False,1,1,0,18285,250,55,7.2,True,5,True,0,0,0,16511,231,56,7.2,False,27.857233333333333,1774,2,1,305,287,18
BR1_2698126478,4,True,0,1,0,16648,240,59,7.2,False,7,False,1,0,0,18694,267,52,7.6,True,28.950033333333334,-2046,-3,-1,299,319,-20
BR1_2721299881,6,True,0,0,0,16415,230,40,6.4,False,7,False,1,0,0,17987,235,60,7.0,True,27.20381666666667,-1572,-1,-1,270,295,-25
BR1_2721885742,4,False,0,0,0,15242,218,48,7.2,True,1,True,1,0,0,13916,202,56,6.8,False,26.290366666666667,1326,3,-1,266,258,8
BR1_2720190141,6,False,1,0,0,17157,213,60,7.2,True,2,True,0,1,0,15014,219,64,6.8,False,25.178616666666667,2143,4,1,273,283,-10
BR1_2720157093,4,True,1,0,0,17038,230,63,7.6,False,5,False,0,1,0,17410,243,46,7.4,True,28.6938,-372,-1,1,293,289,4
BR1_2731712698,11,True,1,1,0,18848,182,56,6.8,True,5,False,0,0,0,15649,198,52,6.8,False,26.116533333333333,3199,6,1,238,250,-12
BR1_2731541909,11,True,0,0,0,17941,212,52,7.0,False,7,False,1,0,0,16516,179,48,6.8,True,26.09455,1425,4,-1,264,227,37
BR1_2731116126,6,True,0,0,0,16871,222,62,7.0,False,9,False,1,0,0,19643,240,57,7.4,True,28.807266666666667,-2772,-3,-1,284,297,-13
BR1_2731094264,5,False,0,0,0,16163,209,60,6.8,False,14,True,0,1,1,23229,263,68,8.0,True,29.58475,-7066,-9,0,269,331,-62
BR1_2729577366,6,True,0,0,0,17474,223,60,7.4,True,2,False,0,0,0,14960,227,52,7.2,False,29.247533333333333,2514,4,0,283,279,4
BR1_2730095506,9,True,0,0,0,17948,222,40,6.8,True,4,False,0,1,0,17188,228,52,7.2,False,29.417366666666666,760,5,0,262,280,-18
BR1_2726957646,9,False,1,1,0,19016,214,57,7.2,True,7,True,0,0,0,17321,215,54,7.4,False,28.150116666666666,1695,2,1,271,269,2
BR1_2731782530,10,False,1,0,0,18413,211,64,7.0,True,6,True,0,1,0,16031,163,48,6.4,False,25.5789,2382,4,1,275,211,64
BR1_2730262773,5,True,0,0,0,15704,202,40,6.8,True,3,False,1,0,0,14763,242,48,6.4,False,25.353666666666665,941,2,-1,242,290,-48
BR1_2729990476,8,False,1,0,0,17956,189,48,7.2,False,16,True,0,0,0,22428,214,69,7.6,True,28.3637,-4472,-8,1,237,283,-46
BR1_2731418752,12,True,1,0,0,19162,223,60,7.4,True,3,False,0,0,0,15012,211,64,7.0,False,27.2635,4150,9,1,283,275,8
BR1_2731056488,6,False,0,0,0,16999,220,52,7.6,False,11,True,1,1,0,20442,247,68,7.4,True,28.379766666666665,-3443,-5,-1,272,315,-43
BR1_2730596307,6,False,0,0,0,15784,188,60,6.8,False,8,True,1,0,0,17244,212,48,6.8,True,26.1363,-1460,-2,-1,248,260,-12
BR1_2731480859,7,True,0,1,0,17824,230,48,7.4,False,7,False,1,0,0,17779,235,68,7.2,True,27.63945,45,0,-1,278,303,-25
BR1_2719381258,4,False,1,0,0,16651,221,52,6.8,False,10,True,0,0,0,20466,256,80,7.8,True,29.7482,-3815,-6,1,273,336,-63
BR1_2730127173,6,False,1,0,0,16304,201,72,7.0,True,6,True,0,0,0,16193,208,60,6.6,False,27.19483333333333,111,0,1,273,268,5
BR1_2731608326,5,True,0,0,0,14735,158,39,5.6,False,10,False,0,0,0,17419,197,48,6.8,True,27.196383333333333,-2684,-5,0,197,245,-48
BR1_2725852971,11,False,1,0,0,18328,193,48,7.2,True,7,True,0,0,0,17779,191,55,7.2,False,28.75733333333333,549,4,1,241,246,-5
BR1_2725050717,5,True,0,0,0,15250,206,48,6.6,True,4,False,1,0,0,14894,224,44,6.6,False,26.843133333333334,356,1,-1,254,268,-14
BR1_2699555810,6,True,1,0,0,16732,220,56,7.0,True,7,False,0,1,0,18152,227,48,7.2,False,26.85396666666667,-1420,-1,1,276,275,1
BR1_2699518879,11,False,1,0,0,19627,209,64,7.2,True,5,True,0,1,0,18331,245,67,7.2,False,28.9963,1296,6,1,273,312,-39
BR1_2699420226,5,False,0,1,0,17299,221,52,7.2,True,7,True,1,0,0,17833,227,60,7.2,False,27.854883333333333,-534,-2,-1,273,287,-14
BR1_2730903618,10,False,0,0,0,18020,192,60,7.2,True,4,True,0,0,0,14446,167,44,6.6,False,25.849733333333333,3574,6,0,252,211,41
BR1_2731781630,10,False,0,0,0,17915,194,44,6.6,True,8,True,0,0,0,17961,217,68,7.0,False,29.41745,-46,2,0,238,285,-47
BR1_2719342543,3,True,0,0,0,16797,231,72,7.2,False,10,False,1,1,0,19663,244,64,7.4,True,28.581866666666667,-2866,-7,-1,303,308,-5
BR1_2719313017,7,False,1,0,0,17593,200,60,7.0,False,7,True,0,1,0,17892,223,72,7.6,True,29.9435,-299,0,1,260,295,-35
BR1_2724418613,8,True,0,0,0,17199,183,64,6.8,False,11,False,1,0,0,17954,162,52,7.0,True,27.3502,-755,-3,-1,247,214,33
BR1_2731599338,12,True,1,0,0,21510,279,59,7.6,True,4,False,0,1,0,17526,230,68,7.4,False,29.555283333333332,3984,8,1,338,298,40
BR1_2731222410,2,False,0,1,1,14553,184,52,6.6,False,8,True,0,0,0,17273,200,44,6.6,True,26.822483333333334,-2720,-6,0,236,244,-8
BR1_2704212374,7,True,1,0,0,17843,234,68,7.2,False,6,False,0,0,0,17527,208,56,7.2,True,28.5436,316,1,1,302,264,38
BR1_2703711899,11,True,1,0,0,18860,215,36,7.0,True,4,False,0,0,0,14223,149,64,6.8,False,26.707066666666666,4637,7,1,251,213,38
BR1_2703696256,5,False,0,0,0,16274,202,36,6.6,False,9,True,1,0,0,16828,209,44,6.6,True,26.951283333333333,-554,-4,-1,238,253,-15
BR1_2731846153,11,False,1,0,0,20433,231,68,7.8,True,7,True,0,1,0,18349,204,52,7.4,False,29.171333333333333,2084,4,1,299,256,43
BR1_2731828674,9,True,1,0,0,18254,200,44,6.8,True,5,False,0,1,1,17091,192,56,6.8,False,26.0926,1163,4,1,244,248,-4
BR1_2731279105,7,True,0,0,0,16579,195,56,7.0,False,6,False,0,1,0,18201,241,66,7.2,True,29.812683333333332,-1622,1,0,251,307,-56
BR1_2731685212,14,True,1,0,1,22080,223,44,7.4,True,10,False,0,0,0,19051,200,68,7.2,False,29.43855,3029,4,1,267,268,-1
BR1_2713912166,8,True,0,0,0,17279,172,47,6.6,False,8,False,1,0,0,17780,216,60,7.2,True,28.20945,-501,0,-1,219,276,-57
BR1_2731823559,8,False,1,0,0,18447,226,52,7.4,True,9,True,0,1,0,19286,220,56,7.2,False,29.02795,-839,-1,1,278,276,2
BR1_2731803921,12,True,1,0,0,19506,214,64,7.6,True,3,False,0,0,0,16154,211,52,7.2,False,27.6857,3352,9,1,278,263,15
BR1_2731752468,5,False,1,0,0,16811,217,64,7.2,False,10,True,0,1,0,20220,227,76,7.4,True,29.507383333333333,-3409,-5,1,281,303,-22
BR1_2730204686,2,False,0,1,0,13529,154,42,6.6,False,7,True,0,0,0,16660,192,64,7.0,True,25.547133333333335,-3131,-5,0,196,256,-60
BR1_2729789632,12,True,0,0,0,20772,235,64,7.6,False,7,False,1,1,0,17631,220,56,7.0,True,27.997366666666668,3141,5,-1,299,276,23
BR1_2729778304,9,True,1,1,0,18795,226,56,7.4,True,7,False,0,0,0,17263,202,56,7.0,False,29.347966666666668,1532,2,1,282,258,24
BR1_2725704863,5,False,1,0,0,16822,196,64,7.2,True,7,True,0,1,1,20281,228,80,7.6,False,29.02065,-3459,-2,1,260,308,-48
BR1_2730745180,5,False,0,0,0,17739,229,60,7.6,True,11,True,1,1,0,19290,210,68,7.6,False,28.730166666666666,-1551,-6,-1,289,278,11
BR1_2728526874,7,False,0,1,1,18935,201,65,7.4,False,10,True,1,0,0,20942,250,55,7.4,True,29.09025,-2007,-3,-1,266,305,-39
BR1_2731172131,10,True,0,1,0,17986,224,52,6.6,False,6,False,1,0,0,16595,224,56,6.8,True,27.267566666666667,1391,4,-1,276,280,-4
BR1_2729744218,12,True,0,0,0,20188,228,40,7.2,False,10,False,1,0,0,19003,204,52,7.4,True,27.591683333333332,1185,2,-1,268,256,12
BR1_2727919380,3,False,1,1,0,15392,225,56,7.0,False,12,True,0,0,0,18291,188,38,7.0,True,25.9214,-2899,-9,1,281,226,55
BR1_2727488416,7,True,0,0,0,16247,223,52,6.6,False,7,False,1,0,0,17216,219,60,7.0,True,26.119616666666666,-969,0,-1,275,279,-4
BR1_2726545402,7,True,0,0,0,17848,221,56,7.0,False,9,False,0,0,0,18251,212,56,7.4,True,28.995233333333335,-403,-2,0,277,268,9
BR1_2724135210,8,True,0,0,0,18639,215,52,7.4,False,8,False,1,0,0,18434,210,78,7.4,True,28.56955,205,0,-1,267,288,-21
BR1_2731321882,10,False,1,0,0,17590,192,44,6.8,True,5,True,0,0,0,14491,167,40,6.6,False,25.9091,3099,5,1,236,207,29
BR1_2731004795,12,True,1,0,0,19495,198,48,6.8,True,5,False,0,0,0,15109,170,48,6.4,False,25.48245,4386,7,1,246,218,28
BR1_2730090080,7,True,0,0,0,16534,187,44,6.6,False,6,False,1,0,0,15642,208,48,6.8,True,26.637566666666668,892,1,-1,231,256,-25
BR1_2731687044,10,False,0,1,0,18638,172,48,7.0,True,8,True,1,0,0,19146,238,44,7.2,False,29.17045,-508,2,-1,220,282,-62
BR1_2731628414,11,False,1,1,0,19925,223,64,7.8,False,4,True,0,0,0,17255,236,52,7.0,True,29.11025,2670,7,1,287,288,-1
BR1_2731474868,3,True,0,0,0,15531,227,52,6.8,True,5,False,0,0,0,14429,165,44,6.4,False,25.172483333333332,1102,-2,0,279,209,70
BR1_2729395508,9,False,1,1,0,19261,235,60,7.6,False,10,True,0,0,0,19597,205,56,7.8,True,29.645883333333334,-336,-1,1,295,261,34
BR1_2728018825,10,True,1,1,0,20948,244,64,7.4,True,13,False,0,0,0,22263,273,52,7.4,False,29.1444,-1315,-3,1,308,325,-17
BR1_2731121914,8,False,1,1,0,17381,163,60,7.0,True,5,True,0,0,0,14930,203,40,6.4,False,25.96875,2451,3,1,223,243,-20
BR1_2731101996,4,False,0,0,0,14643,181,40,6.4,False,9,True,1,0,0,16968,188,56,6.8,True,26.527566666666665,-2325,-5,-1,221,244,-23
BR1_2731824004,8,True,1,0,0,18473,213,67,7.6,True,9,False,0,1,0,19315,230,52,7.6,False,28.67355,-842,-1,1,280,282,-2
BR1_2730536375,12,True,1,0,0,19345,227,48,7.2,True,3,False,0,0,0,16886,252,68,7.2,False,27.954733333333333,2459,9,1,275,320,-45
BR1_2729921799,6,True,0,1,0,17152,221,72,7.0,True,5,False,1,0,0,16337,233,64,6.8,False,26.168983333333333,815,1,-1,293,297,-4
BR1_2729134875,6,True,0,1,0,17008,215,42,6.6,False,13,False,1,0,0,20122,215,50,7.6,True,28.482433333333333,-3114,-7,-1,257,265,-8
BR1_2730222406,8,False,0,0,0,17567,227,51,7.0,True,4,True,1,0,0,14995,169,59,6.6,False,26.058166666666665,2572,4,-1,278,228,50
BR1_2729319651,6,False,0,0,0,16170,225,48,6.8,False,5,True,0,0,0,16441,232,56,7.0,True,27.165166666666668,-271,1,0,273,288,-15
BR1_2729662795,10,True,0,1,1,20076,218,60,7.2,True,2,False,0,0,0,12820,152,36,6.6,False,25.914233333333332,7256,8,0,278,188,90
BR1_2728389476,2,True,0,0,0,13892,188,52,6.4,False,11,False,1,1,0,18964,193,60,7.2,True,26.26245,-5072,-9,-1,240,253,-13
BR1_2728400587,7,True,1,1,0,17059,211,48,7.0,True,4,False,0,0,0,14880,179,56,6.6,False,25.059466666666665,2179,3,1,259,235,24
BR1_2731681362,12,False,1,0,0,18985,218,56,7.2,False,6,True,0,1,0,18182,236,52,7.2,True,28.807266666666667,803,6,1,274,288,-14
BR1_2731829491,13,False,1,0,0,20236,263,51,7.6,True,8,True,0,1,0,18626,238,60,7.4,False,28.006983333333334,1610,5,1,314,298,16
BR1_2731506000,9,True,1,0,0,19390,265,52,7.2,True,2,False,0,0,0,13854,180,44,6.6,False,25.998683333333332,5536,7,1,317,224,93
BR1_2726294423,5,False,0,0,0,15401,186,48,6.4,False,8,True,0,0,0,17437,235,52,6.8,True,26.285383333333332,-2036,-3,0,234,287,-53
BR1_2727568098,6,True,1,0,0,15964,197,44,6.6,True,14,False,0,1,0,20077,221,71,7.2,False,26.434633333333334,-4113,-8,1,241,292,-51
BR1_2727548048,2,False,0,0,0,14279,196,56,6.2,False,11,True,1,0,0,18568,212,76,7.2,True,25.7516,-4289,-9,-1,252,288,-36
BR1_2727490201,7,True,0,0,0,16774,178,58,6.2,False,13,False,0,1,0,18709,206,28,6.8,True,27.00883333333333,-1935,-6,0,236,234,2
BR1_2731237692,7,True,0,0,0,16447,208,52,7.0,False,3,False,1,0,0,14866,205,68,7.0,True,27.163233333333334,1581,4,-1,260,273,-13
BR1_2708778576,6,False,0,0,1,17931,201,60,6.4,False,14,True,1,1,0,21899,207,68,7.6,True,28.842816666666668,-3968,-8,-1,261,275,-14
BR1_2730364876,11,True,0,0,0,19939,225,52,7.6,True,6,False,0,0,0,17180,194,64,7.2,False,29.271216666666668,2759,5,0,277,258,19
BR1_2730333518,12,False,0,0,0,20668,218,52,7.4,True,13,True,1,0,0,21367,247,56,7.6,False,29.640516666666667,-699,-1,-1,270,303,-33
BR1_2730125131,2,False,0,1,0,14349,202,60,7.0,True,5,True,0,0,0,15715,208,44,6.6,False,26.94695,-1366,-3,0,262,252,10
BR1_2728516606,5,False,0,0,0,16827,214,44,7.2,False,8,True,1,0,0,18764,240,56,7.4,True,29.074866666666665,-1937,-3,-1,258,296,-38
BR1_2729662916,14,True,1,0,0,19789,209,56,7.2,True,8,False,0,1,0,17939,207,44,7.0,False,28.667783333333333,1850,6,1,265,251,14
BR1_2729597371,12,True,0,0,0,20490,220,48,7.4,False,8,False,1,0,0,19506,241,60,7.4,True,29.6233,984,4,-1,268,301,-33
BR1_2731444738,10,True,1,0,0,17689,201,64,6.8,True,4,False,0,0,0,14252,169,40,5.6,False,26.041083333333333,3437,6,1,265,209,56
BR1_2731411795,9,False,1,0,0,17681,206,62,7.6,False,9,True,0,0,0,17923,199,45,7.2,True,28.800933333333333,-242,0,1,268,244,24
BR1_2731404888,10,False,0,0,0,17337,172,40,6.6,False,12,True,0,0,0,18436,195,62,6.6,True,26.584366666666668,-1099,-2,0,212,257,-45
BR1_2731402343,13,True,0,1,0,19350,172,51,6.8,True,6,False,0,0,0,14857,181,48,6.4,False,25.434233333333335,4493,7,0,223,229,-6
BR1_2728966753,8,False,0,0,0,17787,191,64,7.0,False,13,True,0,0,0,20850,194,52,7.2,True,29.410166666666665,-3063,-5,0,255,246,9
BR1_2728640734,12,False,0,0,0,18544,160,64,7.0,False,18,True,0,0,0,21206,212,60,7.2,True,26.55665,-2662,-6,0,224,272,-48
BR1_2731540703,10,False,0,0,0,20571,225,60,8.0,True,3,True,1,1,0,17109,263,64,7.6,False,29.154783333333334,3462,7,-1,285,327,-42
BR1_2731519737,11,True,1,0,0,18644,210,52,7.0,True,7,False,0,0,0,16895,197,52,7.0,False,25.981666666666666,1749,4,1,262,249,13
BR1_2731461154,11,True,1,1,0,19732,175,44,7.0,True,17,False,0,0,0,21197,207,51,7.2,False,29.932666666666666,-1465,-6,1,219,258,-39
BR1_2731442544,9,True,0,1,0,19325,264,64,7.2,True,9,False,0,0,0,19574,254,60,7.4,False,29.986016666666668,-249,0,0,328,314,14
BR1_2731809036,7,False,0,1,0,17388,204,48,7.0,False,12,True,1,0,0,19198,235,48,7.4,True,26.864533333333334,-1810,-5,-1,252,283,-31
BR1_2729806475,8,False,0,0,0,17569,199,30,6.4,False,14,True,0,0,0,20473,193,54,7.0,True,28.505216666666666,-2904,-6,0,229,247,-18
BR1_2729725860,6,True,1,0,0,15783,203,44,7.0,True,5,False,0,1,0,15087,195,54,6.8,False,25.620916666666666,696,1,1,247,249,-2
BR1_2731370746,6,True,1,0,0,16364,210,60,7.0,False,9,False,0,1,1,18959,264,44,7.2,True,26.8982,-2595,-3,1,270,308,-38
BR1_2731170388,9,False,0,1,0,19996,231,72,7.4,False,8,True,1,0,0,18685,255,56,7.4,True,27.676133333333333,1311,1,-1,303,311,-8
BR1_2731151140,6,True,0,0,0,16099,214,52,7.2,True,2,False,0,0,0,14131,198,48,6.8,False,26.538933333333333,1968,4,0,266,246,20
BR1_2731432446,3,False,1,0,0,13995,192,52,6.8,False,3,True,0,0,0,16375,259,60,7.2,True,27.066833333333335,-2380,0,1,244,319,-75
BR1_2707921088,5,False,0,0,0,17164,242,43,7.2,False,4,True,0,1,0,18042,220,80,7.4,True,29.78001666666667,-878,1,0,285,300,-15
BR1_2706582235,6,False,0,1,0,15436,149,54,6.2,False,14,True,1,0,0,19119,232,52,7.2,True,26.403166666666667,-3683,-8,-1,203,284,-81
BR1_2731656200,11,False,0,0,0,18818,193,56,7.6,True,7,True,1,0,0,17703,209,52,7.0,False,28.795733333333335,1115,4,-1,249,261,-12
BR1_2731142766,10,False,1,0,0,19683,246,59,7.2,True,9,True,0,0,0,19124,259,56,7.4,False,28.906783333333333,559,1,1,305,315,-10
BR1_2708050110,10,False,0,0,0,19743,218,42,6.8,False,19,True,0,0,0,22643,214,41,7.2,True,29.988133333333334,-2900,-9,0,260,255,5
BR1_2708022880,6,False,0,0,0,16638,218,52,6.8,False,11,True,1,1,0,19532,201,64,7.4,True,25.599866666666667,-2894,-5,-1,270,265,5
BR1_2707649224,9,True,0,0,0,19067,261,73,7.8,True,2,False,1,0,0,15988,230,54,7.2,False,28.11825,3079,7,-1,334,284,50
BR1_2731594775,8,False,0,0,0,18661,218,38,7.2,True,13,True,1,0,0,20200,214,56,7.4,False,29.828266666666668,-1539,-5,-1,256,270,-14
BR1_2731015625,6,False,0,0,0,18283,225,64,7.2,True,10,True,1,0,0,18911,188,56,7.2,False,28.869783333333334,-628,-4,-1,289,244,45
BR1_2730569810,8,True,1,0,0,17706,203,56,7.0,True,7,False,0,0,0,17130,199,44,6.6,False,27.16535,576,1,1,259,243,16
BR1_2730860670,9,False,0,0,0,18455,204,56,7.0,False,16,True,1,0,1,22678,192,64,7.4,True,28.132016666666665,-4223,-7,-1,260,256,4
BR1_2730816649,6,False,0,1,0,16703,170,44,7.2,False,7,True,1,0,0,18240,237,50,7.2,True,27.92945,-1537,-1,-1,214,287,-73
BR1_2707638155,7,True,0,0,0,15472,187,44,6.8,False,5,False,1,0,0,16279,190,68,7.0,True,25.831983333333334,-807,2,-1,231,258,-27
BR1_2706694414,11,True,0,1,0,20731,235,60,7.4,True,9,False,0,0,0,18965,253,56,7.0,False,28.7375,1766,2,0,295,309,-14
BR1_2712958669,8,False,0,0,0,16840,213,47,6.8,True,5,True,1,0,0,16217,231,44,6.8,False,25.868233333333333,623,3,-1,260,275,-15
BR1_2704273151,7,True,1,1,0,16395,196,40,6.4,False,14,False,0,0,0,20689,207,67,7.0,True,25.503816666666665,-4294,-7,1,236,274,-38
BR1_2727612020,11,True,1,1,0,19510,210,60,7.4,True,8,False,0,0,0,17601,193,60,7.2,False,28.046633333333332,1909,3,1,270,253,17
BR1_2730799956,3,False,0,0,0,14651,176,79,7.2,False,13,True,1,1,1,20542,244,49,7.4,True,28.53098333333333,-5891,-10,-1,255,293,-38
BR1_2729556020,2,False,0,1,0,15856,237,63,7.2,False,7,True,1,0,0,18214,249,56,7.4,True,27.586,-2358,-5,-1,300,305,-5
BR1_2731202397,9,False,0,0,0,19136,205,68,7.4,False,8,True,1,0,0,19346,219,49,7.2,True,28.325366666666667,-210,1,-1,273,268,5
BR1_2731141919,8,False,1,0,0,18350,250,60,7.6,False,6,True,0,1,0,17844,230,56,7.4,True,27.523983333333334,506,2,1,310,286,24
BR1_2702007607,12,True,1,1,0,20584,248,47,7.4,True,8,False,0,0,0,18833,229,56,7.4,False,28.10185,1751,4,1,295,285,10
BR1_2696229568,9,True,1,1,0,19621,241,59,7.4,True,6,False,0,0,0,17493,251,52,7.0,False,28.6928,2128,3,1,300,303,-3
BR1_2696207124,8,False,0,1,0,17901,192,76,7.2,False,8,True,1,0,0,17393,202,56,7.2,True,29.45755,508,0,-1,268,258,10
BR1_2726291244,5,False,0,0,0,17148,249,45,7.0,False,9,True,0,0,0,18476,230,53,7.4,True,29.759216666666667,-1328,-4,0,294,283,11
BR1_2731747126,10,False,1,0,0,19545,227,64,7.8,True,8,True,0,1,0,18853,211,57,7.4,False,28.94195,692,2,1,291,268,23
BR1_2729677715,15,True,1,1,0,20729,229,51,7.0,True,4,False,0,0,0,14237,177,48,6.4,False,25.767833333333332,6492,11,1,280,225,55
BR1_2729433557,8,False,1,0,0,16540,201,48,6.8,True,9,True,0,0,0,16877,160,44,6.4,False,25.500983333333334,-337,-1,1,249,204,45
BR1_2731908656,13,True,0,1,1,22115,253,58,7.8,False,5,False,1,0,0,17115,220,56,6.8,True,29.386966666666666,5000,8,-1,311,276,35
BR1_2731740842,4,False,0,0,0,13632,165,34,6.2,False,10,True,1,1,0,17975,188,48,6.8,True,27.114616666666667,-4343,-6,-1,199,236,-37
BR1_2731411600,16,False,1,0,0,20861,182,43,7.0,True,12,True,0,1,0,20809,249,72,7.6,False,28.04843333333333,52,4,1,225,321,-96
BR1_2730822753,10,False,0,0,0,18762,185,48,6.8,False,12,True,1,0,0,19274,208,63,7.0,True,29.368833333333335,-512,-2,-1,233,271,-38
BR1_2729957087,3,True,0,0,0,14336,195,48,6.6,False,10,False,1,0,0,18200,189,60,7.0,True,26.2085,-3864,-7,-1,243,249,-6
BR1_2728491581,10,True,0,1,0,18943,231,52,7.2,True,8,False,1,0,0,17150,222,51,7.0,False,26.622466666666668,1793,2,-1,283,273,10
BR1_2731635486,16,False,1,0,0,20273,168,48,7.2,False,7,True,0,0,0,16132,185,63,6.6,True,27.46538333333333,4141,9,1,216,248,-32
BR1_2731154736,8,True,1,0,0,17883,220,72,7.8,False,6,False,0,1,0,17161,238,47,7.2,True,28.79785,722,2,1,292,285,7
BR1_2730956496,10,True,0,0,0,18859,198,44,7.0,False,8,False,0,0,0,18763,249,64,7.0,True,29.979933333333335,96,2,0,242,313,-71
BR1_2730943999,9,False,0,0,0,16673,199,64,6.8,False,10,True,1,1,0,18118,189,50,7.0,True,27.14105,-1445,-1,-1,263,239,24
BR1_2730373464,7,True,1,1,0,16916,184,60,6.8,False,8,False,0,0,0,17870,209,64,6.8,True,26.54585,-954,-1,1,244,273,-29
BR1_2730365153,13,True,1,0,0,19544,201,40,6.6,True,8,False,0,0,0,17333,179,44,6.4,False,26.8229,2211,5,1,241,223,18
BR1_2679079048,6,True,0,0,0,16049,200,56,7.0,False,5,False,1,1,0,17256,238,60,7.4,True,27.7713,-1207,1,-1,256,298,-42
BR1_2731184499,5,True,0,0,0,15192,177,47,6.4,False,12,False,1,0,0,18948,229,48,7.2,True,25.868733333333335,-3756,-7,-1,224,277,-53
BR1_2731263536,12,True,0,0,0,20546,208,44,7.0,False,16,False,1,0,0,21444,184,44,7.2,True,29.133266666666668,-898,-4,-1,252,228,24
BR1_2729548627,4,False,1,0,0,14711,201,52,6.6,False,6,True,0,0,0,16488,213,52,7.0,True,25.948533333333334,-1777,-2,1,253,265,-12
BR1_2730203391,6,True,1,0,0,15421,171,52,6.8,True,4,False,0,0,0,15003,217,40,7.0,False,26.746466666666667,418,2,1,223,257,-34
BR1_2731761457,4,False,0,0,0,16758,246,62,7.4,False,8,True,1,0,0,19327,247,64,7.4,True,28.33,-2569,-4,-1,308,311,-3
BR1_2731734632,5,False,1,0,0,16124,214,60,7.2,False,9,True,0,0,0,19193,226,68,7.8,True,29.429433333333332,-3069,-4,1,274,294,-20
BR1_2731693985,12,True,1,1,0,19627,216,56,7.6,True,6,False,0,0,0,17031,200,48,6.8,False,27.61505,2596,6,1,272,248,24
BR1_2731145662,7,True,1,1,0,16879,181,56,6.8,True,5,False,0,0,0,15201,206,55,6.4,False,27.277233333333335,1678,2,1,237,261,-24
BR1_2719099011,9,False,0,0,0,18105,195,60,7.2,False,7,True,1,1,0,18467,184,68,7.0,True,28.50805,-362,2,-1,255,252,3
BR1_2718086008,10,True,0,1,0,20020,242,54,7.4,False,11,False,0,0,0,19706,200,48,7.4,True,29.671766666666667,314,-1,0,296,248,48
BR1_2716762628,16,True,0,1,0,21532,223,56,7.2,True,5,False,0,0,0,17221,208,52,7.2,False,29.7009,4311,11,0,279,260,19
BR1_2694410254,3,False,0,1,0,14851,197,48,6.8,False,6,True,0,0,0,16584,189,64,6.8,True,25.2368,-1733,-3,0,245,253,-8
BR1_2731024765,9,False,0,0,0,19405,238,60,7.4,False,6,True,1,0,0,18622,227,64,7.0,True,29.150533333333332,783,3,-1,298,291,7
BR1_2697934899,1,False,0,0,0,14879,223,51,7.4,False,10,True,0,1,0,19478,251,45,7.2,True,29.019516666666668,-4599,-9,0,274,296,-22
BR1_2728534839,9,True,0,0,0,18809,226,39,7.2,False,12,False,1,1,0,20828,240,68,7.8,True,28.218,-2019,-3,-1,265,308,-43
BR1_2728509897,6,False,0,1,0,16696,200,52,6.8,False,7,True,1,0,0,15321,178,40,6.6,True,26.506,1375,-1,-1,252,218,34
BR1_2728443629,5,True,0,0,0,15069,194,40,6.6,True,5,False,0,0,0,15021,193,49,6.6,False,26.10795,48,0,0,234,242,-8
BR1_2730288967,4,False,0,0,0,14183,176,44,6.2,False,15,True,0,0,0,20512,199,49,7.0,True,26.70425,-6329,-11,0,220,248,-28
BR1_2730148265,17,False,0,0,0,22278,198,60,7.4,False,16,True,1,0,0,23187,224,44,7.2,True,28.3898,-909,1,-1,258,268,-10
BR1_2723086037,4,False,0,1,0,16538,211,56,7.2,False,9,True,1,0,0,19220,252,60,7.6,True,29.487516666666668,-2682,-5,-1,267,312,-45
BR1_2730029738,7,True,0,0,0,17642,221,48,7.6,False,2,False,1,1,0,16301,232,64,7.2,True,28.245183333333333,1341,5,-1,269,296,-27
BR1_2726252491,11,True,0,0,0,20288,219,72,7.2,True,5,False,0,0,0,17434,230,56,7.0,False,29.177933333333332,2854,6,0,291,286,5
BR1_2726753566,12,False,0,0,0,18453,158,52,6.2,False,10,True,1,0,0,17635,166,48,6.4,True,26.567283333333332,818,2,-1,210,214,-4
BR1_2726736973,11,False,1,0,0,17273,151,48,6.4,False,14,True,0,0,1,22001,205,52,7.0,True,27.1226,-4728,-3,1,199,257,-58
BR1_2726520445,8,False,1,0,0,15431,179,44,6.8,False,13,True,0,0,0,19454,185,48,7.0,True,26.056066666666666,-4023,-5,1,223,233,-10
BR1_2726699209,6,False,1,0,0,15844,206,52,7.0,True,6,True,0,0,0,15249,171,51,6.6,False,27.41545,595,0,1,258,222,36
BR1_2698061825,12,False,1,0,0,17657,150,48,7.0,True,6,True,0,0,0,16598,244,48,6.6,False,26.353983333333332,1059,6,1,198,292,-94
BR1_2698042481,8,True,0,0,0,19220,237,60,7.4,True,5,False,1,0,0,16584,217,60,7.2,False,28.59326666666667,2636,3,-1,297,277,20
BR1_2697987691,6,False,0,0,0,18235,243,60,7.8,True,7,True,1,0,0,18078,238,64,7.6,False,27.512583333333332,157,-1,-1,303,302,1
BR1_2726896677,11,True,1,1,0,19781,221,72,7.4,True,6,False,0,0,0,17469,241,43,7.0,False,27.63135,2312,5,1,293,284,9
BR1_2731480324,5,True,0,0,0,14662,185,55,7.0,False,13,False,1,0,0,19051,223,60,7.2,True,25.288683333333335,-4389,-8,-1,240,283,-43
BR1_2731366944,13,True,0,0,0,19998,199,48,7.2,True,13,False,1,1,0,21678,189,73,7.4,False,29.0246,-1680,0,-1,247,262,-15
BR1_2731343048,11,True,1,0,0,18306,217,56,7.0,True,9,False,0,0,0,16697,177,47,7.0,False,25.60655,1609,2,1,273,224,49
BR1_2731761411,16,True,1,1,0,21822,187,60,7.0,True,14,False,0,0,0,19715,191,44,6.8,False,29.63885,2107,2,1,247,235,12
BR1_2731085293,5,False,0,0,0,16489,196,56,7.0,False,9,True,0,0,0,16809,167,56,6.8,True,25.593966666666667,-320,-4,0,252,223,29
BR1_2728329080,9,False,1,0,0,16675,196,44,6.8,False,4,True,0,1,0,15530,200,68,6.4,True,26.637483333333332,1145,5,1,240,268,-28
BR1_2727177138,11,True,1,1,0,18921,234,48,7.0,True,3,False,0,0,0,14221,200,47,6.6,False,26.634133333333335,4700,8,1,282,247,35
BR1_2690844844,6,False,1,1,0,17515,240,56,7.4,False,3,True,0,0,0,16632,234,44,7.4,True,27.935483333333334,883,3,1,296,278,18
BR1_2731300471,6,False,0,1,0,17258,215,51,7.4,True,4,True,1,0,0,16484,249,52,7.2,False,29.1094,774,2,-1,266,301,-35
BR1_2731272864,11,True,1,0,0,19533,196,76,7.6,False,6,False,0,0,0,17071,221,40,7.0,True,28.046983333333333,2462,5,1,272,261,11
BR1_2731239854,2,False,0,1,0,16101,249,54,7.4,False,7,True,1,0,0,19159,267,80,7.8,True,27.5606,-3058,-5,-1,303,347,-44
BR1_2717508130,3,False,1,0,0,14974,199,48,6.8,True,6,True,0,0,0,15806,204,52,6.8,False,27.168433333333333,-832,-3,1,247,256,-9
BR1_2711269327,4,False,0,0,0,16055,198,52,7.0,False,9,True,1,1,0,20146,285,52,7.4,True,28.521916666666666,-4091,-5,-1,250,337,-87
BR1_2711240392,9,True,1,0,1,19953,231,52,7.4,True,3,False,0,1,0,16218,212,48,7.0,False,28.99615,3735,6,1,283,260,23
BR1_2726416098,4,False,0,0,0,15597,209,56,6.6,False,6,True,1,0,0,16161,190,48,6.8,True,26.981316666666668,-564,-2,-1,265,238,27
BR1_2726391045,8,False,1,0,0,16694,189,56,6.6,False,10,True,0,1,0,18735,200,60,7.0,True,27.303416666666667,-2041,-2,1,245,260,-15
BR1_2731851246,11,True,0,1,0,20325,226,68,7.2,False,10,False,1,0,0,20356,235,80,7.6,True,27.958866666666665,-31,1,-1,294,315,-21
BR1_2731794682,12,True,1,0,0,18571,196,60,6.6,True,4,False,0,0,0,15223,163,56,6.6,False,26.1253,3348,8,1,256,219,37
BR1_2731658432,8,False,0,0,0,17562,205,53,7.6,True,4,True,0,0,0,17182,229,55,7.0,False,28.4143,380,4,0,258,284,-26
BR1_2724652819,11,False,1,0,0,18262,217,56,7.0,True,6,True,0,0,0,15957,175,57,6.8,False,26.577816666666667,2305,5,1,273,232,41
BR1_2724621925,10,True,1,0,0,19013,248,48,7.4,False,10,False,0,0,0,19128,233,56,7.2,True,29.45515,-115,0,1,296,289,7
BR1_2720859113,17,True,1,0,0,23789,237,68,7.4,True,14,False,0,0,0,20422,226,40,7.4,False,27.754216666666668,3367,3,1,305,266,39
BR1_2731238463,3,True,0,0,0,14920,203,52,6.6,False,4,False,0,0,0,16165,244,62,7.0,True,25.203583333333334,-1245,-1,0,255,306,-51
BR1_2730734430,6,True,0,0,0,16463,187,46,7.0,False,13,False,0,0,0,18946,183,52,7.2,True,26.54425,-2483,-7,0,233,235,-2
BR1_2731699202,7,True,0,1,0,18274,249,56,7.6,False,8,False,0,0,0,17967,206,80,7.8,True,28.70606666666667,307,-1,0,305,286,19
BR1_2729471484,7,False,0,0,0,16531,197,64,7.2,False,11,True,1,1,0,20509,259,48,7.8,True,27.795366666666666,-3978,-4,-1,261,307,-46
BR1_2714649291,9,False,0,1,0,17198,206,59,6.4,False,3,True,0,0,0,14702,187,60,6.2,True,27.042983333333332,2496,6,0,265,247,18
BR1_2703590810,5,True,1,0,0,16178,223,48,7.2,False,8,False,0,1,0,20610,285,72,7.8,True,28.183516666666666,-4432,-3,1,271,357,-86
BR1_2703566269,13,False,0,0,0,21511,214,44,7.2,False,12,True,1,0,0,19330,207,40,7.2,True,28.19235,2181,1,-1,258,247,11
BR1_2723169678,6,True,0,0,0,16149,187,40,6.6,False,11,False,1,0,0,20271,241,51,7.6,True,29.49905,-4122,-5,-1,227,292,-65
BR1_2716379584,4,True,1,0,0,16838,251,52,7.0,True,2,False,0,0,0,15081,207,52,7.0,False,29.434466666666665,1757,2,1,303,259,44
BR1_2729954151,10,False,1,0,1,21891,276,52,7.6,True,3,True,0,1,0,16319,210,69,7.2,False,28.076583333333332,5572,7,1,328,279,49
BR1_2729875213,13,True,1,0,0,19211,199,52,7.2,True,9,False,0,0,0,18781,231,60,7.4,False,29.124366666666667,430,4,1,251,291,-40
BR1_2728509151,5,False,0,1,0,18587,240,72,7.2,True,8,True,0,0,0,18540,236,40,7.4,False,28.54975,47,-3,0,312,276,36
BR1_2728107288,8,True,1,0,0,18191,214,52,7.4,True,9,False,0,0,0,18826,204,72,7.2,False,29.461766666666666,-635,-1,1,266,276,-10
BR1_2726572710,6,False,1,1,0,15518,158,54,6.8,True,10,True,0,0,0,16673,185,53,7.0,False,25.6521,-1155,-4,1,212,238,-26
BR1_2725858017,4,True,0,0,0,14862,174,56,6.4,False,8,False,1,1,0,18571,185,72,7.0,True,26.273966666666666,-3709,-4,-1,230,257,-27
BR1_2715859889,8,True,0,0,0,17528,179,34,6.6,False,16,False,1,0,0,20468,204,54,7.0,True,25.376366666666666,-2940,-8,-1,213,258,-45
BR1_2731780169,4,True,1,0,0,15316,191,48,6.8,False,10,False,0,0,0,18147,176,60,7.4,True,25.4126,-2831,-6,1,239,236,3
BR1_2698237799,14,True,1,0,0,21446,224,64,7.4,True,3,False,0,0,0,14067,155,36,6.4,False,28.75885,7379,11,1,288,191,97
BR1_2688732465,2,True,1,0,0,14603,195,44,7.0,False,8,False,0,0,0,18788,257,72,7.6,True,28.557716666666668,-4185,-6,1,239,329,-90
BR1_2688637711,2,False,1,0,0,14107,214,52,6.8,False,7,True,0,1,0,18157,219,72,7.2,True,25.995616666666667,-4050,-5,1,266,291,-25
BR1_2730647901,12,True,0,0,0,19768,235,44,7.6,False,8,False,1,0,0,19777,218,71,7.6,True,28.536416666666668,-9,4,-1,279,289,-10
BR1_2728312202,5,True,1,0,0,15698,222,44,7.0,True,3,False,0,0,0,15247,217,60,6.8,False,26.515233333333335,451,2,1,266,277,-11
BR1_2731784441,9,True,0,0,0,17125,198,48,6.8,False,3,False,1,0,0,13903,166,60,6.2,True,27.440683333333332,3222,6,-1,246,226,20
BR1_2730684595,6,False,0,0,0,17378,241,48,7.0,False,6,True,1,1,0,18499,229,60,7.4,True,29.437483333333333,-1121,0,-1,289,289,0
BR1_2731782879,9,True,0,0,0,18071,257,51,7.2,True,3,False,0,1,0,14539,191,52,7.0,False,26.597033333333332,3532,6,0,308,243,65
BR1_2731671486,3,False,0,1,0,16269,217,60,7.4,False,7,True,1,0,0,19272,245,72,7.8,True,28.908733333333334,-3003,-4,-1,277,317,-40
BR1_2730621878,7,False,0,1,0,17224,191,50,6.6,False,7,True,1,0,0,17293,189,49,6.6,True,25.948066666666666,-69,0,-1,241,238,3
BR1_2728364137,10,True,0,0,0,17328,179,47,6.2,False,10,False,1,0,0,18608,198,52,7.0,True,25.169416666666667,-1280,0,-1,226,250,-24
BR1_2731693872,8,False,0,0,0,16884,241,44,7.2,False,5,True,0,0,0,16888,227,72,7.2,True,26.174233333333333,-4,3,0,285,299,-14
BR1_2731670329,6,False,0,0,0,16132,221,56,7.0,False,9,True,1,0,0,18233,236,48,6.8,True,26.536616666666667,-2101,-3,-1,277,284,-7
BR1_2731619191,5,True,1,1,0,15247,207,40,7.0,False,9,False,0,0,0,19471,232,44,7.0,True,27.2294,-4224,-4,1,247,276,-29
BR1_2724369386,2,True,0,1,0,14981,216,64,7.0,True,2,False,1,0,0,14819,216,72,6.8,False,26.230416666666667,162,0,-1,280,288,-8
BR1_2724354382,7,True,0,0,0,15825,175,56,6.6,False,13,False,1,0,0,19255,230,56,7.2,True,25.609783333333333,-3430,-6,-1,231,286,-55
BR1_2729777605,10,True,1,1,0,19465,224,56,7.2,True,5,False,0,0,0,18619,222,68,7.4,False,28.59965,846,5,1,280,290,-10
BR1_2731803906,9,True,0,1,0,18287,202,48,6.6,True,6,False,1,0,0,16052,227,44,6.8,False,27.4138,2235,3,-1,250,271,-21
BR1_2731613635,3,True,0,0,0,16610,257,40,7.4,True,4,False,1,0,0,16169,226,64,7.2,False,28.076916666666666,441,-1,-1,297,290,7
BR1_2709896302,12,True,0,0,0,19307,199,69,6.8,True,8,False,0,0,0,17103,172,58,6.8,False,25.39865,2204,4,0,268,230,38
BR1_2728783406,18,True,1,1,0,21882,217,64,8.0,True,6,False,0,0,0,17916,216,44,7.0,False,27.770416666666666,3966,12,1,281,260,21
BR1_2728294584,4,False,0,0,0,16424,223,51,7.4,False,4,True,1,1,0,16419,219,48,7.2,True,27.60335,5,0,-1,274,267,7
BR1_2704237031,7,False,0,0,0,17464,228,48,7.4,False,4,True,1,0,0,16269,248,52,7.0,True,29.519333333333332,1195,3,-1,276,300,-24
BR1_2731781465,10,False,1,0,0,16626,160,44,6.6,True,7,True,0,0,0,15661,182,44,6.4,False,25.560666666666666,965,3,1,204,226,-22
BR1_2731759231,4,False,1,0,0,15233,219,51,6.6,False,4,True,0,0,0,15630,227,48,6.8,True,25.039083333333334,-397,0,1,270,275,-5
BR1_2731247408,3,True,1,1,0,16563,238,64,7.0,True,7,False,0,0,0,18155,210,68,7.2,False,28.373933333333333,-1592,-4,1,302,278,24
BR1_2731221646,6,True,0,0,0,17450,212,54,7.2,False,2,False,1,0,0,16172,218,66,7.0,True,28.5054,1278,4,-1,266,284,-18
BR1_2731828387,7,False,0,0,0,17538,221,55,6.8,True,4,True,0,0,0,14996,196,52,6.6,False,25.3943,2542,3,0,276,248,28
BR1_2731685318,4,False,0,0,0,15448,196,72,7.2,False,7,True,1,0,0,18559,227,56,7.4,True,28.495983333333335,-3111,-3,-1,268,283,-15
BR1_2731744694,12,True,1,0,0,18119,206,44,6.2,True,4,False,0,0,0,13998,146,56,6.4,False,25.88405,4121,8,1,250,202,48
BR1_2730118000,6,True,0,1,0,15413,208,40,6.6,False,10,False,1,0,0,18186,203,47,7.0,True,27.4443,-2773,-4,-1,248,250,-2
BR1_2709062920,11,True,0,0,0,18075,198,56,6.8,False,7,False,0,0,0,17432,220,64,7.0,True,26.427,643,4,0,254,284,-30
BR1_2707087686,11,True,0,1,0,19013,213,68,7.2,True,5,False,0,0,0,15272,182,56,6.4,False,25.854883333333333,3741,6,0,281,238,43
BR1_2729106972,11,True,1,1,0,20358,215,60,7.2,True,7,False,0,0,0,17287,199,60,7.2,False,27.7529,3071,4,1,275,259,16
BR1_2729086878,10,True,1,0,0,18503,200,44,6.8,True,7,False,0,1,0,15271,155,44,6.4,False,26.684316666666668,3232,3,1,244,199,45
BR1_2722894369,7,True,0,1,1,19329,229,52,7.2,False,15,False,0,0,0,21103,224,59,7.6,True,29.668683333333334,-1774,-8,0,281,283,-2
BR1_2731619251,6,True,1,0,0,16886,246,54,7.2,True,0,False,0,0,0,12741,183,49,6.8,False,27.416016666666668,4145,6,1,300,232,68
BR1_2731597634,7,False,0,1,0,19186,250,64,7.8,False,9,True,0,0,0,19901,232,45,7.4,True,28.68155,-715,-2,0,314,277,37
BR1_2730250954,7,True,0,0,0,17189,235,47,6.8,False,10,False,1,0,0,17919,190,51,7.0,True,26.7805,-730,-3,-1,282,241,41
BR1_2731082185,9,True,1,1,0,19518,224,64,7.2,True,8,False,0,0,0,18434,244,64,7.4,False,27.84435,1084,1,1,288,308,-20
BR1_2730283467,11,True,1,0,0,16934,141,56,6.8,False,15,False,0,1,0,20939,202,55,7.0,True,25.646883333333335,-4005,-4,1,197,257,-60
BR1_2731840812,6,True,1,0,0,15844,169,43,6.8,False,6,False,0,0,0,15568,182,60,6.6,True,25.03485,276,0,1,212,242,-30
BR1_2731696559,5,False,1,1,1,18609,236,52,7.2,True,9,True,0,0,0,19453,209,76,7.4,False,28.614883333333335,-844,-4,1,288,285,3
BR1_2724323321,8,False,0,0,0,17123,194,51,7.0,False,11,True,1,0,0,18445,168,68,7.2,True,29.522583333333333,-1322,-3,-1,245,236,9
BR1_2731504715,8,True,0,1,0,17117,176,52,6.8,True,5,False,0,0,0,15261,188,48,6.6,False,26.451933333333333,1856,3,0,228,236,-8
BR1_2731181109,5,False,1,0,0,15962,208,52,7.2,True,5,True,0,0,0,17944,245,52,7.4,False,29.235,-1982,0,1,260,297,-37
BR1_2722187391,7,True,1,0,0,15098,195,50,6.8,False,6,False,0,0,0,15692,197,48,6.4,True,26.144333333333332,-594,1,1,245,245,0
BR1_2722170325,10,True,0,0,0,18971,212,56,7.2,True,13,False,1,0,0,21285,253,67,7.4,False,28.66035,-2314,-3,-1,268,320,-52
BR1_2731855640,10,True,0,0,0,19167,219,52,7.4,False,9,False,1,0,0,18779,214,44,7.6,True,27.51875,388,1,-1,271,258,13
BR1_2731563729,9,False,0,0,0,19337,227,40,7.0,False,12,True,1,1,1,21880,229,64,7.2,True,27.523783333333334,-2543,-3,-1,267,293,-26
BR1_2731549775,10,False,1,0,0,18927,206,60,7.2,True,12,True,0,0,0,20638,198,57,7.2,False,28.05945,-1711,-2,1,266,255,11
BR1_2730957575,11,True,0,1,0,19978,258,70,7.6,True,13,False,0,0,0,20333,231,59,7.6,False,29.169566666666668,-355,-2,0,328,290,38
BR1_2730423010,7,False,1,0,0,17729,225,79,7.2,True,9,True,0,0,0,18799,203,60,7.2,False,28.895566666666667,-1070,-2,1,304,263,41
BR1_2673244022,3,True,0,0,0,16368,241,52,7.2,False,10,False,1,0,0,20827,257,71,8.0,True,29.70093333333333,-4459,-7,-1,293,328,-35
BR1_2673201908,4,False,0,1,0,15897,193,48,7.0,False,7,True,1,0,0,18952,237,60,7.6,True,28.6116,-3055,-3,-1,241,297,-56
BR1_2697414614,5,False,0,0,0,16012,217,52,6.8,True,10,True,1,0,0,17938,193,44,6.8,False,25.80265,-1926,-5,-1,269,237,32
BR1_2681560410,8,False,0,1,0,17004,170,56,7.0,True,5,True,0,0,0,15314,206,60,7.0,False,27.046783333333334,1690,3,0,226,266,-40
BR1_2731779248,7,False,0,0,0,16958,212,51,6.8,False,8,True,1,1,0,19618,236,80,7.4,True,27.848266666666667,-2660,-1,-1,263,316,-53
BR1_2731662335,10,True,0,1,0,17926,171,44,6.6,False,13,False,1,0,0,19198,219,36,6.8,True,26.031416666666665,-1272,-3,-1,215,255,-40
BR1_2664767056,2,False,1,0,0,14091,200,56,6.6,False,9,True,0,0,0,18068,218,44,6.6,True,26.554183333333334,-3977,-7,1,256,262,-6
BR1_2726369724,4,False,0,1,0,16425,230,63,7.2,False,16,True,1,0,0,21925,218,56,7.6,True,29.457333333333334,-5500,-12,-1,293,274,19
BR1_2726341369,12,True,1,0,0,20933,229,48,7.2,True,14,False,0,0,0,19274,194,44,7.0,False,27.862116666666665,1659,-2,1,277,238,39
BR1_2730708719,12,False,0,1,0,20164,239,54,7.4,True,4,True,1,0,0,17485,250,73,7.4,False,28.296316666666666,2679,8,-1,293,323,-30
BR1_2725111589,13,True,1,0,1,19339,201,44,7.0,True,6,False,0,1,0,16567,205,51,7.0,False,26.9961,2772,7,1,245,256,-11
BR1_2731698826,9,False,1,0,0,19016,225,76,7.4,True,8,True,0,1,0,18265,216,48,7.0,False,28.503716666666666,751,1,1,301,264,37
BR1_2724527080,10,True,1,1,0,18954,231,56,7.2,True,7,False,0,0,0,15861,172,44,6.4,False,27.13465,3093,3,1,287,216,71
BR1_2730979391,6,False,0,1,0,18779,245,60,7.4,False,7,True,1,0,0,18036,251,66,7.4,True,27.531383333333334,743,-1,-1,305,317,-12
BR1_2730604034,8,False,0,0,0,17839,225,44,6.8,True,9,True,1,0,0,16929,179,48,6.8,False,26.024283333333333,910,-1,-1,269,227,42
BR1_2693122692,4,True,0,0,0,17112,239,61,7.4,False,6,False,1,1,0,18208,266,72,7.8,True,28.64143333333333,-1096,-2,-1,300,338,-38
BR1_2690148080,8,True,1,0,0,16144,182,56,6.8,True,6,False,0,0,0,14923,176,44,6.4,False,27.47025,1221,2,1,238,220,18
BR1_2731721733,5,True,1,0,0,16062,229,54,6.4,True,3,False,0,0,0,13921,185,44,6.8,False,26.1753,2141,2,1,283,229,54
BR1_2731630546,9,True,0,0,0,17912,230,48,7.0,False,9,False,1,0,0,19191,208,68,7.2,True,27.791366666666665,-1279,0,-1,278,276,2
BR1_2698999786,7,False,0,0,0,16248,188,53,7.0,False,11,True,0,0,0,19104,219,44,6.8,True,25.343216666666667,-2856,-4,0,241,263,-22
BR1_2731715992,7,True,0,0,0,16538,213,56,6.8,True,6,False,1,1,0,16345,194,56,7.0,False,26.4294,193,1,-1,269,250,19
BR1_2716082012,8,True,1,0,0,18195,235,60,7.6,True,5,False,0,0,0,18121,223,74,7.4,False,29.474716666666666,74,3,1,295,297,-2
BR1_2715623758,7,True,0,0,0,17161,217,44,7.0,True,3,False,0,0,0,13258,153,44,6.2,False,25.695266666666665,3903,4,0,261,197,64
BR1_2715601768,7,False,0,0,0,18668,224,68,7.4,True,8,True,1,0,0,19920,223,76,7.6,False,29.790333333333333,-1252,-1,-1,292,299,-7
BR1_2701126909,2,False,0,0,0,15018,189,60,7.0,False,8,True,1,1,0,19303,256,64,7.6,True,27.55666666666667,-4285,-6,-1,249,320,-71
BR1_2731713823,8,True,1,0,0,17403,232,64,7.4,True,2,False,0,0,0,14455,237,42,7.0,False,25.563416666666665,2948,6,1,296,279,17
BR1_2731560876,7,True,1,0,0,18028,219,52,7.0,True,4,False,0,0,0,15041,179,56,6.8,False,25.299866666666667,2987,3,1,271,235,36
BR1_2730461063,9,False,1,0,0,17500,192,56,6.6,True,7,True,0,1,0,16020,189,44,7.0,False,25.368916666666667,1480,2,1,248,233,15
BR1_2729854450,13,True,0,1,0,20334,230,49,7.6,True,6,False,1,0,0,17070,217,77,7.2,False,29.69315,3264,7,-1,279,294,-15
BR1_2729057805,6,False,0,1,0,16112,210,44,6.8,True,6,True,0,0,0,16506,197,60,7.0,False,25.274566666666665,-394,0,0,254,257,-3
BR1_2729032696,6,True,1,1,0,17568,228,64,7.4,True,5,False,0,0,0,18035,236,68,7.4,False,29.830833333333334,-467,1,1,292,304,-12
BR1_2730445757,6,False,1,0,0,15600,168,44,6.6,False,9,True,0,0,0,17562,221,54,6.8,True,26.26775,-1962,-3,1,212,275,-63
BR1_2730089983,9,False,0,1,0,19583,252,50,7.6,True,10,True,1,0,0,19054,233,64,7.4,False,28.442533333333333,529,-1,-1,302,297,5
BR1_2731868921,9,False,0,0,0,17365,210,36,6.8,False,7,True,1,1,0,18396,219,68,7.8,True,29.271933333333333,-1031,2,-1,246,287,-41
BR1_2731827214,9,False,1,0,0,16190,173,36,6.4,False,10,True,0,0,0,16683,174,44,6.4,True,25.2657,-493,-1,1,209,218,-9
BR1_2704729390,9,False,0,1,0,17736,221,40,7.0,True,2,True,1,0,0,14118,207,56,6.6,False,27.485116666666666,3618,7,-1,261,263,-2
BR1_2689015744,11,False,0,1,0,17618,202,43,6.8,False,13,True,0,0,0,19017,203,56,6.8,True,27.128633333333333,-1399,-2,0,245,259,-14
BR1_2689001107,11,False,0,1,2,22119,251,52,7.8,True,6,True,1,0,0,16555,190,60,7.0,False,29.161583333333333,5564,5,-1,303,250,53
BR1_2711304949,7,True,0,1,0,18698,218,52,7.2,False,14,False,1,0,0,21474,200,52,7.2,True,27.733266666666665,-2776,-7,-1,270,252,18
BR1_2717957549,8,False,0,1,0,19253,220,68,7.4,True,9,True,1,0,0,19248,233,38,7.2,False,28.6128,5,-1,-1,288,271,17
BR1_2717911419,10,True,1,1,0,17083,239,48,7.0,True,3,False,0,0,0,14183,187,56,6.8,False,27.283816666666667,2900,7,1,287,243,44
BR1_2729672338,6,False,0,0,0,17095,203,51,7.0,False,8,True,0,0,0,19458,229,56,7.4,True,27.788083333333333,-2363,-2,0,254,285,-31
BR1_2676658224,7,True,0,0,0,18086,235,52,6.8,True,6,False,1,0,0,15945,209,52,6.4,False,26.5594,2141,1,-1,287,261,26
BR1_2707700893,10,False,0,0,0,20648,259,60,7.6,True,12,True,1,0,0,20280,221,52,7.6,False,28.5564,368,-2,-1,319,273,46
BR1_2731638244,14,False,0,1,0,20880,257,56,7.6,False,4,True,1,0,0,16782,227,52,7.2,True,27.8795,4098,10,-1,313,279,34
BR1_2730918481,15,True,0,0,1,23711,237,56,7.4,True,9,False,1,1,0,17633,207,36,6.8,False,28.87095,6078,6,-1,293,243,50
BR1_2723916706,11,True,0,0,0,18425,223,56,7.2,False,6,False,1,0,0,17051,195,64,7.2,True,28.439083333333333,1374,5,-1,279,259,20
BR1_2723885911,7,True,0,0,0,17125,196,60,7.2,True,6,False,0,0,0,15139,173,44,6.6,False,26.69015,1986,1,0,256,217,39
BR1_2690790146,10,True,1,0,0,20598,249,52,7.6,False,9,False,0,0,0,18403,205,48,6.8,True,29.5619,2195,1,1,301,253,48
BR1_2730953333,8,True,1,0,0,18159,245,52,7.4,False,6,False,0,1,1,18700,220,40,7.4,True,29.544916666666666,-541,2,1,297,260,37
BR1_2731909916,11,True,0,0,0,18700,198,64,7.2,True,2,False,1,0,0,13988,187,56,6.4,False,27.30975,4712,9,-1,262,243,19
BR1_2728416849,8,True,1,0,0,16144,184,60,7.0,True,4,False,0,1,0,14070,162,44,6.6,False,26.40835,2074,4,1,244,206,38
BR1_2730158064,13,True,1,0,0,19447,196,44,7.2,True,5,False,0,1,0,19911,267,68,7.8,False,27.791283333333332,-464,8,1,240,335,-95
BR1_2719786068,10,False,0,1,0,18380,192,56,7.2,False,7,True,1,0,0,16738,201,48,6.8,True,26.029416666666666,1642,3,-1,248,249,-1
BR1_2687749285,9,False,0,0,0,17677,179,56,6.6,False,8,True,1,0,0,17656,188,60,6.8,True,26.6683,21,1,-1,235,248,-13
BR1_2686184906,8,True,0,0,0,17676,211,59,7.2,False,13,False,1,1,0,18808,201,72,7.6,True,29.61895,-1132,-5,-1,270,273,-3
BR1_2722322118,6,False,0,0,0,17227,177,64,6.8,False,8,True,0,1,0,17462,184,64,6.8,True,26.86715,-235,-2,0,241,248,-7
BR1_2731683137,6,False,0,0,0,16643,237,39,7.0,True,11,True,1,1,1,20410,235,60,7.6,False,28.957766666666668,-3767,-5,-1,276,295,-19
BR1_2700202496,9,True,0,0,0,17144,183,39,6.6,False,5,False,1,1,0,16438,217,60,6.6,True,26.2849,706,4,-1,222,277,-55
BR1_2699324771,7,True,1,0,0,16921,180,48,6.4,True,10,False,0,1,0,19296,217,54,7.0,False,25.665916666666668,-2375,-3,1,228,271,-43
BR1_2725608415,8,True,0,0,0,18948,213,70,7.4,True,5,False,1,0,0,15584,202,36,6.8,False,29.440066666666667,3364,3,-1,283,238,45
BR1_2730852834,9,False,1,0,0,17301,223,43,7.0,True,4,True,0,1,0,15122,183,56,6.8,False,25.200633333333332,2179,5,1,266,239,27
BR1_2730843471,5,True,0,0,0,15204,183,40,6.8,False,6,False,0,1,0,16718,194,68,7.0,True,25.646083333333333,-1514,-1,0,223,262,-39
BR1_2730832448,4,True,1,0,0,14914,222,48,6.6,True,4,False,0,0,0,15219,208,64,6.8,False,26.53105,-305,0,1,270,272,-2
BR1_2730355910,7,True,0,0,0,17137,181,56,6.8,False,14,False,1,1,1,22408,218,72,7.8,True,27.901883333333334,-5271,-7,-1,237,290,-53
BR1_2729915933,10,True,1,0,0,19001,220,56,7.2,False,10,False,0,1,0,20046,234,60,7.4,True,29.46755,-1045,0,1,276,294,-18
BR1_2731694425,3,False,0,0,0,14426,166,48,6.4,False,11,True,1,0,0,18673,226,60,7.2,True,26.98195,-4247,-8,-1,214,286,-72
BR1_2731743047,4,False,0,0,0,15246,176,60,6.8,False,6,True,1,0,0,16528,221,60,7.0,True,25.67895,-1282,-2,-1,236,281,-45
BR1_2730196520,11,False,1,1,0,20003,212,60,7.4,False,9,True,0,0,0,19091,230,48,7.0,True,29.433933333333332,912,2,1,272,278,-6
BR1_2730169454,6,False,1,0,0,15041,163,60,6.6,False,7,True,0,1,0,16407,191,35,6.8,True,25.67575,-1366,-1,1,223,226,-3
BR1_2730605742,7,False,1,0,0,17149,207,52,7.0,True,6,True,0,0,0,15434,191,44,6.4,False,25.9365,1715,1,1,259,235,24
BR1_2731542124,6,False,0,1,0,19298,198,60,7.2,False,8,True,1,0,0,17711,230,64,7.4,True,27.81555,1587,-2,-1,258,294,-36
BR1_2730747414,10,False,0,1,0,18408,206,75,7.4,True,11,True,1,0,0,20192,229,48,7.6,False,28.512033333333335,-1784,-1,-1,281,277,4
BR1_2730686446,10,True,1,0,0,18515,206,72,7.6,False,9,False,0,0,0,20520,265,64,7.4,True,27.719516666666667,-2005,1,1,278,329,-51
BR1_2730659515,5,True,0,0,0,15428,169,44,6.2,False,9,False,1,0,0,18058,205,68,7.0,True,27.0798,-2630,-4,-1,213,273,-60
BR1_2716846112,10,False,0,1,0,19715,223,48,7.2,True,10,True,1,0,0,19370,206,64,7.0,False,28.41505,345,0,-1,271,270,1
BR1_2715333300,6,False,0,1,0,17749,240,68,7.6,True,10,True,1,0,0,17759,195,68,7.2,False,28.000416666666666,-10,-4,-1,308,263,45
BR1_2728969482,12,True,0,0,0,21369,234,68,7.6,False,6,False,1,0,0,17700,222,72,7.2,True,27.8852,3669,6,-1,302,294,8
BR1_2706465777,13,True,1,0,0,19771,241,44,7.2,True,5,False,0,1,0,16974,179,52,6.8,False,29.09015,2797,8,1,285,231,54
BR1_2730082984,8,False,1,0,0,18122,202,68,7.2,False,8,True,0,0,0,18487,224,56,7.4,True,29.984583333333333,-365,0,1,270,280,-10
BR1_2731850895,16,False,1,0,0,20811,188,60,7.8,True,8,True,0,0,0,19676,237,44,7.4,False,28.151883333333334,1135,8,1,248,281,-33
BR1_2726231386,8,False,0,0,0,17158,173,47,6.4,False,11,True,1,0,0,17169,148,44,6.4,True,27.042333333333332,-11,-3,-1,220,192,28
BR1_2725619849,10,False,0,0,0,19258,211,60,7.0,False,6,True,1,1,0,17240,196,56,7.2,True,29.459066666666665,2018,4,-1,271,252,19
BR1_2731525313,7,False,1,1,0,16373,189,60,6.8,False,6,True,0,0,0,16242,200,64,7.2,True,27.127483333333334,131,1,1,249,264,-15
BR1_2731506814,6,False,1,0,0,15399,185,48,6.6,True,7,True,0,1,0,16905,187,64,7.0,False,26.656433333333332,-1506,-1,1,233,251,-18
BR1_2731174276,8,True,0,0,0,18483,221,60,7.2,True,7,False,1,0,0,17155,199,56,7.0,False,29.7617,1328,1,-1,281,255,26
BR1_2731560578,3,False,0,0,0,15785,196,60,7.4,False,6,True,1,0,0,17461,225,76,7.6,True,29.631883333333334,-1676,-3,-1,256,301,-45
BR1_2731532223,7,True,1,0,0,16425,203,60,7.0,True,3,False,0,0,0,14831,193,56,6.6,False,26.299083333333332,1594,4,1,263,249,14
BR1_2731683437,7,False,1,1,0,18187,227,48,7.0,True,8,True,0,0,0,17766,187,60,7.0,False,29.167816666666667,421,-1,1,275,247,28
BR1_2722901906,5,False,0,0,0,15366,186,36,6.6,False,13,True,0,0,0,19589,204,55,7.0,True,25.20735,-4223,-8,0,222,259,-37
BR1_2730289687,4,False,0,0,0,14886,176,68,6.4,False,13,True,1,0,0,19281,206,56,7.0,True,27.161616666666667,-4395,-9,-1,244,262,-18
BR1_2730260882,11,True,0,0,0,18893,210,49,7.0,True,7,False,0,0,0,17660,193,55,6.6,False,27.626183333333334,1233,4,0,259,248,11
BR1_2730514093,6,True,0,0,0,15822,194,45,6.8,False,4,False,1,1,0,14992,180,60,6.6,True,25.331516666666666,830,2,-1,239,240,-1
BR1_2731779875,5,False,0,1,0,16627,220,56,7.2,False,8,True,1,0,0,16661,203,56,7.0,True,26.320833333333333,-34,-3,-1,276,259,17
BR1_2731755733,5,False,0,0,0,15923,196,56,6.8,True,6,True,1,1,0,18123,233,59,7.4,False,29.88775,-2200,-1,-1,252,292,-40
BR1_2731569667,6,False,0,0,0,17093,220,56,7.2,False,6,True,1,0,0,16041,200,56,6.6,True,26.557883333333333,1052,0,-1,276,256,20
BR1_2730978471,7,True,1,0,0,16929,246,48,6.8,True,6,False,0,0,0,15355,183,62,7.0,False,25.598916666666668,1574,1,1,294,245,49
BR1_2730967601,8,False,1,0,0,18414,206,68,7.4,False,7,True,0,1,0,19110,281,52,7.4,True,28.236883333333335,-696,1,1,274,333,-59
BR1_2727876265,7,True,0,1,0,18132,228,60,7.6,False,7,False,1,0,0,18258,234,48,7.2,True,29.01645,-126,0,-1,288,282,6
BR1_2709300346,11,True,1,0,0,18280,198,44,6.8,True,7,False,0,1,0,16420,164,60,6.6,False,25.402283333333333,1860,4,1,242,224,18
BR1_2709249733,4,False,0,0,0,14756,190,62,7.2,False,3,True,0,0,0,15259,243,60,7.0,True,25.473416666666665,-503,1,0,252,303,-51
BR1_2692708889,9,False,1,0,0,19165,224,68,7.2,True,5,True,0,0,0,17633,227,52,7.0,False,28.551616666666668,1532,4,1,292,279,13
BR1_2692249871,3,False,1,0,0,16005,228,56,7.2,True,5,True,0,1,0,17778,239,76,8.0,False,28.8528,-1773,-2,1,284,315,-31
BR1_2730825992,7,False,0,0,0,18175,248,57,7.4,True,5,True,1,0,0,17866,249,66,7.4,False,28.180466666666668,309,2,-1,305,315,-10
BR1_2730040426,13,True,1,1,0,18950,193,43,6.8,True,4,False,0,0,0,15025,201,52,6.4,False,25.311383333333332,3925,9,1,236,253,-17
BR1_2731857078,4,True,0,1,0,16577,213,44,7.2,False,6,False,1,0,0,16033,205,64,7.2,True,29.734716666666667,544,-2,-1,257,269,-12
BR1_2731008916,4,False,0,0,0,15583,199,43,6.8,False,10,True,1,0,0,18305,211,64,7.0,True,26.486316666666667,-2722,-6,-1,242,275,-33
BR1_2730994370,4,True,0,0,0,17107,220,54,7.4,False,7,False,1,1,1,19786,231,74,7.6,True,28.1844,-2679,-3,-1,274,305,-31
BR1_2730289180,8,True,0,0,0,16364,170,8,5.8,False,7,False,0,0,0,16969,211,48,6.6,True,25.341533333333334,-605,1,0,178,259,-81
BR1_2726085288,5,False,0,0,0,15206,173,52,6.6,False,8,True,1,0,0,16728,188,56,7.0,True,25.8791,-1522,-3,-1,225,244,-19
BR1_2731719284,5,True,0,0,0,15581,210,72,6.8,False,3,False,0,0,0,14782,192,51,6.4,True,27.162566666666667,799,2,0,282,243,39
BR1_2724085415,7,False,0,1,0,18771,217,56,7.0,False,7,True,1,0,0,17654,198,52,7.2,True,28.879583333333333,1117,0,-1,273,250,23
BR1_2727221208,8,True,0,0,1,20542,242,64,7.4,False,8,False,1,1,0,18934,181,76,7.4,True,27.75145,1608,0,-1,306,257,49
BR1_2731157302,7,False,1,0,1,16044,166,48,6.4,False,13,True,0,0,0,18329,183,54,7.0,True,26.097366666666666,-2285,-6,1,214,237,-23
BR1_2729371883,10,True,0,0,0,19912,231,46,7.0,True,5,False,1,1,0,17494,238,52,6.8,False,28.5583,2418,5,-1,277,290,-13
BR1_2720581330,5,False,1,0,0,15359,184,56,6.4,True,5,True,0,0,0,16092,212,56,7.0,False,25.765116666666668,-733,0,1,240,268,-28
BR1_2718967829,6,True,1,0,0,17903,205,80,7.0,True,7,False,0,0,0,18498,256,52,7.8,False,28.643816666666666,-595,-1,1,285,308,-23
BR1_2731093083,2,True,0,0,0,14263,188,55,6.6,True,4,False,1,0,0,14642,209,48,6.8,False,25.7152,-379,-2,-1,243,257,-14
BR1_2730594767,6,True,1,0,0,16362,212,52,7.0,True,9,False,0,1,0,17897,206,44,7.0,False,25.814683333333335,-1535,-3,1,264,250,14
BR1_2730567254,10,True,1,1,0,21510,251,51,7.4,True,5,False,0,0,0,16937,189,64,7.4,False,27.9144,4573,5,1,302,253,49
BR1_2731442402,8,True,0,0,0,16633,251,0,7.0,False,9,False,1,1,0,19317,222,84,7.4,True,27.997083333333332,-2684,-1,-1,251,306,-55
BR1_2686702368,5,False,0,0,0,17467,212,72,7.2,True,9,True,1,1,0,19305,224,68,7.8,False,27.8565,-1838,-4,-1,284,292,-8
BR1_2686687551,6,True,1,1,0,19479,260,72,7.8,True,4,False,0,0,0,16710,228,58,7.4,False,27.504633333333334,2769,2,1,332,286,46
BR1_2686252972,9,True,0,0,0,17947,197,44,7.2,True,2,False,1,0,0,14344,199,55,6.8,False,26.839,3603,7,-1,241,254,-13
BR1_2673832080,13,False,1,0,0,18866,202,53,7.2,True,11,True,0,0,0,21383,247,56,7.4,False,28.551316666666665,-2517,2,1,255,303,-48
BR1_2673800605,3,False,0,0,0,14101,183,42,6.4,False,8,True,1,0,0,18274,227,60,7.0,True,25.12095,-4173,-5,-1,225,287,-62
BR1_2673758710,13,True,0,1,1,22713,212,61,7.6,True,9,False,0,0,0,18064,200,44,7.4,False,28.741183333333332,4649,4,0,273,244,29
BR1_2719835858,9,True,0,0,0,19728,246,48,7.4,True,1,False,0,1,0,14276,180,60,6.8,False,27.815483333333333,5452,8,0,294,240,54
BR1_2724774130,7,False,1,0,0,16661,172,47,7.2,False,17,True,0,1,2,23797,239,60,8.0,True,28.155683333333332,-7136,-10,1,219,299,-80
BR1_2731446329,12,True,1,0,0,19064,214,44,6.6,True,11,False,0,1,0,17890,192,40,7.0,False,26.329666666666668,1174,1,1,258,232,26
BR1_2731437059,11,False,0,0,0,17331,170,48,6.4,True,8,True,1,0,0,15890,169,40,6.4,False,27.1207,1441,3,-1,218,209,9
BR1_2730691919,5,True,1,0,0,15492,226,48,7.0,True,3,False,0,0,0,14704,212,52,6.8,False,25.213783333333332,788,2,1,274,264,10
BR1_2731179007,6,False,0,0,1,18087,244,40,7.0,False,8,True,1,1,0,18695,196,72,7.0,True,27.765333333333334,-608,-2,-1,284,268,16
BR1_2730112314,14,False,0,0,0,18753,200,42,7.0,True,7,True,0,0,0,16452,182,62,6.6,False,25.4011,2301,7,0,242,244,-2
BR1_2669959597,11,False,0,0,0,20424,197,62,7.4,False,13,True,1,1,0,21504,219,64,7.6,True,29.6189,-1080,-2,-1,259,283,-24
BR1_2731862643,3,False,0,1,0,13751,160,60,6.6,False,9,True,1,0,0,17886,205,55,6.8,True,26.291183333333333,-4135,-6,-1,220,260,-40
BR1_2730033859,9,False,0,0,0,18362,201,56,7.6,False,9,True,1,0,0,18324,237,52,7.4,True,29.08775,38,0,-1,257,289,-32
BR1_2721707284,14,True,1,0,0,20318,204,56,7.0,False,9,False,0,0,0,19537,234,56,7.2,True,29.901966666666667,781,5,1,260,290,-30
BR1_2710281541,5,False,1,0,0,17059,208,52,7.4,False,10,True,0,1,0,19919,229,64,7.4,True,28.8779,-2860,-5,1,260,293,-33
BR1_2710209270,9,False,1,0,0,17201,162,48,6.6,False,12,True,0,0,0,19060,176,60,7.2,True,28.954983333333335,-1859,-3,1,210,236,-26
BR1_2716258101,8,True,1,0,0,16965,199,55,7.0,True,1,False,0,0,0,13940,202,44,6.4,False,27.01715,3025,7,1,254,246,8
BR1_2714363942,12,True,1,0,0,21068,234,68,7.4,True,4,False,0,0,0,16723,232,67,7.2,False,27.919083333333333,4345,8,1,302,299,3
BR1_2694383291,12,False,0,1,0,20193,237,62,7.6,True,8,True,0,0,0,18258,221,60,7.4,False,29.045533333333335,1935,4,0,299,281,18
BR1_2729346622,10,False,0,1,0,19272,196,76,7.4,False,6,True,1,0,0,16476,177,52,7.0,True,28.249483333333334,2796,4,-1,272,229,43
BR1_2729313275,9,True,0,0,0,17816,217,60,6.8,False,12,False,1,0,0,18708,181,52,7.0,True,26.165216666666666,-892,-3,-1,277,233,44
BR1_2730221853,2,False,0,0,0,13683,178,46,6.4,False,13,True,1,1,1,20652,237,46,7.0,True,26.15255,-6969,-11,-1,224,283,-59
BR1_2731838804,14,True,1,0,0,20737,188,60,7.4,True,6,False,0,1,0,17771,211,64,7.2,False,29.142966666666666,2966,8,1,248,275,-27
BR1_2727007639,3,True,0,1,0,17390,251,56,7.6,True,0,False,1,0,0,14325,226,64,7.2,False,29.567683333333335,3065,3,-1,307,290,17
BR1_2726092094,15,True,0,0,0,20831,208,52,7.4,True,6,False,0,0,0,17891,193,60,7.2,False,28.72436666666667,2940,9,0,260,253,7
BR1_2726046144,8,True,1,1,0,18169,247,44,7.4,False,11,False,0,0,0,19687,241,60,7.4,True,29.2548,-1518,-3,1,291,301,-10
BR1_2731713977,11,True,1,0,0,18368,202,48,6.8,True,5,False,0,1,0,15861,173,48,6.6,False,28.678233333333335,2507,6,1,250,221,29
BR1_2726546259,0,False,0,0,0,12270,191,40,6.4,False,7,True,1,0,0,16007,157,44,6.8,True,25.499333333333333,-3737,-7,-1,231,201,30
BR1_2725521366,4,False,0,0,0,15161,219,8,6.6,False,6,True,0,0,1,18766,269,56,7.2,True,27.923083333333334,-3605,-2,0,227,325,-98
BR1_2693595391,7,False,0,1,0,18472,216,48,7.2,True,6,True,0,0,0,17522,219,44,7.2,False,27.5532,950,1,0,264,263,1
BR1_2730732607,9,True,1,0,0,19209,219,64,7.6,True,6,False,0,0,0,16654,207,56,7.0,False,27.633883333333333,2555,3,1,283,263,20
BR1_2731670480,2,True,0,0,0,13837,165,60,6.4,False,4,False,1,0,0,15458,240,48,7.2,True,26.843633333333333,-1621,-2,-1,225,288,-63
BR1_2729195386,9,True,0,1,0,17352,236,36,6.8,False,6,False,1,0,0,16081,199,52,6.4,True,26.103083333333334,1271,3,-1,272,251,21
BR1_2725920168,6,True,0,1,0,16274,202,56,7.0,True,3,False,1,0,0,14163,186,44,6.6,False,25.104416666666665,2111,3,-1,258,230,28
BR1_2725895123,11,True,1,0,0,19162,231,64,7.2,True,4,False,0,1,0,16689,205,72,7.4,False,28.631933333333333,2473,7,1,295,277,18
BR1_2729582407,12,True,0,1,0,21075,236,59,7.6,False,6,False,1,0,0,18758,242,68,7.4,True,29.711533333333332,2317,6,-1,295,310,-15
BR1_2716617428,4,False,1,0,0,16561,242,56,7.4,False,6,True,0,1,0,18698,267,58,7.4,True,28.313333333333333,-2137,-2,1,298,325,-27
BR1_2729442287,8,True,1,1,0,17225,202,52,6.8,True,3,False,0,0,0,13934,190,52,7.0,False,26.798516666666668,3291,5,1,254,242,12
BR1_2723596700,6,True,0,0,0,17193,244,44,7.6,False,5,False,1,0,0,16311,183,80,7.2,True,28.914083333333334,882,1,-1,288,263,25
BR1_2713276411,9,True,0,1,0,18155,220,56,7.2,False,6,False,1,0,0,17570,237,73,7.4,True,28.83945,585,3,-1,276,310,-34
BR1_2713267669,15,True,1,1,0,21568,230,64,7.6,True,5,False,0,0,0,16006,192,64,6.8,False,29.699816666666667,5562,10,1,294,256,38
BR1_2713234567,5,True,1,0,0,16727,199,68,7.2,False,8,False,0,1,0,19577,241,58,7.4,True,29.658583333333333,-2850,-3,1,267,299,-32
BR1_2731574772,4,False,0,0,0,15777,221,44,6.8,False,4,True,1,0,0,15742,226,72,7.0,True,26.184283333333333,35,0,-1,265,298,-33
BR1_2731553486,6,True,0,0,0,17471,227,54,7.2,False,7,False,1,0,0,18441,231,49,7.4,True,28.653466666666667,-970,-1,-1,281,280,1
BR1_2730974387,13,False,0,0,0,18888,214,32,6.8,True,8,True,0,0,0,16170,156,43,6.4,False,27.479816666666668,2718,5,0,246,199,47
BR1_2688600024,6,True,0,1,0,17916,260,68,7.6,True,5,False,1,0,0,16556,197,44,7.4,False,27.565266666666666,1360,1,-1,328,241,87
BR1_2731756581,10,True,0,0,1,18534,196,36,6.6,True,7,False,1,0,0,15382,158,56,6.6,False,26.123366666666666,3152,3,-1,232,214,18
BR1_2731180989,11,True,1,1,0,19494,234,59,7.8,True,6,False,0,0,0,16095,206,38,7.0,False,29.403616666666668,3399,5,1,293,244,49
BR1_2729969265,7,True,1,0,0,15760,194,54,6.6,True,5,False,0,1,0,15145,208,40,6.6,False,25.711616666666668,615,2,1,248,248,0
BR1_2729859633,9,False,0,0,0,17688,211,60,7.2,True,6,True,0,0,0,17571,226,44,7.2,False,28.67705,117,3,0,271,270,1
BR1_2729555016,6,False,0,0,0,16474,181,68,6.8,False,8,True,1,0,0,16588,200,44,6.8,True,27.015016666666668,-114,-2,-1,249,244,5
BR1_2726965961,7,True,1,0,0,18887,260,64,7.6,False,2,False,0,1,0,16476,248,64,7.6,True,28.845833333333335,2411,5,1,324,312,12
BR1_2713167908,12,True,0,0,0,20351,219,52,7.0,False,6,False,1,1,0,18219,241,64,7.4,True,29.396433333333334,2132,6,-1,271,305,-34
BR1_2731784479,3,True,0,0,0,12868,131,48,5.8,False,8,False,0,0,1,18164,232,32,6.8,True,27.47235,-5296,-5,0,179,264,-85
BR1_2730737045,11,False,0,1,0,18786,184,52,7.2,True,6,True,0,0,0,16365,167,68,6.8,False,26.078633333333332,2421,5,0,236,235,1
BR1_2730996658,8,True,0,0,0,17277,227,56,6.8,True,2,False,1,0,0,14489,197,52,6.6,False,27.253733333333333,2788,6,-1,283,249,34
BR1_2730974249,12,True,0,0,0,18753,181,64,6.8,False,9,False,0,0,0,16547,184,44,6.6,True,27.345133333333333,2206,3,0,245,228,17
BR1_2731695116,8,True,0,0,0,16381,155,40,6.4,False,9,False,0,0,0,17971,221,48,7.0,True,26.84476666666667,-1590,-1,0,195,269,-74
BR1_2698079054,11,True,1,0,0,18621,234,48,6.8,True,5,False,0,0,0,15083,178,55,6.6,False,26.2002,3538,6,1,282,233,49
BR1_2694037835,5,False,1,1,0,15500,201,64,6.8,True,4,True,0,0,0,15130,192,44,6.6,False,25.253666666666668,370,1,1,265,236,29
BR1_2693553928,10,True,1,0,0,17286,198,45,7.0,True,5,False,0,1,0,15649,174,58,7.0,False,26.51975,1637,5,1,243,232,11
BR1_2693146024,5,False,0,1,0,15575,165,68,6.8,False,5,True,0,0,0,17845,227,60,7.0,True,26.787983333333333,-2270,0,0,233,287,-54
BR1_2728857540,8,False,0,0,0,17413,189,60,7.0,False,7,True,1,0,0,17378,190,52,6.8,True,25.971683333333335,35,1,-1,249,242,7
BR1_2731675693,9,True,0,0,0,16999,203,36,6.6,False,8,False,1,0,0,15858,178,48,6.2,True,26.76856666666667,1141,1,-1,239,226,13
BR1_2730848894,12,False,0,1,0,19217,204,60,6.8,True,9,True,0,0,0,17832,223,44,6.6,False,26.709633333333333,1385,3,0,264,267,-3
BR1_2730547791,1,False,0,0,1,12670,162,42,6.6,False,4,True,0,1,0,17610,223,54,7.0,True,26.96255,-4940,-3,0,204,277,-73
BR1_2717894774,11,True,1,0,0,18674,196,56,7.0,True,4,False,0,1,0,15624,211,60,7.0,False,26.55785,3050,7,1,252,271,-19
BR1_2717859476,5,True,1,1,1,19325,249,64,7.4,False,4,False,0,0,0,16546,232,60,7.4,True,27.7985,2779,1,1,313,292,21
BR1_2731237256,14,True,1,1,0,19026,154,56,6.6,True,7,False,0,0,0,16119,193,44,6.2,False,27.008416666666665,2907,7,1,210,237,-27
BR1_2706458447,6,False,0,0,0,15789,183,48,6.6,True,8,True,1,0,0,16864,216,36,6.8,False,26.2352,-1075,-2,-1,231,252,-21
BR1_2706430889,10,False,1,0,0,18160,211,48,6.8,True,5,True,0,0,0,16206,214,36,6.4,False,26.328883333333334,1954,5,1,259,250,9
BR1_2681026970,10,False,1,0,0,18682,188,64,7.6,False,6,True,0,1,0,17211,199,72,7.2,True,27.539416666666668,1471,4,1,252,271,-19
BR1_2681025151,11,True,1,0,0,17643,196,36,7.0,True,6,False,0,0,0,15932,180,43,7.0,False,25.99973333333333,1711,5,1,232,223,9
BR1_2725818861,6,True,1,0,0,17690,232,40,7.0,False,6,False,0,1,0,17770,203,83,7.4,True,29.752716666666668,-80,0,1,272,286,-14
BR1_2725778984,14,True,1,1,1,21395,185,68,7.6,True,11,False,0,0,1,20986,207,52,7.6,False,28.67555,409,3,1,253,259,-6
BR1_2727447605,6,True,1,0,0,16435,236,54,6.8,True,7,False,0,1,0,16126,189,46,6.6,False,27.007383333333333,309,-1,1,290,235,55
BR1_2724995547,5,False,1,0,0,17139,244,36,7.2,True,3,True,0,0,0,15052,186,44,7.0,False,29.698233333333334,2087,2,1,280,230,50
BR1_2731514586,3,False,0,0,0,16713,256,52,7.4,False,5,True,1,1,0,18029,259,77,7.6,True,29.782783333333334,-1316,-2,-1,308,336,-28
BR1_2731504026,7,True,1,1,0,17220,248,44,6.8,True,5,False,0,0,0,15113,194,32,6.4,False,25.20195,2107,2,1,292,226,66
BR1_2678873978,6,True,0,0,0,15709,200,48,6.6,False,5,False,0,0,0,16316,195,48,6.4,True,27.413283333333332,-607,1,0,248,243,5
BR1_2730884564,8,False,0,0,0,17961,203,40,6.8,True,6,True,0,1,0,16998,192,47,6.8,False,26.918433333333333,963,2,0,243,239,4
BR1_2730868299,7,False,0,1,0,17274,200,54,7.4,False,11,True,1,0,0,20350,266,52,7.6,True,29.178916666666666,-3076,-4,-1,254,318,-64
BR1_2729579824,7,False,0,1,0,16930,234,56,7.4,False,10,True,0,0,0,19402,232,68,7.6,True,28.170366666666666,-2472,-3,0,290,300,-10
BR1_2717588927,7,False,0,1,0,18315,207,48,7.4,False,9,True,1,0,0,17939,203,57,7.0,True,29.408966666666668,376,-2,-1,255,260,-5
BR1_2695747241,10,False,1,0,0,17618,204,48,6.6,True,9,True,0,0,0,17391,214,60,6.8,False,25.504883333333332,227,1,1,252,274,-22
BR1_2695725258,14,True,0,0,0,20688,211,60,7.4,True,6,False,1,0,0,16751,236,60,7.4,False,29.152366666666666,3937,8,-1,271,296,-25
BR1_2729100543,2,False,0,0,0,14162,192,64,7.0,True,5,True,0,0,0,15590,222,46,6.8,False,25.711316666666665,-1428,-3,0,256,268,-12
BR1_2731251261,2,False,1,1,0,15459,215,60,7.0,False,8,True,0,0,0,19047,254,56,7.4,True,29.652583333333332,-3588,-6,1,275,310,-35
BR1_2728566229,6,False,1,0,1,16243,177,60,7.2,False,8,True,0,1,0,21354,274,52,7.8,True,28.676333333333332,-5111,-2,1,237,326,-89
BR1_2728062018,11,True,0,0,0,20511,229,57,7.0,True,4,False,0,0,0,15905,200,62,6.8,False,27.577533333333335,4606,7,0,286,262,24
BR1_2731685688,5,False,0,0,0,15958,204,48,6.6,True,9,True,0,0,0,16641,179,40,6.8,False,26.483016666666668,-683,-4,0,252,219,33
BR1_2706340587,6,True,0,1,0,17451,220,72,7.4,False,5,False,1,0,0,17275,228,52,7.2,True,27.651433333333333,176,1,-1,292,280,12
BR1_2731043142,11,True,1,0,0,19712,189,52,7.0,False,18,False,0,0,0,21623,203,48,7.0,True,28.696983333333332,-1911,-7,1,241,251,-10
BR1_2730255513,13,True,1,0,0,18817,178,56,7.2,True,8,False,0,0,0,17118,132,50,6.8,False,28.41048333333333,1699,5,1,234,182,52
BR1_2730220651,9,False,0,0,0,18332,199,52,7.2,False,8,True,1,0,0,18152,192,60,7.2,True,29.980183333333333,180,1,-1,251,252,-1
BR1_2731771838,14,True,1,1,0,21893,220,63,7.4,True,8,False,0,0,0,18701,231,60,7.4,False,28.451083333333333,3192,6,1,283,291,-8
BR1_2731851641,10,True,0,0,0,18207,205,60,7.2,True,2,False,0,0,0,14389,203,40,6.6,False,25.58503333333333,3818,8,0,265,243,22
BR1_2731043646,7,False,0,0,0,18318,235,68,7.4,False,10,True,1,0,0,19634,221,72,7.4,True,28.119716666666665,-1316,-3,-1,303,293,10
BR1_2730473677,11,False,0,0,0,18388,176,40,7.0,False,8,True,1,0,0,20452,266,56,7.4,True,27.714466666666667,-2064,3,-1,216,322,-106
BR1_2724944307,6,False,0,0,0,17903,230,48,7.0,True,8,True,0,1,0,18361,227,63,7.4,False,27.995366666666666,-458,-2,0,278,290,-12
BR1_2724919843,2,False,0,0,0,14925,207,48,7.0,False,8,True,1,1,0,18842,218,60,7.0,True,27.984716666666667,-3917,-6,-1,255,278,-23
BR1_2724909377,13,True,1,0,0,18954,204,48,7.0,True,3,False,0,1,0,13987,170,60,6.4,False,26.578216666666666,4967,10,1,252,230,22
BR1_2692708635,4,False,0,0,0,14322,164,52,7.0,False,11,True,1,0,0,17532,184,58,7.0,True,26.217033333333333,-3210,-7,-1,216,242,-26
BR1_2692705644,6,False,0,0,0,16159,227,44,6.8,True,4,True,1,0,0,15189,200,52,6.2,False,26.245083333333334,970,2,-1,271,252,19
BR1_2689286051,9,False,0,0,0,16358,172,36,6.6,False,13,True,0,0,0,18598,164,45,6.2,True,25.694133333333333,-2240,-4,0,208,209,-1
BR1_2731777348,9,False,1,0,0,18014,203,52,6.8,True,6,True,0,0,0,14901,155,52,6.4,False,27.334466666666668,3113,3,1,255,207,48
BR1_2731721944,13,True,0,0,0,18823,177,44,6.4,False,10,False,1,0,0,17422,153,32,6.0,True,25.55845,1401,3,-1,221,185,36
BR1_2731663735,9,True,0,0,0,18683,250,43,7.4,False,7,False,1,1,0,17895,220,48,7.2,True,27.8968,788,2,-1,293,268,25
BR1_2700198575,5,True,1,0,0,16020,197,56,7.0,True,6,False,0,0,0,16032,199,58,6.6,False,26.9275,-12,-1,1,253,257,-4
BR1_2697162438,6,True,0,0,0,16925,224,60,7.0,True,7,False,1,0,0,17117,185,55,7.0,False,29.6968,-192,-1,-1,284,240,44
BR1_2697111427,8,True,1,0,0,18646,243,60,7.6,True,3,False,0,0,0,16142,231,76,7.2,False,28.041433333333334,2504,5,1,303,307,-4
BR1_2722672737,2,False,0,0,0,12923,188,39,6.6,False,7,True,1,0,0,16594,207,64,7.0,True,25.64665,-3671,-5,-1,227,271,-44
BR1_2704847102,13,True,1,0,0,20290,243,43,7.4,False,4,False,0,1,0,16940,195,52,7.2,True,29.2517,3350,9,1,286,247,39
BR1_2704837053,14,False,0,0,0,19132,192,48,7.0,True,9,True,0,0,0,15666,172,52,6.6,False,26.08725,3466,5,0,240,224,16
BR1_2704664022,7,True,1,0,0,16278,207,36,6.8,True,5,False,0,0,0,15416,177,52,6.6,False,25.522916666666667,862,2,1,243,229,14
BR1_2726379038,10,True,1,0,0,17652,218,48,6.8,True,3,False,0,0,0,14455,172,58,6.6,False,25.20975,3197,7,1,266,230,36
BR1_2726099166,5,False,0,1,0,17280,194,55,7.0,True,13,True,1,0,0,19103,184,54,7.0,False,29.130383333333334,-1823,-8,-1,249,238,11
BR1_2730156045,13,True,1,0,0,19622,201,52,7.6,True,4,False,0,1,0,15669,186,64,7.0,False,28.252516666666665,3953,9,1,253,250,3
BR1_2667537788,10,True,0,1,0,20104,251,45,7.6,False,7,False,1,0,0,17973,190,70,7.4,True,29.908916666666666,2131,3,-1,296,260,36
BR1_2729388689,7,True,0,0,0,15881,199,48,7.0,False,5,False,0,1,0,16896,219,52,7.0,True,27.485416666666666,-1015,2,0,247,271,-24
BR1_2731852399,7,True,1,0,0,18835,237,64,7.6,True,5,False,0,0,0,16025,191,56,7.4,False,28.26631666666667,2810,2,1,301,247,54
BR1_2731616716,7,False,1,0,0,16644,214,52,7.2,True,5,True,0,0,0,15481,197,48,6.8,False,27.168083333333332,1163,2,1,266,245,21
BR1_2731590061,9,True,0,1,0,19908,252,68,7.2,True,2,False,1,0,0,15117,215,52,7.2,False,28.8598,4791,7,-1,320,267,53
BR1_2729778511,9,False,1,1,0,18613,233,68,7.8,True,5,True,0,0,0,17474,228,48,7.2,False,29.10085,1139,4,1,301,276,25
BR1_2725497302,11,True,1,0,0,19511,221,60,7.0,True,5,False,0,0,0,16874,224,52,6.8,False,29.094033333333332,2637,6,1,281,276,5
BR1_2731868781,5,False,0,0,0,16783,188,56,6.8,False,9,True,0,0,0,18644,249,52,7.6,True,27.821266666666666,-1861,-4,0,244,301,-57
BR1_2722943613,8,True,0,0,0,17034,187,52,6.8,True,2,False,1,0,0,14099,170,72,6.6,False,26.197966666666666,2935,6,-1,239,242,-3
BR1_2708773118,13,True,1,0,0,19683,189,52,7.0,True,6,False,0,1,0,16025,189,52,6.4,False,26.9241,3658,7,1,241,241,0
BR1_2731900870,8,True,0,0,1,19572,247,59,7.4,False,8,False,0,0,0,18694,227,63,7.8,True,29.044766666666668,878,0,0,306,290,16
BR1_2731901441,18,False,0,0,0,20987,186,44,7.2,True,6,True,0,0,0,15261,144,60,6.6,False,26.491066666666665,5726,12,0,230,204,26
BR1_2731877907,5,False,1,0,0,16356,183,68,6.6,False,12,True,0,1,0,21008,268,56,7.8,True,28.97195,-4652,-7,1,251,324,-73
BR1_2731876365,8,True,0,0,0,16761,194,48,6.8,False,9,False,1,1,0,18774,193,64,7.2,True,29.17645,-2013,-1,-1,242,257,-15
BR1_2731864772,8,True,0,0,0,18261,199,60,7.0,True,8,False,0,1,0,17247,175,48,7.2,False,27.711883333333333,1014,0,0,259,223,36
BR1_2731375688,8,False,0,0,0,16714,215,40,6.8,False,10,True,1,0,0,18089,222,52,7.0,True,26.08945,-1375,-2,-1,255,274,-19
BR1_2731364468,5,True,1,1,0,17376,217,62,7.2,False,0,False,0,0,0,15289,234,66,7.2,True,29.06305,2087,5,1,279,300,-21
BR1_2731220688,16,True,0,0,0,21702,199,60,7.4,True,6,False,1,0,0,16959,190,52,7.0,False,29.627316666666665,4743,10,-1,259,242,17
BR1_2730241996,10,True,0,0,1,21113,239,52,7.0,False,11,False,0,0,0,19863,221,52,7.0,True,29.66695,1250,-1,0,291,273,18
BR1_2730216930,15,True,0,0,0,20000,196,56,6.6,True,7,False,0,0,0,16239,157,48,6.4,False,27.101516666666665,3761,8,0,252,205,47
BR1_2730140346,1,False,0,0,0,14510,205,68,6.8,False,9,True,1,0,0,19802,240,76,8.0,True,28.557133333333333,-5292,-8,-1,273,316,-43
BR1_2706743673,8,True,0,1,0,20286,266,68,8.0,True,4,False,0,0,0,17811,249,68,7.6,False,29.777633333333334,2475,4,0,334,317,17
BR1_2706724423,10,True,0,1,0,19995,223,60,7.4,True,4,False,1,0,0,16670,238,52,7.2,False,29.89865,3325,6,-1,283,290,-7
BR1_2731771473,10,True,1,1,0,18912,225,64,7.0,True,3,False,0,0,0,14660,220,55,6.6,False,26.641283333333334,4252,7,1,289,275,14
BR1_2727956076,4,False,0,0,0,16265,225,56,7.2,False,10,True,1,0,0,18736,224,56,7.4,True,28.12425,-2471,-6,-1,281,280,1
BR1_2731856553,12,True,1,0,0,20434,250,60,7.4,True,6,False,0,0,0,17247,206,48,7.2,False,28.242116666666668,3187,6,1,310,254,56
BR1_2731805804,7,False,0,0,0,18132,230,64,7.4,False,7,True,0,0,0,18632,234,53,7.6,True,29.7806,-500,0,0,294,287,7
BR1_2731367963,9,True,0,1,1,21345,250,68,7.6,True,2,False,1,0,0,15538,203,68,7.4,False,29.950316666666666,5807,7,-1,318,271,47
BR1_2729247633,8,True,1,0,0,16749,212,40,7.0,False,9,False,0,0,0,17015,215,44,6.8,True,26.804933333333334,-266,-1,1,252,259,-7
BR1_2729236490,6,True,0,0,0,16405,207,44,7.2,True,3,False,1,0,0,15628,217,72,7.4,False,28.816316666666665,777,3,-1,251,289,-38
BR1_2729088335,7,True,1,0,0,18539,270,52,7.4,True,4,False,0,0,0,16954,243,72,7.4,False,29.50845,1585,3,1,322,315,7
BR1_2728883841,7,True,1,0,0,18006,226,56,7.6,True,7,False,0,0,0,18071,198,72,7.4,False,29.888916666666667,-65,0,1,282,270,12
BR1_2730868312,10,True,0,0,0,18594,200,50,7.0,True,7,False,1,0,0,16953,215,53,7.4,False,27.923083333333334,1641,3,-1,250,268,-18
BR1_2725937645,3,True,0,1,0,16737,223,80,7.6,False,5,False,1,0,0,17663,244,60,7.6,True,28.44943333333333,-926,-2,-1,303,304,-1
BR1_2703860967,10,False,0,0,0,20536,265,56,7.4,True,4,True,1,0,0,18307,268,55,7.6,False,28.646266666666666,2229,6,-1,321,323,-2
BR1_2725140188,6,False,0,0,0,17769,215,56,7.6,False,10,True,1,0,0,19721,241,80,7.6,True,27.730933333333333,-1952,-4,-1,271,321,-50
BR1_2729914271,4,False,0,1,0,14809,172,60,6.4,False,13,True,1,0,0,18301,192,40,7.0,True,26.711283333333334,-3492,-9,-1,232,232,0
BR1_2729887609,9,False,1,1,0,19782,235,64,7.8,True,5,True,0,0,0,16134,221,40,7.0,False,27.64143333333333,3648,4,1,299,261,38
BR1_2731792087,8,True,0,0,0,18786,258,48,7.2,False,8,False,1,0,0,17936,213,56,7.4,True,27.722433333333335,850,0,-1,306,269,37
BR1_2731733835,10,False,0,0,0,18429,218,60,7.2,True,9,True,0,0,0,16406,178,40,6.8,False,26.27316666666667,2023,1,0,278,218,60
BR1_2731306473,9,True,0,0,0,17517,211,56,7.4,True,4,False,1,1,0,15847,187,56,6.8,False,25.996233333333333,1670,5,-1,267,243,24
BR1_2680418802,9,True,0,0,0,18507,237,56,7.4,False,7,False,1,1,1,19769,226,52,7.4,True,29.96555,-1262,2,-1,293,278,15
BR1_2680187007,7,True,0,0,0,18151,232,44,7.4,False,7,False,0,0,0,16798,223,42,7.2,True,29.205433333333332,1353,0,0,276,265,11
BR1_2731312856,3,True,0,0,0,16143,219,64,6.8,True,3,False,0,0,0,14985,222,36,6.8,False,27.1111,1158,0,0,283,258,25
BR1_2731288960,5,False,1,1,0,18881,275,67,7.6,True,4,True,0,0,0,17246,244,56,7.2,False,29.069466666666667,1635,1,1,342,300,42
BR1_2731237672,7,False,0,0,0,16760,183,60,7.0,True,7,True,1,0,0,15773,166,60,6.8,False,27.3892,987,0,-1,243,226,17
BR1_2694817184,1,False,1,0,0,15551,222,56,7.0,True,4,True,0,0,0,16435,208,56,6.6,False,29.911433333333335,-884,-3,1,278,264,14
BR1_2730996609,7,False,0,0,0,16639,189,48,7.0,False,7,True,0,0,0,16857,198,56,6.8,True,26.88365,-218,0,0,237,254,-17
BR1_2731431848,6,False,0,0,0,16168,201,62,6.4,False,10,True,1,0,0,18696,191,52,7.0,True,26.663716666666666,-2528,-4,-1,263,243,20
BR1_2731411313,7,True,0,1,0,18460,203,60,7.6,True,3,False,1,0,0,14638,180,48,7.0,False,29.04265,3822,4,-1,263,228,35
BR1_2731804220,8,True,0,0,0,17492,216,56,7.2,False,5,False,0,0,0,14632,188,40,6.8,True,26.7479,2860,3,0,272,228,44
BR1_2731328736,8,False,0,0,0,17796,207,56,6.8,False,15,True,1,1,0,22306,220,76,7.8,True,29.93615,-4510,-7,-1,263,296,-33
BR1_2731210379,12,True,1,1,0,18466,184,60,6.8,True,5,False,0,0,0,15943,173,72,6.8,False,25.386333333333333,2523,7,1,244,245,-1
BR1_2728418864,10,False,0,0,0,19569,258,60,7.6,True,7,True,1,0,0,17355,211,64,7.2,False,27.882183333333334,2214,3,-1,318,275,43
BR1_2729977136,7,True,0,0,0,18057,227,36,7.0,False,7,False,0,0,0,18859,236,56,7.4,True,29.354916666666668,-802,0,0,263,292,-29
BR1_2712775369,8,True,0,0,0,18781,200,56,7.2,True,5,False,1,1,0,16937,205,76,7.2,False,29.871116666666666,1844,3,-1,256,281,-25
BR1_2721544704,5,False,1,0,0,17790,212,76,7.4,False,6,True,0,1,0,18943,251,60,7.6,True,29.8559,-1153,-1,1,288,311,-23
BR1_2721530569,12,True,1,0,0,20920,229,56,7.0,False,9,False,0,0,0,18821,200,44,6.8,True,29.896833333333333,2099,3,1,285,244,41
BR1_2715225143,3,True,0,1,0,15704,202,48,6.8,False,7,False,1,0,0,18032,236,64,7.4,True,29.15015,-2328,-4,-1,250,300,-50
BR1_2731115561,9,True,0,0,0,16633,208,52,7.0,True,3,False,1,0,0,14706,183,55,6.8,False,25.677,1927,6,-1,260,238,22
BR1_2730214485,9,True,1,1,0,18856,210,72,7.8,True,5,False,0,0,0,16872,210,68,7.4,False,29.030883333333332,1984,4,1,282,278,4
BR1_2729989394,4,False,0,0,0,14218,194,31,6.4,False,11,True,1,0,0,18474,209,68,7.2,True,25.05605,-4256,-7,-1,225,277,-52
BR1_2729965838,9,False,1,1,0,21387,268,79,7.8,True,10,True,0,0,0,19848,242,60,7.6,False,28.486366666666665,1539,-1,1,347,302,45
BR1_2730002425,8,False,1,0,0,17549,174,52,7.4,False,8,True,0,0,0,18263,253,50,7.4,True,29.596416666666666,-714,0,1,226,303,-77
BR1_2729982405,3,False,1,0,0,16593,264,56,7.2,False,4,True,0,1,0,17111,229,72,7.4,True,28.002133333333333,-518,-1,1,320,301,19
BR1_2729515441,5,True,0,0,0,18149,257,60,7.4,True,7,False,0,0,0,17486,218,68,7.6,False,27.68505,663,-2,0,317,286,31
BR1_2726270281,8,False,0,0,0,17266,181,67,7.0,False,5,True,1,0,0,17722,204,84,7.4,True,29.66175,-456,3,-1,248,288,-40
BR1_2729099372,6,False,0,0,0,17720,218,68,7.2,False,12,True,1,1,0,21320,240,64,7.8,True,28.826316666666667,-3600,-6,-1,286,304,-18
BR1_2731598602,6,False,1,1,0,17091,222,52,7.2,True,4,True,0,0,0,15056,197,48,6.6,False,25.07435,2035,2,1,274,245,29
BR1_2730595355,14,True,0,0,0,20547,234,35,7.2,False,12,False,1,1,0,20180,174,64,7.2,True,29.196266666666666,367,2,-1,269,238,31
BR1_2731253483,8,True,0,0,0,17482,201,68,6.8,True,10,False,0,0,0,17643,201,56,6.6,False,26.204416666666667,-161,-2,0,269,257,12
BR1_2728920256,9,True,1,0,0,18990,185,60,7.0,True,6,False,0,0,0,17125,235,72,7.2,False,29.199916666666667,1865,3,1,245,307,-62
BR1_2728895663,2,False,0,0,0,15945,242,52,7.0,False,6,True,1,1,0,17099,230,52,7.0,True,28.469483333333333,-1154,-4,-1,294,282,12
BR1_2725731135,10,True,1,1,0,18089,223,48,7.0,True,2,False,0,0,0,14663,209,64,7.0,False,25.043116666666666,3426,8,1,271,273,-2
BR1_2730789985,14,True,0,1,0,20735,218,52,7.4,False,6,False,0,0,0,16876,195,56,7.4,True,29.16895,3859,8,0,270,251,19
BR1_2731547769,9,True,0,1,0,18849,219,48,7.4,False,4,False,1,0,0,16870,229,68,7.2,True,27.57165,1979,5,-1,267,297,-30
BR1_2731139340,12,True,0,0,0,19604,201,48,7.6,False,9,False,1,0,0,18841,222,56,7.2,True,28.316366666666667,763,3,-1,249,278,-29
BR1_2731845424,10,True,1,0,0,18074,242,44,7.0,True,3,False,0,0,0,13676,146,54,6.6,False,26.344316666666668,4398,7,1,286,200,86
BR1_2731815391,5,False,1,0,0,17115,238,74,7.4,False,8,True,0,1,0,19040,215,46,7.6,True,29.589433333333332,-1925,-3,1,312,261,51
BR1_2729155083,4,False,0,0,0,16868,238,68,7.6,False,5,True,1,1,0,18161,263,68,7.6,True,29.702833333333334,-1293,-1,-1,306,331,-25
BR1_2729136922,6,False,0,0,0,16640,176,52,6.4,True,11,True,1,0,0,17974,193,51,6.8,False,25.446816666666667,-1334,-5,-1,228,244,-16
BR1_2730586209,8,True,1,0,0,19270,274,48,7.4,False,8,False,0,1,0,18364,233,68,7.2,True,29.467266666666667,906,0,1,322,301,21
BR1_2730569591,3,True,0,1,0,15163,203,44,7.0,False,5,False,0,0,0,16742,215,88,7.4,True,26.6071,-1579,-2,0,247,303,-56
BR1_2730550921,8,False,1,0,0,18292,221,51,6.8,False,10,True,0,1,0,19210,221,72,7.0,True,28.5951,-918,-2,1,272,293,-21
BR1_2713078105,12,True,1,1,0,19678,172,70,7.4,False,11,False,0,0,0,19876,239,48,7.6,True,29.3248,-198,1,1,242,287,-45
BR1_2731591518,7,True,0,1,0,17728,221,56,7.0,True,7,False,1,0,0,16357,192,60,7.2,False,27.015366666666665,1371,0,-1,277,252,25
BR1_2730117085,11,False,1,0,0,17106,159,48,6.4,False,10,True,0,0,0,18805,176,56,6.8,True,25.424083333333332,-1699,1,1,207,232,-25
BR1_2681959227,8,False,1,0,0,18126,254,52,7.0,True,10,True,0,0,0,19517,259,51,7.8,False,29.252116666666666,-1391,-2,1,306,310,-4
BR1_2719847796,11,True,1,0,0,19076,237,56,6.8,True,8,False,0,1,0,17463,195,44,6.6,False,25.4586,1613,3,1,293,239,54
BR1_2710715268,5,False,0,0,0,16562,228,48,7.0,False,12,True,1,1,0,20086,228,56,7.4,True,28.084383333333335,-3524,-7,-1,276,284,-8
BR1_2731262354,10,True,0,0,0,19370,249,47,7.2,True,4,False,0,0,0,16016,221,60,7.2,False,27.66036666666667,3354,6,0,296,281,15
BR1_2731232888,8,True,1,0,0,19261,269,66,7.6,True,6,False,0,0,0,17754,252,41,7.6,False,28.541266666666665,1507,2,1,335,293,42
BR1_2731620015,3,True,0,0,0,16547,224,60,7.0,False,11,False,1,0,0,19936,271,56,7.6,True,28.864916666666666,-3389,-8,-1,284,327,-43
BR1_2727378555,8,True,0,0,0,18006,195,60,7.2,True,6,False,0,0,0,17944,249,64,7.6,False,29.9489,62,2,0,255,313,-58
BR1_2730090659,9,True,0,0,0,19365,206,52,7.0,False,13,False,1,0,0,19866,203,48,7.0,True,28.7271,-501,-4,-1,258,251,7
BR1_2729982276,6,False,0,0,0,16359,188,48,7.0,False,15,True,0,1,0,22457,243,68,8.0,True,28.77135,-6098,-9,0,236,311,-75
BR1_2731905684,10,False,1,0,0,18162,217,56,7.2,True,6,True,0,1,0,16788,210,44,6.8,False,26.561966666666667,1374,4,1,273,254,19
BR1_2730272414,4,True,0,0,0,14923,178,48,6.4,False,5,False,1,0,0,16105,204,60,6.8,True,25.040266666666668,-1182,-1,-1,226,264,-38
BR1_2731817110,7,True,1,0,0,17252,214,64,6.8,True,4,False,0,0,0,15167,194,36,6.2,False,26.397933333333334,2085,3,1,278,230,48
BR1_2731831449,12,False,1,0,1,21241,218,68,7.4,True,6,True,0,1,0,17755,220,56,7.2,False,28.71105,3486,6,1,286,276,10
BR1_2726032674,6,True,1,0,0,15392,180,52,6.8,False,9,False,0,0,0,17346,206,60,7.2,True,26.087483333333335,-1954,-3,1,232,266,-34
BR1_2688151305,9,True,1,0,0,17020,216,56,7.0,False,7,False,0,0,0,17047,230,60,7.0,True,27.2864,-27,2,1,272,290,-18
BR1_2731552494,9,False,0,1,0,18983,222,44,7.2,False,7,True,0,0,0,17369,212,36,6.8,True,28.043,1614,2,0,266,248,18
BR1_2731878280,5,False,0,0,0,15307,186,56,6.6,True,4,True,0,0,0,14932,227,32,6.6,False,26.92106666666667,375,1,0,242,259,-17
BR1_2731539876,8,True,1,0,0,18311,255,56,7.4,True,6,False,0,1,0,18064,226,60,7.4,False,28.6942,247,2,1,311,286,25
BR1_2729234678,10,False,1,0,0,18415,219,79,7.6,True,3,True,0,1,0,15665,211,40,7.2,False,28.11018333333333,2750,7,1,298,251,47
BR1_2731009221,7,False,0,1,0,17588,215,52,7.2,True,11,True,1,0,0,20440,270,55,8.0,False,29.91575,-2852,-4,-1,267,325,-58
BR1_2731468812,8,True,0,1,0,17469,193,40,6.8,False,7,False,1,0,0,16469,192,60,6.6,True,26.64885,1000,1,-1,233,252,-19
BR1_2731444191,1,True,0,0,0,12888,158,46,6.2,False,7,False,0,0,0,16929,215,52,7.2,True,27.032716666666666,-4041,-6,0,204,267,-63
BR1_2731359072,8,True,1,1,0,17909,221,60,7.2,False,8,False,0,0,0,19103,222,64,7.0,True,29.460316666666667,-1194,0,1,281,286,-5
BR1_2731212885,15,True,0,0,0,21381,197,56,7.0,False,14,False,1,0,0,19912,175,60,6.8,True,27.8937,1469,1,-1,253,235,18
BR1_2731546661,7,True,1,0,0,18613,215,80,7.4,False,9,False,0,1,0,20367,231,68,7.8,True,27.590233333333334,-1754,-2,1,295,299,-4
BR1_2714701944,4,True,1,0,0,14664,166,56,7.0,False,6,False,0,1,0,16754,224,64,7.2,True,26.015116666666668,-2090,-2,1,222,288,-66
BR1_2731228023,4,True,1,0,0,15196,188,52,6.8,False,9,False,0,0,0,17580,216,48,6.8,True,25.870633333333334,-2384,-5,1,240,264,-24
BR1_2731501729,5,True,1,0,0,15698,193,72,7.2,True,2,False,0,1,0,14600,223,40,7.0,False,25.99416666666667,1098,3,1,265,263,2
BR1_2731068585,3,False,0,0,0,14546,172,64,6.8,False,8,True,1,0,0,16848,211,63,7.2,True,27.098,-2302,-5,-1,236,274,-38
BR1_2731577714,8,False,0,0,0,19000,219,72,7.4,True,5,True,0,0,0,17121,216,60,7.4,False,29.1442,1879,3,0,291,276,15
BR1_2706649715,9,False,1,0,0,19119,235,64,7.6,True,5,True,0,1,0,17912,229,62,7.2,False,29.87985,1207,4,1,299,291,8
BR1_2731576063,12,False,0,1,0,19703,182,51,7.0,True,5,True,1,0,0,15223,202,44,6.4,False,25.234566666666666,4480,7,-1,233,246,-13
BR1_2726173030,10,True,0,0,0,17686,219,65,7.4,True,3,False,0,0,0,14427,202,50,6.8,False,25.138133333333332,3259,7,0,284,252,32
BR1_2725963444,4,False,1,0,0,17014,204,68,7.2,False,6,True,0,1,0,18133,217,72,7.6,True,27.974166666666665,-1119,-2,1,272,289,-17
BR1_2730710594,7,False,0,0,0,16802,225,44,6.8,False,9,True,0,1,0,16833,157,56,6.4,True,26.94483333333333,-31,-2,0,269,213,56
BR1_2715613006,8,False,1,0,0,17017,209,44,7.0,True,4,True,0,0,0,15116,205,61,6.6,False,26.657816666666665,1901,4,1,253,266,-13
BR1_2731683416,5,False,0,0,0,15367,195,60,6.4,False,5,True,1,0,0,16486,250,52,7.2,True,25.257033333333332,-1119,0,-1,255,302,-47
BR1_2731247011,8,False,0,0,0,19579,246,63,7.8,True,7,True,1,1,0,18137,232,72,7.6,False,29.704516666666667,1442,1,-1,309,304,5
BR1_2731715308,9,False,0,0,0,19257,247,56,7.4,True,9,True,1,0,0,19153,242,67,7.4,False,28.435183333333335,104,0,-1,303,309,-6
BR1_2731661605,4,False,0,0,0,14138,170,44,6.4,False,11,True,1,0,0,18425,219,68,6.8,True,27.104883333333333,-4287,-7,-1,214,287,-73
BR1_2731288057,6,False,0,0,0,17065,243,69,7.6,False,8,True,0,0,0,17938,241,44,7.4,True,29.5543,-873,-2,0,312,285,27
BR1_2731727018,4,False,0,0,0,13788,172,41,6.4,False,10,True,0,0,0,17348,185,47,7.0,True,27.122316666666666,-3560,-6,0,213,232,-19
BR1_2728670545,10,True,1,1,0,20004,259,66,7.4,True,2,False,0,0,0,15548,214,56,7.2,False,29.409833333333335,4456,8,1,325,270,55
BR1_2728299763,4,False,0,1,0,16578,206,55,7.2,False,6,True,0,0,0,18873,261,72,7.6,True,29.409,-2295,-2,0,261,333,-72
BR1_2698011489,4,False,0,1,0,17190,236,60,7.6,True,2,True,1,0,0,15872,236,64,7.2,False,27.695333333333334,1318,2,-1,296,300,-4
BR1_2696655388,11,True,0,0,0,20294,247,53,7.6,True,3,False,0,0,0,16264,194,52,6.8,False,29.976866666666666,4030,8,0,300,246,54
BR1_2695141624,14,False,0,0,0,22227,238,52,7.4,True,13,True,0,0,0,19808,190,54,6.8,False,29.902083333333334,2419,1,0,290,244,46
BR1_2717987520,9,False,1,0,0,18555,218,60,7.6,False,7,True,0,0,0,17304,224,52,7.2,True,28.433166666666665,1251,2,1,278,276,2
BR1_2717697336,8,False,0,1,0,19151,182,75,7.4,False,11,True,1,0,0,19642,248,52,7.4,True,27.829116666666668,-491,-3,-1,257,300,-43
BR1_2717550392,5,True,1,0,0,15360,164,52,6.6,True,4,False,0,0,0,14659,181,43,6.4,False,27.410783333333335,701,1,1,216,224,-8
BR1_2685083370,8,False,0,0,1,18873,208,56,6.8,True,12,True,1,0,0,18166,163,56,6.8,False,25.199783333333333,707,-4,-1,264,219,45
BR1_2723787184,5,False,0,0,0,16111,200,68,6.8,True,8,True,1,0,0,17495,202,59,6.8,False,26.800233333333335,-1384,-3,-1,268,261,7
BR1_2727288649,2,True,1,0,0,15432,208,68,7.0,False,8,False,0,1,1,20024,242,52,7.6,True,28.622716666666665,-4592,-6,1,276,294,-18
BR1_2727277294,3,False,0,0,0,15207,209,64,6.8,False,7,True,1,1,0,18117,250,60,7.4,True,27.1827,-2910,-4,-1,273,310,-37
BR1_2727255658,7,True,1,0,0,16510,199,48,7.0,True,2,False,0,0,0,13611,181,36,6.4,False,26.969483333333333,2899,5,1,247,217,30
BR1_2731909488,11,False,1,0,0,19624,237,68,7.6,True,10,True,0,1,0,19648,235,56,7.6,False,29.00198333333333,-24,1,1,305,291,14
BR1_2731895412,9,False,0,0,0,18041,210,40,7.0,True,10,True,0,1,0,18857,219,64,7.0,False,25.13475,-816,-1,0,250,283,-33
BR1_2730538461,9,False,1,0,0,18774,235,59,7.2,True,5,True,0,0,0,16725,176,60,7.0,False,27.608166666666666,2049,4,1,294,236,58
BR1_2730521757,9,True,0,0,0,18463,213,51,7.0,True,4,False,0,0,0,15969,200,52,6.8,False,28.48805,2494,5,0,264,252,12
BR1_2707064915,4,False,0,0,0,16079,221,52,7.2,False,11,True,1,0,0,19315,219,88,7.8,True,29.219116666666668,-3236,-7,-1,273,307,-34
BR1_2731751766,6,False,0,0,0,16944,189,63,6.4,False,7,True,0,0,0,16571,192,44,6.4,True,25.874566666666666,373,-1,0,252,236,16
BR1_2731253324,5,False,0,0,0,15634,195,58,7.0,False,8,True,0,1,0,17144,201,46,6.8,True,26.56655,-1510,-3,0,253,247,6
BR1_2731597616,7,True,1,0,0,16584,180,52,6.6,True,3,False,0,1,0,15784,200,44,6.6,False,25.516966666666665,800,4,1,232,244,-12
BR1_2731580724,8,False,1,1,0,17482,200,56,7.2,True,3,True,0,0,0,14596,185,52,6.6,False,25.546116666666666,2886,5,1,256,237,19
BR1_2680264964,11,True,1,1,0,18113,210,56,7.2,True,6,False,0,0,0,15062,183,39,6.8,False,27.480016666666668,3051,5,1,266,222,44
BR1_2678512900,5,False,0,1,0,17634,247,48,7.0,False,7,True,1,0,0,18707,242,52,7.6,True,28.48731666666667,-1073,-2,-1,295,294,1
BR1_2728420709,9,True,1,1,0,19304,224,80,7.4,False,8,False,0,0,0,18219,212,48,7.4,True,29.872683333333335,1085,1,1,304,260,44
BR1_2728388719,11,False,1,1,0,18618,196,73,7.2,False,5,True,0,0,0,14316,151,66,6.6,True,26.255916666666668,4302,6,1,269,217,52
BR1_2728361993,11,True,0,0,0,21182,275,68,7.8,True,10,False,0,0,0,20236,259,56,7.4,False,28.092266666666667,946,1,0,343,315,28
BR1_2717542555,7,True,1,1,0,19015,216,68,7.6,True,5,False,0,0,0,15743,184,52,6.8,False,29.694883333333333,3272,2,1,284,236,48
BR1_2715960144,12,True,0,0,0,17877,175,47,6.8,True,4,False,0,0,0,14268,193,52,6.6,False,27.2045,3609,8,0,222,245,-23
BR1_2716459165,5,False,0,0,0,14961,175,44,6.2,False,9,True,0,0,0,17677,171,60,6.6,True,26.657183333333332,-2716,-4,0,219,231,-12
BR1_2716429952,7,False,1,0,0,19462,274,72,7.6,True,5,True,0,1,0,16057,160,52,6.8,False,29.817166666666665,3405,2,1,346,212,134
BR1_2674140699,3,False,1,0,0,17559,281,72,7.6,True,7,True,0,1,0,19330,268,59,7.8,False,29.70415,-1771,-4,1,353,327,26
BR1_2730027169,4,True,0,1,0,14727,174,44,6.2,False,10,False,1,0,0,18386,216,52,7.2,True,26.099383333333332,-3659,-6,-1,218,268,-50
BR1_2731514631,8,True,0,1,0,19553,245,60,7.4,True,13,False,1,0,0,20604,218,53,7.4,False,27.926483333333334,-1051,-5,-1,305,271,34
BR1_2731501398,13,True,1,1,0,19770,189,60,7.6,False,5,False,0,0,0,16623,219,63,7.4,True,29.268266666666666,3147,8,1,249,282,-33
BR1_2726537931,11,True,1,0,0,18986,193,64,6.8,True,6,False,0,0,0,17322,205,52,6.4,False,25.9208,1664,5,1,257,257,0
BR1_2730741112,8,False,0,0,0,17922,216,48,7.2,False,8,True,0,1,0,17968,218,60,7.4,True,28.702733333333335,-46,0,0,264,278,-14
BR1_2731288540,12,True,1,0,0,18457,155,56,6.8,False,6,False,0,0,0,15307,191,39,6.6,True,26.7258,3150,6,1,211,230,-19
BR1_2728802672,8,False,0,1,0,16514,220,40,7.0,True,8,True,0,0,0,17824,213,84,7.2,False,27.080933333333334,-1310,0,0,260,297,-37
BR1_2726974258,7,False,0,0,0,18691,222,69,7.6,False,5,True,1,1,0,17077,226,62,7.2,True,27.553433333333334,1614,2,-1,291,288,3
BR1_2726947407,9,True,1,1,0,18617,213,48,7.2,True,8,False,0,0,0,18275,221,75,7.4,False,29.38395,342,1,1,261,296,-35
BR1_2731145254,8,True,0,0,0,15691,160,56,6.8,False,12,False,1,0,0,18548,208,52,7.2,True,26.54995,-2857,-4,-1,216,260,-44
BR1_2731494105,7,True,0,0,0,16342,222,48,7.0,False,10,False,1,0,0,17640,183,72,7.2,True,26.776516666666666,-1298,-3,-1,270,255,15
BR1_2728458604,8,True,0,0,0,17953,229,42,7.0,False,5,False,1,0,0,16269,215,52,7.0,True,28.567866666666667,1684,3,-1,271,267,4
BR1_2728430430,5,False,0,1,0,16908,228,61,7.4,False,6,True,0,0,0,17383,232,48,7.6,True,28.798483333333333,-475,-1,0,289,280,9
BR1_2731767412,14,True,0,0,0,21022,254,52,7.4,True,8,False,0,0,0,17693,206,32,7.2,False,28.7139,3329,6,0,306,238,68
BR1_2729117747,6,False,0,0,0,15204,175,36,6.2,False,9,True,1,0,0,17265,193,48,6.8,True,26.7272,-2061,-3,-1,211,241,-30
BR1_2728542682,14,True,0,1,0,20912,193,76,7.2,False,8,False,0,0,0,18263,212,52,7.2,True,28.470766666666666,2649,6,0,269,264,5
BR1_2714516996,10,True,0,1,0,19506,231,52,7.2,False,8,False,1,0,0,18973,219,64,7.6,True,28.826516666666667,533,2,-1,283,283,0
BR1_2714496700,7,False,1,0,0,16391,197,60,7.2,False,5,True,0,1,0,15930,231,40,6.6,True,26.5435,461,2,1,257,271,-14
BR1_2731752916,9,False,0,0,0,17016,202,48,6.6,False,8,True,0,0,0,17197,203,44,6.6,True,27.240066666666667,-181,1,0,250,247,3
BR1_2685634613,8,False,0,0,0,19270,245,56,7.6,False,8,True,1,1,0,18545,220,64,7.4,True,28.926166666666667,725,0,-1,301,284,17
BR1_2730846579,3,False,0,0,0,16470,249,64,7.6,True,6,True,1,1,0,18771,248,72,7.8,False,28.055433333333333,-2301,-3,-1,313,320,-7
BR1_2722794243,5,True,1,0,0,15908,204,52,6.4,False,9,False,0,1,0,18090,213,48,6.8,True,25.920983333333332,-2182,-4,1,256,261,-5
BR1_2722769954,8,True,1,1,0,18539,214,63,7.6,True,4,False,0,0,0,17024,221,76,7.8,False,29.209666666666667,1515,4,1,277,297,-20
BR1_2731645640,8,True,1,0,0,16443,197,68,6.6,True,7,False,0,0,0,17354,201,47,6.4,False,27.184433333333335,-911,1,1,265,248,17
BR1_2731766675,3,False,0,0,0,14737,188,48,6.6,False,9,True,1,1,0,17841,178,52,6.8,True,26.998716666666667,-3104,-6,-1,236,230,6
BR1_2731731867,10,True,1,0,0,19584,228,46,7.0,False,9,False,0,1,0,19233,184,58,7.2,True,28.717683333333333,351,1,1,274,242,32
BR1_2731678480,9,True,1,0,0,18693,229,48,7.0,True,5,False,0,0,0,17554,224,64,7.2,False,27.65905,1139,4,1,277,288,-11
BR1_2731623136,7,True,0,0,0,15330,177,38,6.8,False,9,False,1,0,0,17943,196,53,6.6,True,25.49595,-2613,-2,-1,215,249,-34
BR1_2731692480,4,False,0,0,0,15547,211,40,7.0,True,5,True,1,0,0,16157,232,58,6.6,False,26.065266666666666,-610,-1,-1,251,290,-39
BR1_2682121057,11,True,0,0,0,18347,194,56,7.4,True,2,False,1,0,0,13357,198,51,7.0,False,25.341816666666666,4990,9,-1,250,249,1
BR1_2681439688,7,False,1,1,0,18093,208,56,7.6,True,6,True,0,0,0,17100,224,60,7.6,False,29.668466666666667,993,1,1,264,284,-20
BR1_2718685629,12,True,1,0,0,20491,234,64,7.6,True,4,False,0,0,0,17536,222,64,7.2,False,27.743383333333334,2955,8,1,298,286,12
BR1_2731089023,9,True,0,0,0,17749,193,48,7.0,False,12,False,0,1,0,20214,227,56,7.6,True,29.5118,-2465,-3,0,241,283,-42
BR1_2730813924,11,True,0,1,1,20502,217,51,7.4,True,6,False,1,0,0,16720,229,52,7.0,False,28.067333333333334,3782,5,-1,268,281,-13
BR1_2730771835,6,False,1,0,1,15177,179,56,6.4,False,11,True,0,0,0,19735,196,52,6.8,True,26.983516666666667,-4558,-5,1,235,248,-13
BR1_2729030178,10,True,0,0,0,18913,231,52,7.0,True,5,False,1,1,0,16370,231,56,7.2,False,26.674616666666665,2543,5,-1,283,287,-4
BR1_2731663381,3,False,1,0,0,15402,216,65,7.0,True,9,True,0,1,0,18966,226,56,7.6,False,27.835283333333333,-3564,-6,1,281,282,-1
BR1_2728833674,3,True,1,0,0,16944,235,58,7.2,False,5,False,0,1,0,17189,213,60,7.6,True,28.972733333333334,-245,-2,1,293,273,20
BR1_2726757725,7,False,0,0,0,17204,258,52,7.6,True,5,True,0,0,0,16496,212,62,7.6,False,27.949916666666667,708,2,0,310,274,36
BR1_2726158727,3,False,1,0,0,16557,240,60,7.4,False,6,True,0,1,0,17696,228,60,7.8,True,29.13308333333333,-1139,-3,1,300,288,12
BR1_2731338980,6,True,1,0,0,16675,200,68,7.0,False,9,False,0,0,0,16735,204,52,6.6,True,25.331966666666666,-60,-3,1,268,256,12
BR1_2729671444,6,False,1,0,0,17298,214,52,7.0,True,5,True,0,0,0,16230,210,52,6.8,False,29.591,1068,1,1,266,262,4
BR1_2730737502,14,True,0,1,0,19286,210,61,7.6,True,2,False,1,0,0,13719,199,47,7.0,False,27.1249,5567,12,-1,271,246,25
BR1_2726160774,7,True,1,0,0,17186,179,60,7.0,True,8,False,0,0,0,19418,254,68,7.6,False,28.47815,-2232,-1,1,239,322,-83
BR1_2726138341,9,False,0,0,0,18909,261,48,7.2,True,7,True,0,0,0,19078,242,60,7.0,False,29.282383333333332,-169,2,0,309,302,7
BR1_2730866993,14,True,0,0,0,19479,166,44,7.0,True,4,False,0,0,0,14087,196,48,6.6,False,27.169433333333334,5392,10,0,210,244,-34
BR1_2731195449,7,False,1,0,0,17656,225,54,7.2,False,6,True,0,0,0,17414,212,62,7.2,True,28.42975,242,1,1,279,274,5
BR1_2726463022,0,False,0,0,0,13473,201,56,6.6,False,5,True,1,0,0,17274,242,64,7.2,True,26.908766666666665,-3801,-5,-1,257,306,-49
BR1_2725877203,8,False,1,0,0,16710,214,56,7.0,True,4,True,0,1,0,15766,221,60,7.0,False,26.00946666666667,944,4,1,270,281,-11
BR1_2712169569,9,False,1,0,0,16132,172,44,6.6,True,7,True,0,0,0,16021,184,34,6.6,False,27.055583333333335,111,2,1,216,218,-2
BR1_2728681705,11,False,0,0,0,19928,215,72,7.2,True,13,True,1,1,0,21544,232,70,7.6,False,29.65635,-1616,-2,-1,287,302,-15
BR1_2726442872,7,False,1,0,0,15775,171,55,6.8,True,6,True,0,0,0,15660,204,42,7.0,False,25.285633333333333,115,1,1,226,246,-20
BR1_2731430415,12,True,1,1,0,20619,229,68,7.2,False,7,False,0,0,0,17391,228,52,7.0,True,28.713733333333334,3228,5,1,297,280,17
BR1_2731832765,15,False,0,1,1,23339,222,58,7.8,True,13,True,0,0,0,20030,198,50,7.0,False,28.6721,3309,2,0,280,248,32
BR1_2731815542,5,False,0,0,0,17037,203,72,7.0,True,6,True,1,0,0,17069,195,40,7.2,False,28.43365,-32,-1,-1,275,235,40
BR1_2727598897,6,True,0,0,0,18052,208,48,7.4,True,10,False,0,1,0,19048,207,48,7.2,False,28.17645,-996,-4,0,256,255,1
BR1_2726718117,11,True,1,0,0,19276,215,52,7.6,True,8,False,0,1,1,19172,215,60,7.2,False,29.289,104,3,1,267,275,-8
BR1_2726193026,8,True,1,0,0,16350,164,52,6.6,False,6,False,0,0,0,15614,163,50,6.8,True,26.37005,736,2,1,216,213,3
BR1_2725472549,3,False,0,0,0,16786,240,64,7.4,False,4,True,1,0,0,16679,236,64,7.4,True,28.398616666666666,107,-1,-1,304,300,4
BR1_2729852932,9,False,0,0,0,18096,216,47,7.2,True,9,True,1,0,0,17209,175,52,6.8,False,27.0238,887,0,-1,263,227,36
BR1_2730950418,6,True,1,0,0,16895,193,68,7.2,True,1,False,0,1,0,13980,191,48,6.8,False,25.124766666666666,2915,5,1,261,239,22
BR1_2730449807,4,False,0,0,0,14968,202,48,6.6,True,7,True,0,0,0,15650,206,44,6.6,False,27.132533333333335,-682,-3,0,250,250,0
BR1_2731323887,14,False,1,0,0,20816,214,59,7.2,False,18,True,0,0,0,23386,224,60,7.4,True,27.723933333333335,-2570,-4,1,273,284,-11
BR1_2731872680,12,False,1,0,0,17774,220,46,7.0,True,15,True,0,0,0,20061,178,56,6.8,False,26.205,-2287,-3,1,266,234,32
BR1_2731714482,7,True,1,1,1,20561,223,64,7.4,False,8,False,0,0,0,17739,234,44,7.2,True,27.79335,2822,-1,1,287,278,9
BR1_2709458792,13,True,1,0,0,20204,173,52,7.0,True,10,False,0,1,1,20950,227,72,7.4,False,28.774283333333333,-746,3,1,225,299,-74
BR1_2730739768,7,True,1,1,0,19203,222,48,7.2,True,4,False,0,0,0,16478,201,68,6.8,False,28.167033333333332,2725,3,1,270,269,1
BR1_2729121882,9,True,1,0,0,18946,272,76,7.4,True,0,False,0,0,0,12568,200,28,6.4,False,26.6573,6378,9,1,348,228,120
BR1_2731828617,13,True,0,1,0,20325,274,68,7.6,True,6,False,1,0,0,16545,149,61,7.0,False,29.387766666666668,3780,7,-1,342,210,132
BR1_2731752328,5,False,0,1,0,15992,213,44,6.8,True,7,True,1,0,0,16795,190,48,6.6,False,25.6318,-803,-2,-1,257,238,19
BR1_2731002308,5,True,1,1,1,18881,263,68,7.2,False,3,False,0,0,0,15655,221,52,7.2,True,27.60285,3226,2,1,331,273,58
BR1_2713740324,2,False,0,0,0,14935,205,60,7.2,False,7,True,0,1,0,19208,214,60,7.2,True,28.954583333333332,-4273,-5,0,265,274,-9
BR1_2726781157,14,True,0,0,0,18099,169,64,6.8,True,9,False,0,1,0,16360,165,48,6.6,False,26.2574,1739,5,0,233,213,20
BR1_2711328598,3,False,0,1,0,15385,212,59,6.8,False,7,True,0,0,0,15542,172,60,6.8,True,26.781466666666667,-157,-4,0,271,232,39
BR1_2729877379,6,True,1,1,0,17530,227,56,7.0,False,8,False,0,0,0,18149,226,52,7.2,True,28.38693333333333,-619,-2,1,283,278,5
BR1_2686986791,12,False,0,1,0,20830,242,32,7.2,False,19,True,1,0,0,24108,253,86,7.8,True,28.629483333333333,-3278,-7,-1,274,339,-65
BR1_2686967220,14,True,0,0,0,21269,213,55,7.2,True,6,False,0,0,0,17220,237,36,7.0,False,29.83145,4049,8,0,268,273,-5
BR1_2720121452,8,False,0,0,0,18077,204,46,7.2,False,8,True,1,1,0,18736,261,69,7.4,True,28.803433333333334,-659,0,-1,250,330,-80
BR1_2719674756,17,True,1,1,0,22302,218,56,7.2,True,12,False,0,0,0,20834,207,48,7.0,False,27.5158,1468,5,1,274,255,19
BR1_2726309705,6,True,0,0,0,15076,189,39,6.8,False,12,False,0,0,0,18595,203,68,7.0,True,27.3529,-3519,-6,0,228,271,-43
BR1_2730977282,3,False,1,0,0,15316,197,44,7.4,False,9,True,0,1,0,19081,236,76,7.8,True,29.028833333333335,-3765,-6,1,241,312,-71
BR1_2730026951,8,False,0,0,0,18733,209,44,7.0,True,18,True,0,0,0,21614,213,60,7.2,False,29.883183333333335,-2881,-10,0,253,273,-20
BR1_2721287614,7,True,1,0,0,17604,248,48,7.2,True,4,False,0,0,0,15752,220,48,6.8,False,25.770783333333334,1852,3,1,296,268,28
BR1_2721258930,6,False,0,0,0,17012,255,64,7.6,False,8,True,0,1,0,18326,212,71,7.4,True,28.0346,-1314,-2,0,319,283,36
BR1_2731828997,10,False,0,0,0,19159,194,48,7.0,False,16,True,1,1,0,20438,179,52,6.6,True,26.663383333333332,-1279,-6,-1,242,231,11
BR1_2731808996,12,False,1,1,0,19616,220,60,7.2,True,9,True,0,0,0,17485,171,40,6.6,False,29.86865,2131,3,1,280,211,69
BR1_2731835947,8,False,0,0,0,17008,183,60,7.4,False,12,True,0,1,0,20420,217,64,7.2,True,29.49898333333333,-3412,-4,0,243,281,-38
BR1_2731263184,12,True,1,0,0,19818,240,44,7.2,True,7,False,0,0,0,17919,200,72,7.0,False,28.455716666666667,1899,5,1,284,272,12
BR1_2731201121,8,True,1,0,0,18718,217,56,7.4,True,6,False,0,0,0,17133,203,68,7.0,False,27.529433333333333,1585,2,1,273,271,2
BR1_2731151724,11,True,0,0,0,19599,176,52,6.8,False,13,False,1,0,0,20632,229,60,7.4,True,27.519233333333332,-1033,-2,-1,228,289,-61
BR1_2722230100,11,True,1,0,0,18695,203,44,7.0,True,6,False,0,0,0,16900,208,44,7.2,False,28.587116666666667,1795,5,1,247,252,-5
BR1_2731079916,7,False,0,0,0,18978,245,48,7.4,True,6,True,1,0,0,18087,240,64,7.2,False,27.949566666666666,891,1,-1,293,304,-11
BR1_2724564263,6,False,0,0,0,15578,200,36,6.4,False,11,True,1,1,0,19047,198,52,6.8,True,26.369433333333333,-3469,-5,-1,236,250,-14
BR1_2724527863,8,False,0,1,0,19524,246,71,7.4,False,9,True,1,0,0,19494,211,60,7.2,True,28.0542,30,-1,-1,317,271,46
BR1_2701492681,6,False,1,0,0,15479,180,68,6.8,True,4,True,0,0,0,14751,187,60,6.8,False,26.549483333333335,728,2,1,248,247,1
BR1_2729356364,9,True,1,0,0,17528,231,68,7.0,True,2,False,0,0,0,14777,195,47,6.6,False,26.585566666666665,2751,7,1,299,242,57
BR1_2714869684,6,True,0,1,0,17302,224,52,7.2,False,12,False,1,0,0,20941,207,64,7.4,True,29.454366666666665,-3639,-6,-1,276,271,5
BR1_2714518318,5,True,0,0,0,16865,214,58,7.2,False,9,False,0,0,0,18252,221,70,7.4,True,29.55135,-1387,-4,0,272,291,-19
BR1_2730777595,7,True,0,0,0,17132,208,51,7.2,False,7,False,0,0,0,16826,211,57,7.0,True,25.596633333333333,306,0,0,259,268,-9
BR1_2715385516,9,True,1,0,0,17396,212,64,6.8,True,5,False,0,0,0,15184,200,56,6.4,False,26.491116666666667,2212,4,1,276,256,20
BR1_2701667734,5,False,0,1,0,15732,200,44,6.6,False,8,True,0,0,0,17661,202,48,6.8,True,26.4827,-1929,-3,0,244,250,-6
BR1_2700385363,8,True,1,0,0,16502,193,60,6.8,False,4,False,0,0,0,15588,211,54,6.6,True,26.2093,914,4,1,253,265,-12
BR1_2700355791,4,True,1,0,0,15358,197,48,6.4,True,7,False,0,0,0,15734,189,35,6.8,False,27.473166666666668,-376,-3,1,245,224,21
BR1_2731758174,9,True,1,0,0,17052,175,57,6.6,False,10,False,0,0,0,17338,184,56,7.0,True,26.404,-286,-1,1,232,240,-8
BR1_2731305591,14,True,1,0,0,19541,187,46,7.4,True,14,False,0,0,0,20266,215,59,7.2,False,27.89365,-725,0,1,233,274,-41
BR1_2699190394,1,False,1,0,0,14444,189,68,6.8,False,10,True,0,1,1,20786,252,60,7.6,True,29.244633333333333,-6342,-9,1,257,312,-55
BR1_2730228246,8,False,0,0,0,16824,192,48,7.2,False,2,True,0,1,0,16099,212,60,7.4,True,28.583333333333332,725,6,0,240,272,-32
BR1_2706175506,10,True,1,0,0,20079,256,48,7.4,False,7,False,0,0,0,17324,207,68,7.2,True,27.98425,2755,3,1,304,275,29
BR1_2706152640,8,False,1,0,0,17244,203,57,7.2,True,11,True,0,0,0,19260,208,50,7.2,False,27.986266666666666,-2016,-3,1,260,258,2
BR1_2702130158,8,True,1,0,0,16964,204,63,7.2,True,6,False,0,1,0,15830,180,52,6.8,False,27.155216666666668,1134,2,1,267,232,35
BR1_2701670407,6,True,0,1,0,18011,223,66,7.2,False,9,False,1,0,0,18716,223,61,7.4,True,27.75075,-705,-3,-1,289,284,5
BR1_2701645090,4,False,0,0,0,16874,198,60,7.2,False,13,True,0,1,1,21620,227,60,7.4,True,28.054916666666667,-4746,-9,0,258,287,-29
BR1_2679304641,7,False,1,0,0,16168,177,52,6.6,True,7,True,0,1,0,17596,238,52,7.2,False,26.661683333333333,-1428,0,1,229,290,-61
BR1_2679287394,6,False,0,0,0,14535,188,48,6.8,False,10,True,1,1,0,17678,214,64,7.4,True,27.48765,-3143,-4,-1,236,278,-42
BR1_2731655131,13,False,1,1,0,20026,205,44,7.0,True,5,True,0,0,0,14770,171,52,6.4,False,27.18035,5256,8,1,249,223,26
BR1_2729626987,6,False,1,1,0,18025,221,75,7.4,True,11,True,0,0,0,19369,225,40,7.6,False,28.107883333333334,-1344,-5,1,296,265,31
BR1_2727361642,7,True,0,1,0,17952,186,69,6.8,True,10,False,0,0,0,20010,242,62,7.4,False,29.699983333333332,-2058,-3,0,255,304,-49
BR1_2727888662,7,False,1,1,0,17556,216,68,7.4,True,2,True,0,0,0,13293,162,52,6.4,False,27.148216666666666,4263,5,1,284,214,70
BR1_2731169250,5,False,0,0,0,15552,200,56,7.0,True,6,True,1,1,0,18489,216,64,7.4,False,29.911233333333332,-2937,-1,-1,256,280,-24
BR1_2730143528,4,False,0,0,0,14766,187,52,6.6,False,9,True,1,1,0,17966,213,52,6.8,True,26.643766666666668,-3200,-5,-1,239,265,-26
BR1_2731164196,6,True,0,0,0,15945,209,44,6.6,True,6,False,1,1,0,16902,211,64,6.6,False,26.31555,-957,0,-1,253,275,-22
BR1_2729375833,9,False,0,0,0,16955,188,52,6.8,False,9,True,0,1,0,17876,223,52,6.8,True,27.3658,-921,0,0,240,275,-35
BR1_2731779643,7,False,0,0,0,15492,141,55,6.0,False,13,True,0,1,1,20616,222,48,7.0,True,26.895416666666666,-5124,-6,0,196,270,-74
BR1_2731753638,9,False,1,0,0,18537,223,76,7.4,False,11,True,0,1,0,20166,252,64,7.2,True,28.952583333333333,-1629,-2,1,299,316,-17
BR1_2729373730,9,True,0,0,0,16990,211,68,7.2,True,5,False,1,0,0,15738,192,40,6.4,False,26.4487,1252,4,-1,279,232,47
BR1_2729091692,11,True,1,0,1,20303,209,58,7.0,True,6,False,0,0,0,17921,202,51,7.0,False,28.733166666666666,2382,5,1,267,253,14
BR1_2729337741,10,False,0,0,0,17177,220,36,6.8,False,11,True,1,0,0,18746,201,64,7.0,True,25.681416666666667,-1569,-1,-1,256,265,-9
BR1_2730325042,5,False,0,0,0,19076,287,60,7.6,False,6,True,1,0,0,17899,226,68,7.4,True,28.278183333333335,1177,-1,-1,347,294,53
BR1_2731707253,11,False,0,0,0,19468,230,48,7.2,True,11,True,1,1,0,19437,185,64,7.2,False,29.121116666666666,31,0,-1,278,249,29
BR1_2731570486,4,True,0,1,0,15408,214,47,6.8,False,7,False,1,0,0,16473,195,72,6.8,True,25.7273,-1065,-3,-1,261,267,-6
BR1_2731548316,9,True,1,1,0,19131,215,60,7.4,True,6,False,0,0,0,17623,228,44,7.2,False,27.587983333333334,1508,3,1,275,272,3
BR1_2728029427,13,False,1,0,0,19826,249,64,7.2,True,7,True,0,0,0,17554,206,64,7.4,False,29.334816666666665,2272,6,1,313,270,43
BR1_2730877540,10,False,1,1,0,17384,162,48,6.6,True,5,True,0,0,0,14860,173,34,6.2,False,27.237683333333333,2524,5,1,210,207,3
BR1_2711803857,6,True,1,1,0,18277,229,76,7.2,False,10,False,0,0,0,19548,227,64,7.4,True,29.688533333333332,-1271,-4,1,305,291,14
BR1_2731485102,14,True,1,0,0,19965,217,48,6.8,True,7,False,0,0,0,16717,178,44,6.8,False,27.080033333333333,3248,7,1,265,222,43
BR1_2731416749,9,True,1,0,0,19283,224,62,7.8,True,4,False,0,0,0,16463,217,40,6.8,False,28.936616666666666,2820,5,1,286,257,29
BR1_2726298333,6,True,1,1,0,17826,203,80,7.4,False,4,False,0,0,0,16472,233,60,7.4,True,28.07725,1354,2,1,283,293,-10
BR1_2728959295,7,True,1,0,0,17222,222,64,7.2,False,5,False,0,0,0,16095,209,68,7.0,True,27.4938,1127,2,1,286,277,9
BR1_2730085395,7,False,0,0,0,17692,221,56,7.6,True,6,True,1,0,0,18643,245,76,7.6,False,27.504166666666666,-951,1,-1,277,321,-44
BR1_2723400547,2,True,0,1,0,14559,215,48,7.0,False,3,False,0,0,0,15357,242,70,7.2,True,25.16925,-798,-1,0,263,312,-49
BR1_2731745377,11,True,0,0,0,17816,198,40,6.8,True,8,False,1,0,0,15880,160,60,6.4,False,26.9134,1936,3,-1,238,220,18
BR1_2731721305,8,False,1,1,0,16628,188,56,6.8,True,4,True,0,0,0,15001,198,38,6.6,False,27.193366666666666,1627,4,1,244,236,8
BR1_2711479573,5,False,0,0,0,17163,225,52,7.4,False,5,True,1,1,0,16509,235,56,7.2,True,29.650133333333333,654,0,-1,277,291,-14
BR1_2711469363,10,True,1,0,0,19163,207,52,7.2,True,8,False,0,0,0,16132,169,56,6.6,False,25.625016666666667,3031,2,1,259,225,34
BR1_2711459290,9,True,0,0,0,17734,211,64,7.0,True,4,False,0,0,0,14739,201,48,6.8,False,26.080866666666665,2995,5,0,275,249,26
BR1_2731769188,6,True,0,0,0,17839,231,48,7.4,False,7,False,1,0,0,18466,222,64,7.4,True,29.415733333333332,-627,-1,-1,279,286,-7
BR1_2731408317,9,True,0,0,0,17582,181,56,7.0,True,5,False,0,0,0,16432,220,60,6.6,False,25.094033333333332,1150,4,0,237,280,-43
BR1_2722014066,10,False,1,0,0,16080,161,52,6.4,True,6,True,0,1,0,15748,157,44,6.4,False,26.758416666666665,332,4,1,213,201,12
BR1_2729664909,7,False,0,0,0,16440,218,40,7.0,True,6,True,0,0,0,16927,236,60,7.0,False,25.52115,-487,1,0,258,296,-38
BR1_2729272940,8,False,0,0,0,17643,229,64,7.4,True,6,True,0,0,0,15146,176,52,6.6,False,25.946566666666666,2497,2,0,293,228,65
BR1_2729262161,12,True,1,0,0,19278,197,52,6.8,True,7,False,0,0,0,16718,181,48,6.4,False,26.821,2560,5,1,249,229,20
BR1_2729234706,7,False,0,0,0,16493,200,64,7.2,False,6,True,0,0,0,17022,245,52,6.8,True,25.437916666666666,-529,1,0,264,297,-33
BR1_2731726162,6,True,0,1,0,17896,213,48,7.4,True,10,False,1,0,0,18743,224,68,7.4,False,27.856183333333334,-847,-4,-1,261,292,-31
BR1_2728985382,5,False,0,1,0,18375,298,56,7.6,True,5,True,1,0,0,17021,218,70,7.2,False,29.587816666666665,1354,0,-1,354,288,66
BR1_2730728799,6,False,0,0,0,17048,214,48,7.0,False,14,True,1,1,0,21534,255,56,7.6,True,28.623816666666666,-4486,-8,-1,262,311,-49
BR1_2730629558,9,False,0,1,0,17861,222,60,7.0,True,7,True,0,0,0,16210,202,47,7.0,False,27.066266666666667,1651,2,0,282,249,33
BR1_2729995081,4,True,0,0,0,17290,231,80,7.2,False,6,False,1,1,0,18008,224,64,7.4,True,27.800966666666667,-718,-2,-1,311,288,23
BR1_2729917296,7,False,1,1,0,18140,239,59,7.4,False,3,True,0,0,0,16948,249,66,7.4,True,28.640016666666668,1192,4,1,298,315,-17
BR1_2731372582,9,False,1,0,1,19555,212,72,7.0,True,9,True,0,1,0,19746,199,60,7.0,False,28.034966666666666,-191,0,1,284,259,25
BR1_2731314686,11,False,0,1,0,18818,239,48,7.4,False,8,True,1,0,0,19537,243,68,7.6,True,29.14725,-719,3,-1,287,311,-24
BR1_2689796481,7,False,0,0,0,17336,189,60,6.8,False,6,True,1,0,0,16850,199,46,6.8,True,27.7489,486,1,-1,249,245,4
BR1_2709853273,8,True,1,0,0,16684,221,52,6.8,False,4,False,0,0,0,15874,213,52,6.8,True,27.03015,810,4,1,273,265,8
BR1_2731248818,5,True,1,0,0,18572,266,72,7.2,True,3,False,0,1,0,16854,240,65,7.4,False,29.318633333333334,1718,2,1,338,305,33
BR1_2730318423,5,False,0,0,0,16830,207,64,6.8,False,6,True,0,0,0,18813,242,68,7.6,True,28.432366666666667,-1983,-1,0,271,310,-39
BR1_2729415985,11,True,1,0,0,18342,191,54,6.8,False,12,False,0,0,0,19090,166,52,6.8,True,27.01045,-748,-1,1,245,218,27
BR1_2729383357,7,False,0,0,0,15444,176,44,6.6,False,4,True,1,1,0,15744,220,56,6.6,True,25.563616666666668,-300,3,-1,220,276,-56
BR1_2719785623,10,True,0,1,0,18486,232,53,6.8,True,3,False,0,0,0,14801,205,40,6.4,False,26.749716666666668,3685,7,0,285,245,40
BR1_2731402547,8,False,1,0,0,17349,207,64,7.2,True,5,True,0,0,0,15874,199,48,6.6,False,26.334116666666667,1475,3,1,271,247,24
BR1_2726206308,4,False,0,0,0,15116,197,56,6.6,False,5,True,0,1,0,15454,173,56,7.0,True,25.69955,-338,-1,0,253,229,24
BR1_2728913969,12,False,0,1,0,21002,207,60,7.4,True,4,True,0,0,0,16575,232,52,6.8,False,29.145566666666667,4427,8,0,267,284,-17
BR1_2731047126,9,True,1,0,0,18633,195,42,7.2,False,9,False,0,0,0,18977,235,58,7.4,True,28.059733333333334,-344,0,1,237,293,-56
BR1_2731867871,6,True,0,1,0,18495,239,64,7.4,False,6,False,1,0,0,17625,237,76,7.2,True,29.58935,870,0,-1,303,313,-10
BR1_2731859849,8,False,0,0,0,19127,231,56,7.4,True,6,True,1,1,0,17775,204,60,7.2,False,29.607416666666666,1352,2,-1,287,264,23
BR1_2722600707,5,False,0,0,0,15744,171,56,6.8,True,7,True,1,0,0,17171,217,52,6.6,False,27.35108333333333,-1427,-2,-1,227,269,-42
BR1_2731134409,5,False,1,1,0,15166,148,48,7.0,False,7,True,0,0,0,17385,205,52,7.2,True,28.15075,-2219,-2,1,196,257,-61
BR1_2727595055,6,False,0,0,0,16752,222,44,7.0,True,4,True,0,0,0,15011,201,44,7.0,False,26.984166666666667,1741,2,0,266,245,21
BR1_2727573727,8,True,1,1,0,17044,185,52,6.8,True,8,False,0,0,0,15989,153,39,6.2,False,27.005466666666667,1055,0,1,237,192,45
BR1_2731765451,7,True,1,1,0,17449,218,65,7.2,True,4,False,0,0,0,15054,217,66,6.8,False,27.2353,2395,3,1,283,283,0
BR1_2725413797,8,False,0,0,0,18251,228,35,7.2,True,7,True,0,1,0,17125,214,40,7.0,False,29.26825,1126,1,0,263,254,9
BR1_2724292539,11,True,1,1,0,19082,178,60,7.0,False,11,False,0,0,0,19360,213,52,7.4,True,29.711083333333335,-278,0,1,238,265,-27
BR1_2725349644,5,False,0,1,0,16824,209,58,7.2,False,8,True,1,0,0,19227,245,82,7.6,True,28.742166666666666,-2403,-3,-1,267,327,-60
BR1_2730213049,9,True,1,1,0,19579,227,63,7.8,True,7,False,0,0,0,18002,214,64,7.4,False,28.032616666666666,1577,2,1,290,278,12
BR1_2709492639,12,True,1,0,0,20163,216,64,7.4,True,6,False,0,1,0,18545,250,55,7.2,False,28.9253,1618,6,1,280,305,-25
BR1_2730978722,8,True,0,0,0,19038,257,44,7.0,True,8,False,1,1,0,19545,221,68,7.2,False,28.60595,-507,0,-1,301,289,12
BR1_2731183493,13,True,0,0,0,17693,128,40,6.4,True,6,False,0,0,0,15678,155,44,6.2,False,26.490983333333332,2015,7,0,168,199,-31
BR1_2729879594,9,True,1,0,0,17325,214,56,7.0,True,2,False,0,0,0,13902,215,54,7.0,False,25.9627,3423,7,1,270,269,1
BR1_2728595851,2,False,1,0,0,13750,179,40,6.8,True,3,True,0,0,0,14325,189,50,6.6,False,27.470033333333333,-575,-1,1,219,239,-20
BR1_2731794576,6,True,1,0,0,17792,218,51,7.4,False,9,False,0,0,0,19251,234,64,7.4,True,29.2666,-1459,-3,1,269,298,-29
BR1_2731742615,7,False,0,0,0,19297,233,60,7.4,False,7,True,1,0,0,18875,264,60,7.6,True,28.734216666666665,422,0,-1,293,324,-31
BR1_2731230466,4,False,1,0,0,15244,187,56,6.8,False,10,True,0,0,0,19005,219,68,7.0,True,25.176233333333332,-3761,-6,1,243,287,-44
BR1_2691765124,2,True,0,1,0,15979,234,64,7.2,False,10,False,1,0,0,18580,227,68,7.2,True,28.5052,-2601,-8,-1,298,295,3
BR1_2691732027,7,True,0,0,0,18618,250,60,7.4,False,5,False,1,0,0,17004,227,64,7.4,True,29.168416666666666,1614,2,-1,310,291,19
BR1_2705836307,0,False,0,1,0,15064,224,64,7.2,True,11,True,1,0,1,20458,242,50,7.4,False,27.593566666666668,-5394,-11,-1,288,292,-4
BR1_2704040969,7,False,0,0,0,15689,186,48,6.8,True,8,True,0,0,0,17212,217,72,7.0,False,26.685283333333334,-1523,-1,0,234,289,-55
BR1_2702876218,7,True,0,1,0,18089,235,31,7.4,True,3,False,1,0,0,14277,180,56,6.8,False,25.648716666666665,3812,4,-1,266,236,30
BR1_2728943465,5,False,0,0,0,15273,197,40,6.6,False,6,True,1,0,0,15828,184,52,6.6,True,26.839266666666667,-555,-1,-1,237,236,1
BR1_2730846892,7,False,1,0,0,17003,194,44,6.8,False,6,True,0,1,0,17254,210,64,6.8,True,27.140433333333334,-251,1,1,238,274,-36
BR1_2729241554,9,True,0,1,0,17178,189,44,6.4,True,6,False,0,0,0,15483,185,52,6.4,False,26.29768333333333,1695,3,0,233,237,-4
BR1_2728703441,4,False,0,1,0,17443,194,72,7.2,False,10,True,1,0,0,18724,217,60,7.2,True,28.14445,-1281,-6,-1,266,277,-11
BR1_2725879479,10,False,0,0,0,17641,183,56,7.2,True,10,True,1,1,0,18523,195,72,6.8,False,27.415983333333333,-882,0,-1,239,267,-28
BR1_2725765880,9,True,0,0,0,19110,234,75,7.2,True,2,False,0,0,0,16202,246,52,7.2,False,28.21525,2908,7,0,309,298,11
BR1_2731620424,8,False,0,0,0,17770,231,48,7.2,False,11,True,1,1,0,19529,221,48,7.4,True,27.840066666666665,-1759,-3,-1,279,269,10
BR1_2731582183,6,True,1,0,0,17022,242,52,7.0,True,9,False,0,0,0,19320,259,68,7.4,False,27.758233333333333,-2298,-3,1,294,327,-33
BR1_2731626828,4,True,0,1,0,16200,232,76,7.2,True,6,False,1,0,0,15931,234,50,6.8,False,26.074716666666667,269,-2,-1,308,284,24
BR1_2731881462,2,True,1,0,0,14793,191,68,7.2,True,2,False,0,1,0,13871,187,56,6.6,False,26.400383333333334,922,0,1,259,243,16
BR1_2731854546,4,False,0,0,0,16110,213,48,7.2,False,6,True,1,1,0,17967,232,72,7.6,True,27.6059,-1857,-2,-1,261,304,-43
BR1_2731844236,8,False,1,0,0,17681,180,71,7.0,False,8,True,0,0,0,18846,233,64,7.2,True,28.913033333333335,-1165,0,1,251,297,-46
BR1_2706753836,9,False,1,1,0,17300,182,64,7.0,True,8,True,0,0,0,16993,205,56,6.6,False,25.235083333333332,307,1,1,246,261,-15
BR1_2687393718,3,True,0,0,0,15849,229,47,7.0,False,11,False,1,1,0,20672,228,64,7.6,True,29.680116666666667,-4823,-8,-1,276,292,-16
BR1_2686799874,12,True,1,0,0,19984,253,64,7.4,True,5,False,0,0,0,16700,181,48,7.0,False,29.240383333333334,3284,7,1,317,229,88
BR1_2731650408,4,False,0,1,0,16251,186,52,7.0,False,13,True,1,0,0,21482,230,75,7.8,True,28.443583333333333,-5231,-9,-1,238,305,-67
BR1_2731579764,9,True,0,0,0,17721,185,40,6.6,True,4,False,0,0,0,14346,176,40,6.4,False,26.162,3375,5,0,225,216,9
BR1_2730294006,10,False,1,0,0,18091,218,52,6.8,True,11,True,0,1,0,19829,202,76,7.2,False,28.2357,-1738,-1,1,270,278,-8
BR1_2729150019,1,False,1,0,0,13743,191,56,6.6,False,8,True,0,0,0,17010,221,52,7.0,True,26.061283333333332,-3267,-7,1,247,273,-26
BR1_2729095127,10,True,0,0,0,20127,249,60,7.4,True,5,False,1,0,0,16857,206,55,7.0,False,29.821733333333334,3270,5,-1,309,261,48
BR1_2728806880,11,True,0,1,0,20212,235,44,7.6,True,5,False,1,0,0,16411,216,56,7.2,False,28.147566666666666,3801,6,-1,279,272,7
BR1_2718302327,10,False,0,0,0,18752,200,56,7.4,False,9,True,1,0,0,18164,187,60,7.0,True,25.159566666666667,588,1,-1,256,247,9
BR1_2718219361,12,True,1,0,0,20284,215,48,7.6,True,5,False,0,1,0,16307,173,68,7.0,False,27.642016666666667,3977,7,1,263,241,22
BR1_2731780599,7,True,0,1,1,19017,234,64,7.6,False,9,False,0,0,0,18307,227,52,7.4,True,29.079833333333333,710,-2,0,298,279,19
BR1_2731730866,4,False,0,1,0,15359,199,55,7.2,False,13,True,1,0,0,19777,204,56,7.4,True,28.029,-4418,-9,-1,254,260,-6
BR1_2688655080,3,True,0,0,0,16496,235,60,7.6,False,7,False,0,1,0,19262,262,64,7.6,True,29.5139,-2766,-4,0,295,326,-31
BR1_2729924808,6,False,0,1,0,17083,229,72,7.2,False,13,True,1,0,0,21531,267,44,7.6,True,28.739066666666666,-4448,-7,-1,301,311,-10
BR1_2730843379,2,False,0,0,0,14474,183,48,6.8,False,8,True,1,1,0,17817,227,60,7.4,True,29.498566666666665,-3343,-6,-1,231,287,-56
BR1_2731470391,5,False,1,1,0,16386,210,71,7.2,True,4,True,0,0,0,15228,194,58,6.8,False,26.0903,1158,1,1,281,252,29
BR1_2700600094,10,True,0,1,0,19239,221,44,7.0,False,14,False,0,0,0,21630,202,60,7.2,True,29.56065,-2391,-4,0,265,262,3
BR1_2731589022,7,True,0,0,0,18257,233,56,7.2,True,5,False,1,1,0,16467,209,64,7.2,False,27.601033333333334,1790,2,-1,289,273,16
BR1_2731153808,7,False,1,0,0,18829,245,53,7.2,False,8,True,0,0,0,17970,199,65,7.4,True,28.846166666666665,859,-1,1,298,264,34
BR1_2730167928,5,False,1,0,0,17032,236,72,7.4,True,5,True,0,0,0,16962,227,52,7.4,False,29.452183333333334,70,0,1,308,279,29
BR1_2730022611,12,True,1,0,0,19385,210,50,7.4,False,5,False,0,1,0,19696,248,74,7.2,True,28.995066666666666,-311,7,1,260,322,-62
BR1_2729869054,6,False,0,0,0,16899,183,64,6.6,False,14,True,1,1,1,23550,268,52,7.4,True,27.5774,-6651,-8,-1,247,320,-73
BR1_2730775059,6,True,1,0,0,17463,237,51,7.4,True,10,False,0,1,0,19840,260,60,7.8,False,28.637933333333333,-2377,-4,1,288,320,-32
BR1_2731696591,3,False,1,0,0,15627,224,59,7.0,True,8,True,0,0,0,19089,252,64,7.4,False,29.618933333333334,-3462,-5,1,283,316,-33
BR1_2731666244,8,True,1,1,0,19128,266,68,7.2,True,4,False,0,0,0,15170,195,48,6.8,False,25.45095,3958,4,1,334,243,91
BR1_2731642247,10,True,1,0,0,19450,240,72,7.2,True,8,False,0,0,0,17672,206,52,7.0,False,29.23745,1778,2,1,312,258,54
BR1_2731657328,9,False,0,0,0,18748,213,64,6.8,False,14,True,1,1,0,22497,215,56,7.4,True,28.459516666666666,-3749,-5,-1,277,271,6
BR1_2730696778,9,True,1,0,0,19408,195,68,7.2,True,9,False,0,0,0,19106,224,40,7.2,False,29.9975,302,0,1,263,264,-1
BR1_2730645157,11,False,0,1,0,18319,158,36,6.8,True,14,True,1,0,0,20699,203,64,6.8,False,25.99675,-2380,-3,-1,194,267,-73
BR1_2723179537,5,True,1,1,0,18326,248,64,7.6,True,4,False,0,0,0,17259,251,56,7.6,False,28.75411666666667,1067,1,1,312,307,5
BR1_2723105666,10,True,1,0,0,18960,232,48,7.4,True,6,False,0,1,0,17949,238,60,7.4,False,27.51785,1011,4,1,280,298,-18
BR1_2731906501,7,True,1,0,0,18427,244,70,7.6,False,8,False,0,0,0,18697,242,52,7.4,True,29.090516666666666,-270,-1,1,314,294,20
BR1_2731787880,5,False,1,0,0,14461,151,52,6.6,False,8,True,0,0,0,17400,218,48,7.0,True,27.480133333333335,-2939,-3,1,203,266,-63
BR1_2731758811,10,True,1,0,0,19016,205,56,7.4,True,8,False,0,0,0,17293,186,48,7.0,False,28.251433333333335,1723,2,1,261,234,27
BR1_2731703121,6,False,0,1,0,14471,133,48,6.2,False,8,True,1,0,0,17104,170,56,6.8,True,25.4643,-2633,-2,-1,181,226,-45
BR1_2725425400,7,True,1,0,0,16355,179,55,6.6,False,4,False,0,0,0,15317,208,52,6.8,True,26.742366666666666,1038,3,1,234,260,-26
BR1_2721684595,7,True,0,0,0,16737,190,56,6.8,True,7,False,1,0,0,15949,194,48,6.8,False,26.55775,788,0,-1,246,242,4
BR1_2731872292,12,True,1,0,0,20716,226,53,7.4,True,9,False,0,0,0,17458,174,52,6.6,False,27.991133333333334,3258,3,1,279,226,53
BR1_2731334006,9,False,0,0,0,17632,188,60,7.0,True,7,True,1,0,0,15396,189,64,6.6,False,26.945316666666667,2236,2,-1,248,253,-5
BR1_2731421897,3,False,0,0,0,14774,218,52,6.6,False,9,True,0,0,0,17847,203,52,7.2,True,27.061966666666667,-3073,-6,0,270,255,15
BR1_2730927270,7,False,0,0,0,16541,169,44,6.4,False,8,True,0,0,0,18252,219,44,7.0,True,28.228,-1711,-1,0,213,263,-50
BR1_2730438106,4,False,0,1,0,18113,245,68,7.6,False,4,True,1,0,0,16353,219,60,7.4,True,28.848533333333332,1760,0,-1,313,279,34
BR1_2722657034,8,True,1,0,0,17556,213,60,7.6,True,7,False,0,0,0,18537,240,64,7.2,False,27.9178,-981,1,1,273,304,-31
BR1_2722458816,3,True,1,0,0,14043,167,40,6.6,False,5,False,0,0,0,15786,211,68,7.0,True,26.398433333333333,-1743,-2,1,207,279,-72
BR1_2731533074,7,False,0,0,0,17351,234,35,7.2,False,5,True,0,1,0,16898,217,60,6.8,True,29.947733333333332,453,2,0,269,277,-8
BR1_2731329846,7,True,1,1,0,18882,235,52,7.6,True,3,False,0,0,0,15204,204,46,7.0,False,29.0472,3678,4,1,287,250,37
BR1_2731319079,3,False,0,0,0,15188,166,68,6.8,False,7,True,1,1,0,17013,221,52,6.8,True,25.621316666666665,-1825,-4,-1,234,273,-39
BR1_2725227280,12,False,1,0,0,16821,160,40,6.4,True,8,True,0,0,0,16642,166,56,6.4,False,25.397283333333334,179,4,1,200,222,-22
BR1_2724629603,3,False,1,0,0,15484,228,56,7.0,False,7,True,0,1,0,18626,273,54,7.6,True,29.931266666666666,-3142,-4,1,284,327,-43
BR1_2724208140,8,False,0,0,0,15957,187,52,6.8,False,11,True,1,0,0,19643,209,52,7.2,True,26.017916666666668,-3686,-3,-1,239,261,-22
BR1_2699945061,14,True,0,0,0,20456,247,52,7.6,True,3,False,0,0,0,16108,214,60,7.2,False,29.867,4348,11,0,299,274,25
BR1_2699866979,5,False,0,0,0,14554,160,48,7.0,False,5,True,1,0,0,16468,202,76,7.0,True,27.41995,-1914,0,-1,208,278,-70
BR1_2704675617,11,True,1,0,0,19659,235,60,7.2,True,7,False,0,0,0,17523,212,46,7.0,False,27.80035,2136,4,1,295,258,37
BR1_2704649407,9,False,0,0,0,18805,211,52,7.0,True,10,True,1,0,0,18554,219,44,7.4,False,28.404033333333334,251,-1,-1,263,263,0
BR1_2731629993,13,True,0,0,0,20361,219,56,7.6,False,12,False,0,0,0,19247,196,40,7.0,True,28.772016666666666,1114,1,0,275,236,39
BR1_2731589656,4,True,1,1,0,15467,201,62,6.8,False,6,False,0,0,0,15314,152,56,6.6,True,25.784416666666665,153,-2,1,263,208,55
BR1_2725360722,6,True,1,0,0,18377,229,60,7.2,True,7,False,0,0,0,19224,252,70,7.4,False,28.059833333333334,-847,-1,1,289,322,-33
BR1_2731309161,5,False,1,0,0,16675,224,61,7.0,True,7,True,0,1,0,18593,212,48,7.0,False,27.70365,-1918,-2,1,285,260,25
BR1_2730521170,14,False,0,1,1,19759,165,39,6.6,True,21,True,1,0,0,23814,218,44,7.2,False,27.534416666666665,-4055,-7,-1,204,262,-58
BR1_2730404992,8,True,1,1,0,16891,221,40,6.8,True,6,False,0,0,0,15887,190,48,6.6,False,27.20175,1004,2,1,261,238,23
BR1_2731868297,9,True,1,0,0,17353,193,50,7.2,True,8,False,0,0,0,16807,171,48,6.6,False,27.108033333333335,546,1,1,243,219,24
BR1_2720424351,14,False,0,1,0,21544,218,64,7.4,False,14,True,1,0,0,21924,231,60,7.4,True,29.908766666666665,-380,0,-1,282,291,-9
BR1_2719525576,7,True,1,0,0,16357,169,48,6.4,True,7,False,0,0,0,17118,196,39,6.8,False,26.20606666666667,-761,0,1,217,235,-18
BR1_2729385081,7,False,1,0,1,17943,210,56,6.6,True,10,True,0,1,1,21236,225,58,7.0,False,28.1556,-3293,-3,1,266,283,-17
BR1_2729228743,12,False,1,0,0,19696,239,60,7.4,True,12,True,0,0,0,20848,216,51,7.2,False,29.837433333333333,-1152,0,1,299,267,32
BR1_2730612245,10,True,1,1,0,19984,236,48,7.4,False,6,False,0,0,0,17623,239,68,7.6,True,28.11863333333333,2361,4,1,284,307,-23
BR1_2728589468,10,True,1,0,0,17677,205,60,6.8,True,7,False,0,0,0,16194,194,40,6.4,False,25.163283333333332,1483,3,1,265,234,31
BR1_2731571330,5,False,0,0,0,16434,209,52,7.0,False,10,True,1,0,0,18467,221,69,7.4,True,29.065316666666668,-2033,-5,-1,261,290,-29
BR1_2731228822,8,True,1,1,0,17462,214,59,7.2,True,2,False,0,0,0,13376,171,52,6.6,False,25.152283333333333,4086,6,1,273,223,50
BR1_2674416293,4,True,0,0,0,15903,196,52,6.8,False,8,False,1,0,0,16593,183,72,7.0,True,27.423333333333332,-690,-4,-1,248,255,-7
BR1_2673160349,8,True,1,0,0,16285,187,48,7.2,True,2,False,0,1,0,15029,220,64,6.8,False,27.000683333333335,1256,6,1,235,284,-49
BR1_2731360517,11,False,1,0,0,20054,229,59,7.8,True,5,True,0,1,0,16182,183,56,6.6,False,28.541066666666666,3872,6,1,288,239,49
BR1_2730129611,1,False,0,0,0,13794,188,60,6.6,False,7,True,1,0,0,17036,215,64,6.8,True,25.42465,-3242,-6,-1,248,279,-31
BR1_2731387438,5,True,0,1,0,16411,213,52,7.0,False,8,False,0,0,0,18579,231,64,7.0,True,28.754183333333334,-2168,-3,0,265,295,-30
BR1_2731801777,4,True,0,1,0,16071,205,60,7.2,True,8,False,1,0,0,17524,193,56,7.0,False,25.179133333333333,-1453,-4,-1,265,249,16
BR1_2731207712,6,False,0,0,0,18148,261,56,7.6,True,8,True,1,0,0,18744,234,76,7.2,False,28.493883333333333,-596,-2,-1,317,310,7
BR1_2730957378,7,False,1,1,0,18797,256,59,7.4,False,9,True,0,0,0,18125,214,44,7.2,True,28.832466666666665,672,-2,1,315,258,57
BR1_2730866675,8,False,1,0,0,16831,217,52,6.6,True,4,True,0,0,0,14788,167,68,6.4,False,25.59305,2043,4,1,269,235,34
BR1_2730845790,9,False,0,0,0,16008,180,56,6.8,False,10,True,0,0,0,17936,210,44,7.2,True,25.884566666666668,-1928,-1,0,236,254,-18
BR1_2730755868,9,True,1,0,0,18155,232,42,6.8,True,5,False,0,1,0,15953,224,46,6.8,False,27.173033333333333,2202,4,1,274,270,4
BR1_2731681722,2,True,0,0,0,15843,229,52,7.0,False,7,False,1,0,0,18462,255,72,7.2,True,28.70505,-2619,-5,-1,281,327,-46
BR1_2731834607,6,True,0,0,0,17548,205,52,6.8,True,9,False,0,0,0,18251,203,52,7.0,False,28.9292,-703,-3,0,257,255,2
BR1_2731086847,4,True,0,1,0,17562,243,75,7.4,False,7,False,1,0,0,18226,213,55,7.0,True,28.515133333333335,-664,-3,-1,318,268,50
BR1_2731073366,8,False,0,1,0,17951,218,48,7.2,False,11,True,1,0,0,18754,235,71,7.4,True,29.153666666666666,-803,-3,-1,266,306,-40
BR1_2731415785,9,False,0,0,0,17507,171,72,7.4,True,11,True,1,0,0,20416,236,62,7.4,False,28.474033333333335,-2909,-2,-1,243,298,-55
BR1_2731414235,8,False,1,1,0,17707,188,62,7.0,True,13,True,0,0,0,20191,215,48,7.2,False,28.176016666666666,-2484,-5,1,250,263,-13
BR1_2730299999,4,True,1,0,0,15415,197,60,6.8,False,3,False,0,0,0,15336,227,52,7.0,True,26.661933333333334,79,1,1,257,279,-22
BR1_2730115707,8,True,1,1,0,18615,215,56,7.0,False,8,False,0,0,0,17165,192,60,7.0,True,25.529133333333334,1450,0,1,271,252,19
BR1_2731225401,2,False,0,0,0,15217,263,56,7.0,True,1,True,1,0,0,14179,209,56,7.2,False,25.505866666666666,1038,1,-1,319,265,54
BR1_2731823007,11,True,1,0,0,17095,194,48,7.0,True,7,False,0,0,0,16205,173,30,6.8,False,26.406433333333332,890,4,1,242,203,39
BR1_2731732398,13,True,1,0,0,20371,201,28,7.2,False,9,False,0,1,0,19206,214,72,7.4,True,28.370016666666668,1165,4,1,229,286,-57
BR1_2729409635,5,False,0,1,0,17041,208,60,7.0,True,2,True,1,0,0,14207,187,52,6.6,False,26.18525,2834,3,-1,268,239,29
BR1_2729390259,10,False,1,0,0,19587,232,64,7.4,False,8,True,0,1,0,20163,272,64,7.6,True,28.6161,-576,2,1,296,336,-40
BR1_2731838294,8,False,1,0,0,17721,206,56,7.4,True,5,True,0,1,0,17826,233,58,7.0,False,28.05225,-105,3,1,262,291,-29
BR1_2727992041,4,False,0,0,0,16393,217,60,7.4,False,7,True,1,1,0,17844,233,56,7.4,True,28.03845,-1451,-3,-1,277,289,-12
BR1_2727961482,10,True,1,0,0,18866,212,44,7.4,True,7,False,0,0,0,17012,199,45,7.0,False,27.56595,1854,3,1,256,244,12
BR1_2726588837,15,False,0,1,0,21056,230,56,7.4,True,5,True,0,0,0,16616,212,60,7.2,False,28.1736,4440,10,0,286,272,14
BR1_2726584145,3,True,1,1,0,15485,220,48,7.4,False,4,False,0,0,0,16921,269,64,7.6,True,28.09038333333333,-1436,-1,1,268,333,-65
BR1_2725905164,9,False,0,0,0,17323,187,47,6.8,False,12,True,0,0,0,21387,257,78,7.4,True,28.970083333333335,-4064,-3,0,234,335,-101
BR1_2730007076,9,False,0,1,0,19294,223,60,7.4,True,7,True,0,0,0,18381,226,55,7.0,False,28.214666666666666,913,2,0,283,281,2
BR1_2730542498,16,True,1,0,0,20226,206,53,7.4,False,10,False,0,0,0,19109,174,47,7.0,True,27.899216666666668,1117,6,1,259,221,38
BR1_2731610039,11,True,1,0,0,18332,207,64,7.0,False,4,False,0,0,0,16751,223,44,6.6,True,27.1257,1581,7,1,271,267,4
BR1_2730934169,15,False,1,0,0,21042,179,56,6.8,True,11,True,0,1,0,17894,149,40,6.0,False,25.311616666666666,3148,4,1,235,189,46
BR1_2731791553,12,True,1,0,0,19701,228,44,7.4,True,5,False,0,0,0,16635,209,56,7.2,False,29.6511,3066,7,1,272,265,7
BR1_2731547929,5,False,0,1,0,17512,224,52,7.2,False,6,True,1,0,0,18055,237,60,7.2,True,28.394133333333333,-543,-1,-1,276,297,-21
BR1_2729574639,5,True,0,0,0,17980,240,60,7.4,True,6,False,1,1,0,17348,213,88,7.4,False,28.584133333333334,632,-1,-1,300,301,-1
BR1_2731712618,10,True,0,0,0,16319,165,48,6.6,False,14,False,0,0,0,20818,218,44,7.2,True,25.515766666666668,-4499,-4,0,213,262,-49
BR1_2731604771,5,True,0,0,0,17098,225,64,7.0,True,7,False,1,0,0,17913,230,72,7.2,False,29.196883333333332,-815,-2,-1,289,302,-13
BR1_2731210477,15,True,1,0,1,22933,222,60,7.4,True,6,False,0,0,0,17317,209,44,6.8,False,28.1833,5616,9,1,282,253,29
BR1_2730274422,5,True,0,0,0,14965,189,62,7.2,False,6,False,1,1,0,17358,201,60,7.0,True,27.200466666666667,-2393,-1,-1,251,261,-10
BR1_2730233240,9,False,1,1,0,19257,241,64,7.2,False,9,True,0,0,0,19689,232,44,7.0,True,27.69395,-432,0,1,305,276,29
BR1_2730200698,7,False,0,0,0,17585,213,52,7.2,False,11,True,1,0,0,19351,220,68,7.4,True,28.829583333333332,-1766,-4,-1,265,288,-23
BR1_2701883907,5,False,0,1,0,16439,207,60,7.2,False,8,True,1,0,0,19285,227,60,7.2,True,28.0308,-2846,-3,-1,267,287,-20
BR1_2695827493,15,False,1,1,0,22510,219,72,7.6,False,11,True,0,0,0,20329,238,60,7.2,True,28.0581,2181,4,1,291,298,-7
BR1_2731333147,8,False,1,0,0,18807,227,68,7.6,False,8,True,0,0,0,18482,230,59,7.4,True,28.56155,325,0,1,295,289,6
BR1_2704752284,7,True,0,0,0,16743,189,54,6.8,False,7,False,1,0,0,15356,180,40,7.0,True,26.239016666666668,1387,0,-1,243,220,23
BR1_2729332961,9,True,0,1,0,19189,213,64,7.4,True,6,False,1,0,0,17837,247,68,7.2,False,29.337316666666666,1352,3,-1,277,315,-38
BR1_2728667561,8,False,0,0,0,17360,190,45,7.0,False,8,True,0,1,0,19043,214,52,7.4,True,28.185716666666668,-1683,0,0,235,266,-31
BR1_2731184619,5,True,0,0,0,16623,187,48,6.8,False,12,False,0,1,0,20289,244,56,7.6,True,29.758183333333335,-3666,-7,0,235,300,-65
BR1_2731161383,7,True,0,0,0,18775,236,52,7.8,False,9,False,1,0,0,18768,203,60,7.4,True,29.93575,7,-2,-1,288,263,25
BR1_2731133461,3,False,0,0,0,16134,234,60,7.4,False,7,True,0,0,0,18820,248,52,7.4,True,29.499633333333332,-2686,-4,0,294,300,-6
BR1_2724453871,8,False,0,1,0,16330,176,64,6.4,False,10,True,1,0,0,17409,199,42,6.4,True,26.62885,-1079,-2,-1,240,241,-1
BR1_2724043604,6,True,0,1,0,16082,211,56,6.6,False,7,False,1,0,0,16461,192,56,6.4,True,27.243983333333333,-379,-1,-1,267,248,19
BR1_2703051835,7,True,1,0,0,18459,232,51,7.2,True,6,False,0,0,0,16839,198,48,7.4,False,28.022733333333335,1620,1,1,283,246,37
BR1_2731849488,8,False,0,0,0,18430,193,64,7.2,False,12,True,1,0,0,20128,228,64,7.4,True,29.89785,-1698,-4,-1,257,292,-35
BR1_2731733830,5,True,0,0,0,15400,188,40,6.4,True,5,False,1,0,0,15611,213,60,6.6,False,25.8522,-211,0,-1,228,273,-45
BR1_2730017998,9,False,0,0,0,17537,218,34,6.8,True,6,True,0,0,0,15414,155,32,6.6,False,26.369,2123,3,0,252,187,65
BR1_2729661214,13,True,1,0,0,20384,225,56,7.0,True,15,False,0,0,0,21057,210,56,7.4,False,28.030566666666665,-673,-2,1,281,266,15
BR1_2719896974,16,False,0,0,0,22374,242,60,7.6,False,10,True,1,0,0,19324,207,64,7.2,True,27.700516666666665,3050,6,-1,302,271,31
BR1_2701619505,5,True,0,0,0,16830,212,40,7.2,False,13,False,0,1,0,20796,233,60,7.4,True,29.137433333333334,-3966,-8,0,252,293,-41
BR1_2726519217,7,False,0,0,0,17765,238,56,7.2,True,4,True,0,0,0,16812,229,60,7.6,False,29.9537,953,3,0,294,289,5
BR1_2731585939,4,True,1,1,0,16347,230,64,7.0,True,1,False,0,0,0,14578,231,56,7.0,False,27.00123333333333,1769,3,1,294,287,7
BR1_2694218054,13,True,0,1,0,19410,162,36,6.6,False,11,False,0,0,0,20043,191,40,7.0,True,28.3867,-633,2,0,198,231,-33
BR1_2694135246,7,True,0,1,0,16274,166,48,6.4,True,5,False,0,0,0,15633,192,48,6.4,False,26.146066666666666,641,2,0,214,240,-26
BR1_2693628769,7,False,0,0,0,17456,219,56,6.8,False,6,True,1,1,0,16228,195,56,6.6,True,26.939666666666668,1228,1,-1,275,251,24
BR1_2731083914,6,False,0,1,0,17798,242,60,7.8,True,3,True,0,0,0,17569,257,56,7.6,False,29.6874,229,3,0,302,313,-11
BR1_2731548330,8,True,1,0,0,18365,210,58,7.4,False,6,False,0,0,0,17527,208,52,7.4,True,28.1984,838,2,1,268,260,8
BR1_2731714071,13,False,1,0,0,20131,226,57,7.4,True,8,True,0,0,0,18680,230,36,6.8,False,29.0342,1451,5,1,283,266,17
BR1_2731603513,3,True,0,0,0,14281,220,44,6.6,False,6,False,1,0,0,16186,199,64,7.0,True,27.123183333333333,-1905,-3,-1,264,263,1
BR1_2709245485,6,False,0,0,0,15722,145,43,6.4,False,5,True,0,0,0,16232,211,48,6.6,True,25.19045,-510,1,0,188,259,-71
BR1_2705572589,7,False,1,0,0,17704,184,48,7.0,False,12,True,0,1,0,20385,214,60,7.0,True,27.563583333333334,-2681,-5,1,232,274,-42
BR1_2720873903,9,False,0,0,0,17913,177,57,6.6,True,11,True,0,0,0,19050,189,46,6.8,False,27.81085,-1137,-2,0,234,235,-1
BR1_2719307663,2,True,1,0,0,15880,245,44,7.4,False,3,False,0,1,0,16050,210,64,7.0,True,27.684566666666665,-170,-1,1,289,274,15
BR1_2731613699,15,True,1,0,0,19604,232,52,7.2,True,3,False,0,0,0,14035,182,52,6.6,False,25.5594,5569,12,1,284,234,50
BR1_2731593389,10,True,0,0,0,17904,187,40,6.6,False,4,False,1,0,0,15145,176,60,6.8,True,26.8672,2759,6,-1,227,236,-9
BR1_2728871125,8,True,0,1,0,18316,236,44,7.2,True,3,False,0,0,0,13021,166,45,6.6,False,25.076183333333333,5295,5,0,280,211,69
BR1_2729413263,5,False,0,1,0,17513,221,72,7.4,True,9,True,1,0,0,19491,222,64,7.2,False,29.36675,-1978,-4,-1,293,286,7
BR1_2729374315,13,False,0,0,0,19487,176,53,7.2,False,14,True,0,0,0,21918,199,63,7.6,True,29.707,-2431,-1,0,229,262,-33
BR1_2729347633,16,True,0,1,0,21076,222,40,7.2,True,4,False,1,0,0,14885,170,48,6.6,False,29.14603333333333,6191,12,-1,262,218,44
BR1_2731633908,16,True,0,0,0,22330,240,40,7.2,False,13,False,1,0,0,21180,194,72,7.2,True,29.6826,1150,3,-1,280,266,14
BR1_2731599529,11,True,0,1,0,20482,247,64,7.6,True,5,False,1,0,0,16131,201,64,7.2,False,29.066383333333334,4351,6,-1,311,265,46
BR1_2731245672,7,False,0,1,0,18124,221,56,7.6,True,4,True,1,0,0,16749,252,56,7.4,False,29.665216666666666,1375,3,-1,277,308,-31
BR1_2680848443,13,True,1,1,0,19832,206,56,7.4,True,5,False,0,0,0,15690,183,44,6.4,False,25.388133333333332,4142,8,1,262,227,35
BR1_2680750994,10,False,1,0,0,19249,208,50,7.6,True,8,True,0,0,0,18797,235,76,7.2,False,29.999866666666666,452,2,1,258,311,-53
BR1_2678489307,7,True,0,0,0,19223,249,48,7.8,True,3,False,1,0,0,16102,236,68,7.4,False,29.9772,3121,4,-1,297,304,-7
BR1_2723189145,4,False,0,1,0,16702,210,60,7.4,False,7,True,1,0,0,18893,223,64,7.2,True,27.642083333333332,-2191,-3,-1,270,287,-17
BR1_2729787351,7,True,0,0,0,16724,212,42,6.8,True,5,False,0,1,0,15310,200,48,6.6,False,26.399416666666667,1414,2,0,254,248,6
BR1_2728258091,5,False,0,1,0,16691,182,68,7.0,False,8,True,0,0,0,18179,220,64,7.4,True,28.34385,-1488,-3,0,250,284,-34
BR1_2729235692,10,False,1,0,1,19211,204,48,6.6,True,7,True,0,1,0,16614,176,48,6.4,False,25.396416666666667,2597,3,1,252,224,28
BR1_2731809836,8,True,0,0,0,16708,167,46,6.4,True,9,False,0,1,0,17590,173,61,6.6,False,25.42465,-882,-1,0,213,234,-21
BR1_2730787645,10,True,0,0,0,17613,159,45,6.6,False,11,False,1,0,0,17553,183,51,7.0,True,27.238416666666666,60,-1,-1,204,234,-30
BR1_2730191856,14,True,0,0,0,20049,179,56,7.0,True,6,False,1,0,0,16533,188,55,6.6,False,27.694583333333334,3516,8,-1,235,243,-8
BR1_2731800302,10,False,0,1,1,21079,202,55,7.4,True,7,True,1,0,0,18981,224,64,7.4,False,29.17031666666667,2098,3,-1,257,288,-31
BR1_2731738212,8,True,0,0,0,16043,191,32,7.0,False,2,False,1,1,0,15488,213,80,6.8,True,25.749183333333335,555,6,-1,223,293,-70
BR1_2725910322,6,False,0,0,0,16446,177,56,6.2,True,10,True,0,1,0,17922,185,48,6.6,False,26.942683333333335,-1476,-4,0,233,233,0
BR1_2724360362,9,False,1,0,0,17981,221,68,6.8,True,4,True,0,0,0,14865,194,40,6.8,False,26.90015,3116,5,1,289,234,55
BR1_2724339517,11,True,1,0,0,19088,198,43,6.6,False,12,False,0,0,0,19827,186,56,7.0,True,28.563116666666666,-739,-1,1,241,242,-1
BR1_2689558026,5,True,0,1,1,18486,248,55,7.4,False,5,False,0,0,0,16393,224,52,7.2,True,28.0345,2093,0,0,303,276,27
BR1_2731044063,6,True,1,0,0,18343,248,71,7.6,True,6,False,0,1,0,18045,235,64,7.8,False,29.6706,298,0,1,319,299,20
BR1_2731761285,8,True,1,0,0,17088,220,64,7.0,True,5,False,0,0,0,15834,213,56,7.0,False,26.86916666666667,1254,3,1,284,269,15
BR1_2719453370,5,True,0,0,0,15505,191,44,6.6,False,12,False,1,0,0,18679,209,40,7.0,True,26.100433333333335,-3174,-7,-1,235,249,-14
BR1_2717945593,10,True,0,0,0,18325,199,40,7.0,False,6,False,1,1,0,16494,187,56,7.0,True,26.5457,1831,4,-1,239,243,-4
BR1_2715084930,6,False,1,0,0,17685,223,67,7.4,True,5,True,0,1,0,18493,267,58,7.2,False,28.506533333333334,-808,1,1,290,325,-35
BR1_2713942628,11,False,1,1,0,19282,237,56,7.4,True,4,True,0,0,0,14777,189,48,6.6,False,26.59026666666667,4505,7,1,293,237,56
BR1_2713917002,6,False,0,0,0,18660,233,57,7.6,True,6,True,0,0,0,16425,197,60,7.2,False,28.344883333333332,2235,0,0,290,257,33
BR1_2725709875,6,True,1,0,0,16002,165,53,6.4,True,8,False,0,0,0,16470,200,50,6.8,False,26.15565,-468,-2,1,218,250,-32
BR1_2710644379,6,False,1,0,0,18409,254,68,7.6,True,3,True,0,0,0,15902,220,52,6.8,False,29.640466666666665,2507,3,1,322,272,50
BR1_2697383888,6,True,0,0,0,14776,173,43,6.2,False,12,False,0,0,0,17571,170,32,6.6,True,25.063533333333332,-2795,-6,0,216,202,14
BR1_2697142004,5,False,1,0,0,16239,213,60,6.8,True,7,True,0,0,0,15983,204,51,6.6,False,27.2343,256,-2,1,273,255,18
BR1_2731703277,3,True,0,1,0,15809,213,68,7.0,False,8,False,0,0,0,20030,239,64,8.0,True,28.077983333333332,-4221,-5,0,281,303,-22
BR1_2669828250,12,True,0,0,0,19308,195,48,7.8,True,4,False,0,0,0,16080,229,54,7.6,False,29.14303333333333,3228,8,0,243,283,-40
BR1_2714935283,12,True,1,0,0,18238,198,60,7.2,True,5,False,0,0,0,15821,174,52,6.8,False,26.8159,2417,7,1,258,226,32
BR1_2712707901,5,False,0,0,0,14410,190,41,6.6,False,9,True,1,0,0,16887,208,58,7.2,True,25.57305,-2477,-4,-1,231,266,-35
BR1_2731712094,11,True,0,0,0,20101,232,55,7.4,False,10,False,0,1,0,20058,219,52,7.2,True,27.8218,43,1,0,287,271,16
BR1_2730600837,8,False,0,0,0,16577,181,44,6.6,False,15,True,1,0,0,20747,188,60,7.0,True,26.112483333333333,-4170,-7,-1,225,248,-23
BR1_2731789878,2,False,1,1,0,13766,184,60,6.4,False,6,True,0,0,0,16310,202,48,6.8,True,25.104033333333334,-2544,-4,1,244,250,-6
BR1_2731771085,8,False,0,0,0,18468,197,48,7.6,False,8,True,1,1,0,19626,241,72,7.8,True,28.14345,-1158,0,-1,245,313,-68
BR1_2731742660,7,False,0,0,0,17321,210,56,7.0,False,9,True,1,0,0,18993,201,68,7.0,True,28.650716666666668,-1672,-2,-1,266,269,-3
BR1_2731621064,9,True,0,0,0,17172,191,52,7.2,True,7,False,1,0,0,17404,226,48,6.8,False,28.652483333333333,-232,2,-1,243,274,-31
BR1_2688190515,5,True,1,0,0,16353,211,51,6.8,True,4,False,0,1,0,14914,190,52,6.6,False,27.2026,1439,1,1,262,242,20
BR1_2688151704,5,False,0,0,0,16636,170,86,7.0,False,6,True,1,1,0,18992,265,52,7.4,True,29.9254,-2356,-1,-1,256,317,-61
BR1_2730841219,13,True,0,0,0,20844,219,55,7.2,True,12,False,1,1,0,21219,240,64,7.6,False,28.29145,-375,1,-1,274,304,-30
BR1_2730638072,5,True,0,0,0,16319,224,50,7.4,False,8,False,1,1,0,18985,260,52,7.8,True,28.235033333333334,-2666,-3,-1,274,312,-38
BR1_2731423977,4,False,0,0,0,14704,182,61,6.6,False,12,True,1,0,0,18574,200,49,7.2,True,26.984766666666665,-3870,-8,-1,243,249,-6
BR1_2730940696,4,True,1,1,0,15723,170,65,7.0,False,4,False,0,0,0,18501,257,80,7.8,True,27.9478,-2778,0,1,235,337,-102
BR1_2712244118,7,True,0,0,0,17486,210,52,6.8,False,9,False,0,1,0,20306,249,76,8.0,True,28.551133333333333,-2820,-2,0,262,325,-63
BR1_2711193950,5,False,0,1,0,17732,220,44,7.0,False,9,True,1,0,0,19465,258,76,7.8,True,27.73265,-1733,-4,-1,264,334,-70
BR1_2728978614,5,False,1,0,0,16408,177,56,7.0,False,11,True,0,0,0,20520,245,28,7.4,True,28.090666666666667,-4112,-6,1,233,273,-40
BR1_2718517213,4,False,0,0,0,17051,211,68,7.4,False,8,True,1,1,0,18574,197,68,7.2,True,29.721066666666665,-1523,-4,-1,279,265,14
BR1_2703175480,11,False,1,0,0,18952,188,76,7.4,False,14,True,0,0,0,22150,250,64,7.6,True,29.4057,-3198,-3,1,264,314,-50
BR1_2702413873,7,True,1,0,0,18445,237,71,7.4,True,6,False,0,1,0,17880,221,60,7.6,False,29.425,565,1,1,308,281,27
BR1_2693696080,3,False,0,0,0,14436,221,44,6.6,False,5,True,0,1,0,15901,196,44,6.6,True,26.665733333333332,-1465,-2,0,265,240,25
BR1_2729399635,6,True,1,0,0,15662,201,52,6.8,True,6,False,0,0,0,15572,172,52,6.4,False,25.005966666666666,90,0,1,253,224,29
BR1_2731197912,3,False,0,1,0,16279,219,63,7.2,False,5,True,1,0,0,17671,247,64,7.6,True,29.852733333333333,-1392,-2,-1,282,311,-29
BR1_2729983279,7,True,1,0,0,16542,205,51,7.4,False,6,False,0,1,0,17469,220,58,7.4,True,28.168833333333332,-927,1,1,256,278,-22
BR1_2731563558,7,False,1,0,0,17176,179,42,6.8,False,13,True,0,0,0,20211,214,62,7.6,True,29.2216,-3035,-6,1,221,276,-55
BR1_2731572571,11,True,0,1,0,19198,176,54,6.6,True,14,False,1,0,0,19580,213,57,7.0,False,26.442216666666667,-382,-3,-1,230,270,-40
BR1_2731375745,7,False,1,0,0,16680,205,68,7.0,False,10,True,0,0,2,21664,209,56,7.4,True,28.089883333333333,-4984,-3,1,273,265,8
BR1_2726269227,10,True,1,0,0,17083,171,60,6.6,False,7,False,0,0,0,16906,197,48,6.6,True,25.510983333333332,177,3,1,231,245,-14
BR1_2723583191,12,False,0,1,0,18574,192,52,7.0,False,14,True,0,0,0,19364,183,53,6.8,True,25.98175,-790,-2,0,244,236,8
BR1_2721274278,7,True,0,0,0,18642,229,74,7.4,False,17,False,1,1,0,22468,208,60,7.4,True,28.936333333333334,-3826,-10,-1,303,268,35
BR1_2719421715,15,False,1,0,0,18747,156,60,6.8,True,6,True,0,1,0,16954,185,52,6.8,False,27.203916666666668,1793,9,1,216,237,-21
BR1_2728556477,10,True,1,1,0,19064,238,56,7.2,False,10,False,0,0,0,17817,177,60,6.8,True,25.617866666666668,1247,0,1,294,237,57
BR1_2731087334,7,False,0,0,0,18454,231,64,7.0,True,12,True,1,1,0,20992,236,40,7.4,False,28.45815,-2538,-5,-1,295,276,19
BR1_2731808552,6,False,0,1,0,18409,242,68,7.4,False,8,True,1,0,0,18504,245,52,7.6,True,28.487866666666665,-95,-2,-1,310,297,13
BR1_2730976954,9,False,1,0,0,18350,231,52,7.2,True,7,True,0,0,0,16850,226,48,7.2,False,29.07665,1500,2,1,283,274,9
BR1_2730967534,10,False,0,0,0,17691,200,60,6.6,False,6,True,1,1,1,19198,215,52,7.4,True,28.128233333333334,-1507,4,-1,260,267,-7
BR1_2698348288,12,False,1,0,0,18717,194,56,7.2,True,5,True,0,0,0,14855,164,60,6.8,False,26.452866666666665,3862,7,1,250,224,26
BR1_2698322165,11,True,1,0,0,19907,221,52,7.2,False,8,False,0,0,0,19510,225,67,7.2,True,28.108533333333334,397,3,1,273,292,-19
BR1_2717402990,7,False,1,0,0,16867,210,52,7.0,True,10,True,0,1,0,17834,225,45,6.8,False,26.199833333333334,-967,-3,1,262,270,-8
BR1_2717063472,10,False,0,0,0,16453,175,52,7.0,True,7,True,0,0,0,16552,214,52,6.8,False,26.725833333333334,-99,3,0,227,266,-39
BR1_2731037943,7,False,0,0,0,17613,198,52,7.4,False,11,True,1,0,0,19313,245,56,7.2,True,29.645783333333334,-1700,-4,-1,250,301,-51
BR1_2681407380,7,False,0,0,0,17341,204,56,7.4,True,11,True,1,1,0,19054,236,52,7.8,False,29.14895,-1713,-4,-1,260,288,-28
BR1_2714410809,7,True,1,0,0,18455,224,51,7.6,True,3,False,0,0,0,15629,199,40,7.2,False,29.02695,2826,4,1,275,239,36
BR1_2716119344,12,True,1,0,0,19972,206,52,7.0,True,8,False,0,0,0,17519,202,51,6.6,False,28.48645,2453,4,1,258,253,5
BR1_2716104792,8,True,1,0,0,16091,157,46,6.4,False,8,False,0,1,1,18862,234,64,7.2,True,25.577116666666665,-2771,0,1,203,298,-95
BR1_2716081259,2,False,0,0,0,16800,222,56,7.4,True,8,True,1,0,0,18723,223,76,7.4,False,28.159316666666665,-1923,-6,-1,278,299,-21
BR1_2731788801,5,True,1,0,0,15105,173,36,6.6,True,10,False,0,0,0,17142,176,76,7.0,False,26.54015,-2037,-5,1,209,252,-43
BR1_2731792683,5,False,0,0,0,16688,197,55,7.4,False,8,True,1,0,0,17081,204,56,7.4,True,29.0407,-393,-3,-1,252,260,-8
BR1_2731548224,5,False,1,0,0,18054,234,68,7.2,False,8,True,0,1,0,18437,218,60,7.0,True,29.783183333333334,-383,-3,1,302,278,24
BR1_2731294139,9,False,0,1,1,20643,230,63,7.4,True,11,True,1,0,0,19191,192,42,7.0,False,27.674166666666668,1452,-2,-1,293,234,59
BR1_2731751885,3,False,1,0,0,16664,227,56,7.2,True,6,True,0,1,0,17606,212,54,7.0,False,29.28325,-942,-3,1,283,266,17
BR1_2731536653,7,True,0,1,0,17453,216,48,6.8,False,12,False,2,0,0,18399,173,64,7.0,True,27.6613,-946,-5,-2,264,237,27
BR1_2731524635,5,True,1,1,0,15575,165,60,6.4,False,11,False,0,0,0,17827,212,40,7.0,True,25.613366666666668,-2252,-6,1,225,252,-27
BR1_2722933887,5,False,0,0,0,16474,203,50,7.2,False,6,True,1,1,0,18648,231,59,7.4,True,29.612116666666665,-2174,-1,-1,253,290,-37
BR1_2728357924,6,True,0,0,0,15763,168,56,6.4,False,11,False,0,1,0,18176,200,52,6.8,True,25.922433333333334,-2413,-5,0,224,252,-28
BR1_2728343253,8,True,0,0,0,18783,248,72,7.4,False,8,False,1,0,0,17879,200,44,7.4,True,28.938066666666668,904,0,-1,320,244,76
BR1_2730852237,9,True,0,1,0,17732,196,60,7.2,True,5,False,0,0,0,16501,202,60,7.0,False,27.2444,1231,4,0,256,262,-6
BR1_2731865266,10,True,1,1,1,20139,208,56,7.2,True,7,False,0,0,0,16702,193,52,6.6,False,25.127166666666668,3437,3,1,264,245,19
BR1_2731666306,3,False,1,1,0,14906,196,56,6.8,False,8,True,0,0,0,17874,221,48,7.0,True,25.451766666666668,-2968,-5,1,252,269,-17
BR1_2670146625,8,True,0,1,0,16352,199,52,6.8,True,7,False,1,0,0,16421,161,59,7.0,False,25.09515,-69,1,-1,251,220,31
BR1_2731631745,11,True,1,1,0,19504,218,46,7.2,True,5,False,0,0,0,17414,223,68,7.2,False,29.08915,2090,6,1,264,291,-27
BR1_2728021049,7,True,1,1,0,19384,224,54,7.4,True,8,False,0,0,0,18058,212,60,7.6,False,27.690683333333332,1326,-1,1,278,272,6
BR1_2727993539,10,False,0,0,0,19703,225,54,7.0,False,14,True,1,0,0,20722,205,49,7.0,True,28.52488333333333,-1019,-4,-1,279,254,25
BR1_2721558946,7,True,0,0,0,17030,212,56,6.8,True,6,False,0,0,0,16413,218,64,7.0,False,25.969633333333334,617,1,0,268,282,-14
BR1_2729331118,8,True,0,1,0,17823,210,64,7.2,False,6,False,1,0,0,18271,270,64,7.4,True,27.8517,-448,2,-1,274,334,-60
BR1_2711053418,8,False,0,1,0,18602,198,65,7.2,True,8,True,1,0,0,17341,197,58,7.4,False,29.809,1261,0,-1,263,255,8
BR1_2731834696,16,False,0,1,0,22048,259,64,7.6,True,7,True,1,0,0,19326,262,72,7.6,False,28.3378,2722,9,-1,323,334,-11
BR1_2731818512,10,True,0,0,0,18066,209,59,7.0,False,5,False,0,1,0,16092,183,57,6.8,True,26.058766666666667,1974,5,0,268,240,28
BR1_2731470671,7,True,0,1,0,17175,201,76,7.2,True,2,False,1,0,0,14638,192,60,7.0,False,26.293666666666667,2537,5,-1,277,252,25
BR1_2731449960,8,False,1,0,0,17579,187,60,7.2,False,13,True,0,1,2,22904,257,64,7.6,True,29.118916666666667,-5325,-5,1,247,321,-74
BR1_2731336276,9,True,1,1,0,19771,246,84,7.6,True,5,False,0,0,0,17455,239,48,7.4,False,28.453416666666666,2316,4,1,330,287,43
BR1_2726351885,16,True,0,1,0,18636,167,56,6.8,True,5,False,0,0,0,14772,183,44,6.4,False,25.248333333333335,3864,11,0,223,227,-4
BR1_2711621617,9,True,1,0,0,16233,146,48,6.8,True,4,False,0,0,0,14737,184,48,6.6,False,25.988933333333332,1496,5,1,194,232,-38
BR1_2722444758,4,False,0,0,0,15766,224,52,6.8,False,4,True,0,1,0,16141,202,72,7.2,True,25.14545,-375,0,0,276,274,2
BR1_2730797546,12,False,0,0,0,18033,199,48,7.0,False,12,True,1,1,0,19431,190,48,6.4,True,26.3766,-1398,0,-1,247,238,9
BR1_2731743531,4,True,0,0,0,16492,229,56,7.4,False,8,False,1,0,0,18246,202,72,7.4,True,28.3218,-1754,-4,-1,285,274,11
BR1_2729053207,10,False,0,0,0,19459,204,60,7.2,True,5,True,0,0,0,16911,243,32,7.0,False,27.817733333333333,2548,5,0,264,275,-11
BR1_2726375268,11,True,1,0,0,20043,265,68,7.4,True,5,False,0,1,0,16725,234,48,7.2,False,28.629883333333332,3318,6,1,333,282,51
BR1_2730167961,12,False,0,1,0,18235,200,44,7.2,True,6,True,1,0,0,15735,201,48,6.6,False,25.56855,2500,6,-1,244,249,-5
BR1_2702373811,10,True,1,0,0,19449,221,64,7.8,True,1,False,0,0,0,15036,203,68,7.2,False,29.0074,4413,9,1,285,271,14
BR1_2701845664,2,False,0,0,0,15634,194,60,7.0,False,7,True,1,1,0,19379,258,72,7.8,True,28.487566666666666,-3745,-5,-1,254,330,-76
BR1_2728631768,10,True,1,0,0,19020,210,68,7.4,True,6,False,0,0,0,16230,176,48,7.2,False,29.9241,2790,4,1,278,224,54
BR1_2730362714,9,False,0,0,0,18324,209,64,7.4,False,6,True,1,1,0,17727,226,64,7.2,True,28.858316666666667,597,3,-1,273,290,-17
BR1_2731699432,5,True,1,0,0,16796,198,56,7.2,True,6,False,0,0,0,16909,226,52,7.4,False,29.601183333333335,-113,-1,1,254,278,-24
BR1_2731624578,8,False,0,0,0,18947,242,76,7.8,True,6,True,1,0,0,17458,232,52,7.6,False,28.456966666666666,1489,2,-1,318,284,34
BR1_2731703196,10,True,1,0,0,19648,232,72,7.2,True,5,False,0,0,0,17504,252,56,7.2,False,29.596383333333332,2144,5,1,304,308,-4
BR1_2731540361,4,True,0,0,0,15247,198,60,6.8,False,7,False,1,0,0,16223,206,48,6.8,True,27.159783333333333,-976,-3,-1,258,254,4
BR1_2731821966,12,True,0,0,0,19677,214,52,7.2,True,3,False,0,0,0,15121,203,46,6.8,False,27.470466666666667,4556,9,0,266,249,17
BR1_2731701933,5,False,1,0,0,17346,209,64,7.2,True,8,True,0,0,0,18579,216,60,7.6,False,29.592083333333335,-1233,-3,1,273,276,-3
BR1_2703657107,7,True,0,1,0,16305,171,56,7.0,False,7,False,1,0,0,16761,224,60,7.2,True,27.251783333333332,-456,0,-1,227,284,-57
BR1_2731121375,5,True,1,0,0,15680,211,46,6.6,False,7,False,0,0,0,17189,221,56,7.2,True,25.207083333333333,-1509,-2,1,257,277,-20
BR1_2731666414,11,True,1,0,0,19239,202,59,7.6,True,5,False,0,0,0,16948,220,52,7.2,False,29.601383333333334,2291,6,1,261,272,-11
BR1_2712480850,3,False,0,0,0,15063,185,50,7.0,False,6,True,0,0,0,17270,239,52,7.2,True,28.922983333333335,-2207,-3,0,235,291,-56
BR1_2731608831,6,False,0,1,0,16979,213,54,7.0,False,9,True,1,0,1,20399,255,73,7.4,True,27.516666666666666,-3420,-3,-1,267,328,-61
BR1_2731590985,3,False,0,0,0,15452,240,52,7.2,False,6,True,0,1,0,19037,266,60,7.4,True,29.758816666666668,-3585,-3,0,292,326,-34
BR1_2731578220,8,False,1,1,0,18054,223,63,7.4,False,7,True,0,0,0,17985,249,59,7.6,True,29.89891666666667,69,1,1,286,308,-22
BR1_2731249834,6,True,1,0,0,16357,205,64,6.8,True,7,False,0,0,0,16869,212,56,7.0,False,25.3448,-512,-1,1,269,268,1
BR1_2731256838,5,False,1,0,0,15424,192,48,6.4,False,9,True,0,0,0,16879,174,58,6.6,True,27.14741666666667,-1455,-4,1,240,232,8
BR1_2730514719,4,False,0,0,0,14913,186,60,6.6,False,10,True,0,0,0,19185,236,64,7.2,True,26.77045,-4272,-6,0,246,300,-54
BR1_2721553344,6,True,0,1,0,17523,237,52,6.8,True,1,False,1,0,0,13587,201,60,6.8,False,27.15165,3936,5,-1,289,261,28
BR1_2723606215,9,True,1,0,0,16019,172,48,6.6,True,11,False,0,1,0,18719,184,60,6.4,False,26.59295,-2700,-2,1,220,244,-24
BR1_2723575014,9,False,0,0,0,18351,217,60,7.4,False,9,True,1,0,0,18699,226,56,7.4,True,29.5917,-348,0,-1,277,282,-5
BR1_2723474777,6,False,0,0,0,15846,201,40,6.4,False,4,True,1,0,0,15569,195,64,6.8,True,25.415033333333334,277,2,-1,241,259,-18
BR1_2731869716,6,True,0,0,0,16583,209,48,6.8,False,10,False,1,1,1,19574,225,60,7.0,True,26.6316,-2991,-4,-1,257,285,-28
BR1_2731841366,10,False,0,0,0,19961,240,56,7.4,True,9,True,0,0,0,19258,203,44,7.2,False,27.6698,703,1,0,296,247,49
BR1_2731669413,8,False,0,0,0,16982,209,50,6.6,True,10,True,1,0,0,17806,209,56,6.8,False,25.364333333333335,-824,-2,-1,259,265,-6
BR1_2708537458,5,False,1,0,0,18069,251,78,7.4,True,5,True,0,0,0,16590,262,59,7.4,False,28.458983333333332,1479,0,1,329,321,8
BR1_2731593422,8,False,0,0,0,17459,181,56,7.0,False,15,True,0,1,0,22083,207,76,7.4,True,29.03805,-4624,-7,0,237,283,-46
BR1_2731547719,9,False,1,0,0,19187,227,60,7.2,False,7,True,0,1,0,17961,221,44,7.0,True,28.130316666666666,1226,2,1,287,265,22
BR1_2721246236,5,True,0,0,0,17364,254,62,7.4,True,2,False,1,0,0,15358,224,62,7.4,False,28.790283333333335,2006,3,-1,316,286,30
BR1_2730312465,7,True,1,0,0,16195,184,52,6.6,False,3,False,0,0,0,14676,194,52,6.6,True,27.132166666666667,1519,4,1,236,246,-10
BR1_2730288494,7,False,0,0,0,16979,195,48,6.6,True,10,True,1,0,0,18632,208,52,6.8,False,27.566216666666666,-1653,-3,-1,243,260,-17
BR1_2729628070,13,True,1,0,0,20927,242,46,7.6,True,3,False,0,1,0,16350,216,69,7.4,False,27.913933333333333,4577,10,1,288,285,3
BR1_2729598604,7,True,0,0,0,17371,216,36,7.2,True,5,False,1,1,0,17089,204,68,7.4,False,29.9923,282,2,-1,252,272,-20
BR1_2730814579,6,True,0,0,0,16915,205,52,6.8,True,8,False,1,0,0,18513,249,48,7.0,False,29.977033333333335,-1598,-2,-1,257,297,-40
BR1_2731538840,8,False,0,0,0,19406,228,60,7.2,True,8,True,0,1,0,17912,200,48,7.4,False,28.9178,1494,0,0,288,248,40
BR1_2731732722,3,False,0,0,0,13809,195,48,6.8,False,2,True,0,0,0,14358,208,52,7.0,True,26.811033333333334,-549,1,0,243,260,-17
BR1_2731708223,9,True,0,1,0,19061,256,55,7.4,True,5,False,0,0,0,16110,184,48,7.0,False,28.95435,2951,4,0,311,232,79
BR1_2729269132,7,True,0,1,0,17588,222,52,7.2,False,10,False,1,0,0,19415,220,68,7.6,True,28.685266666666667,-1827,-3,-1,274,288,-14
BR1_2728897973,18,False,0,0,0,22763,188,56,7.2,True,11,True,0,0,0,18816,208,56,6.8,False,29.9401,3947,7,0,244,264,-20
BR1_2726054550,7,False,1,0,0,15873,175,40,6.6,True,4,True,0,1,0,15334,185,52,6.4,False,26.614466666666665,539,3,1,215,237,-22
BR1_2731154669,8,True,1,1,0,17492,195,67,7.0,True,7,False,0,0,0,15293,157,44,6.4,False,25.689283333333332,2199,1,1,262,201,61
BR1_2731846751,8,False,0,0,0,17789,183,68,7.2,False,10,True,1,1,2,22081,227,48,7.2,True,29.493333333333332,-4292,-2,-1,251,275,-24
BR1_2731832345,11,False,1,0,0,18992,185,56,6.8,True,6,True,0,1,0,17876,199,59,6.8,False,29.874183333333335,1116,5,1,241,258,-17
BR1_2730385575,10,True,1,0,0,17383,176,26,6.6,False,13,False,0,1,1,20504,195,55,7.2,True,28.181983333333335,-3121,-3,1,202,250,-48
BR1_2730232870,6,True,0,1,0,17707,201,56,7.4,False,10,False,1,0,0,19026,200,60,7.4,True,29.1764,-1319,-4,-1,257,260,-3
BR1_2726539984,8,True,0,0,0,16739,187,44,7.0,False,6,False,1,0,0,16318,194,43,6.4,True,25.85485,421,2,-1,231,237,-6
BR1_2726519687,11,False,1,0,0,19632,229,48,6.8,True,11,True,0,0,0,20747,267,59,7.6,False,28.27615,-1115,0,1,277,326,-49
BR1_2730020822,7,False,0,1,0,18055,216,60,7.2,False,9,True,1,0,0,18301,205,40,7.0,True,27.60415,-246,-2,-1,276,245,31
BR1_2690598981,6,True,0,0,0,17034,180,55,7.0,True,7,False,1,0,0,17600,216,75,7.4,False,29.315933333333334,-566,-1,-1,235,291,-56
BR1_2730686631,5,False,0,0,0,17635,240,48,7.2,True,6,True,0,0,0,18398,246,84,7.6,False,29.96826666666667,-763,-1,0,288,330,-42
BR1_2731164712,5,False,1,0,0,16511,229,44,7.2,False,7,True,0,0,0,18922,259,72,7.6,True,29.75395,-2411,-2,1,273,331,-58
BR1_2711751916,10,True,1,0,0,19419,217,52,7.2,True,5,False,0,0,0,16959,193,60,7.2,False,27.770466666666668,2460,5,1,269,253,16
BR1_2710733489,6,True,0,1,0,16459,209,58,7.0,False,6,False,1,0,0,16949,198,53,7.2,True,29.298466666666666,-490,0,-1,267,251,16
BR1_2710712113,8,True,0,0,0,17142,190,68,7.2,False,10,False,1,1,0,18700,211,52,7.4,True,29.052066666666665,-1558,-2,-1,258,263,-5
BR1_2731315368,4,False,1,0,0,15051,218,47,6.8,True,3,True,0,0,0,15215,217,48,7.0,False,27.05075,-164,1,1,265,265,0
BR1_2730933819,7,True,0,0,0,19373,254,40,7.0,True,7,False,1,0,0,17349,212,48,7.4,False,28.40351666666667,2024,0,-1,294,260,34
BR1_2731675564,11,False,1,0,1,19097,179,60,7.0,True,9,True,0,0,0,18214,186,54,6.8,False,25.630583333333334,883,2,1,239,240,-1
BR1_2731653506,11,True,1,0,0,19960,226,40,7.0,True,10,False,0,0,0,19064,181,52,7.0,False,28.60568333333333,896,1,1,266,233,33
BR1_2726242811,8,True,0,0,0,17515,204,55,7.0,True,9,False,0,0,0,16909,209,40,6.8,False,25.320833333333333,606,-1,0,259,249,10
BR1_2730728794,6,False,0,1,0,16730,192,52,6.8,False,9,True,1,0,0,18123,202,60,7.4,True,25.23775,-1393,-3,-1,244,262,-18
BR1_2708664309,13,True,1,0,0,21402,218,84,7.2,False,8,False,0,0,0,17267,196,56,6.4,True,28.988566666666667,4135,5,1,302,252,50
BR1_2731259762,6,True,1,0,0,15690,215,52,6.4,False,9,False,0,0,0,17752,206,52,6.6,True,26.301066666666667,-2062,-3,1,267,258,9
BR1_2720407544,6,True,1,1,0,16162,191,68,6.8,True,5,False,0,0,0,15263,206,44,6.6,False,26.434516666666667,899,1,1,259,250,9
BR1_2731751820,1,False,1,0,0,14106,206,64,7.2,True,7,True,0,1,0,18392,199,80,7.6,False,28.061116666666667,-4286,-6,1,270,279,-9
BR1_2731730700,3,False,1,1,0,14619,179,48,6.4,True,5,True,0,0,0,16610,221,68,7.0,False,25.80775,-1991,-2,1,227,289,-62
BR1_2731704038,9,False,0,0,0,18055,225,58,7.2,True,8,True,0,0,0,18932,213,49,7.4,False,28.185716666666668,-877,1,0,283,262,21
BR1_2731624581,11,True,1,0,0,17448,188,68,6.8,True,6,False,0,0,0,15428,178,52,6.6,False,26.71635,2020,5,1,256,230,26
BR1_2731637767,12,True,0,0,0,18192,151,36,6.8,False,15,False,0,0,0,21814,218,64,7.4,True,29.21925,-3622,-3,0,187,282,-95
BR1_2717762977,8,True,1,0,0,18504,224,56,7.2,True,7,False,0,0,0,17948,224,64,7.6,False,29.034283333333335,556,1,1,280,288,-8
BR1_2717746458,13,True,1,0,0,18983,225,56,7.4,True,5,False,0,0,0,15592,209,62,7.2,False,25.7385,3391,8,1,281,271,10
BR1_2717732117,8,True,0,1,0,16060,166,32,6.6,False,8,False,1,0,0,16954,209,80,7.2,True,27.056316666666667,-894,0,-1,198,289,-91
BR1_2729710746,7,False,0,0,0,18583,217,82,7.6,False,7,True,1,1,0,19450,223,56,7.8,True,28.953033333333334,-867,0,-1,299,279,20
BR1_2728008293,5,False,1,1,0,15374,165,48,6.6,False,10,True,0,0,0,17815,190,68,7.0,True,25.082766666666668,-2441,-5,1,213,258,-45
BR1_2731907226,4,False,0,0,0,16477,221,64,7.6,False,7,True,1,1,0,18587,230,67,7.6,True,28.303566666666665,-2110,-3,-1,285,297,-12
BR1_2730179118,6,False,1,0,0,15532,204,52,6.4,False,10,True,0,1,0,18304,189,52,7.2,True,27.121283333333334,-2772,-4,1,256,241,15
BR1_2708093160,5,True,0,0,0,15099,202,44,6.2,False,7,False,0,1,0,16769,231,48,6.8,True,25.4089,-1670,-2,0,246,279,-33
BR1_2730595803,8,True,0,1,0,18146,225,48,6.8,True,5,False,1,0,0,15100,164,52,6.8,False,26.155383333333333,3046,3,-1,273,216,57
BR1_2730232613,3,False,0,0,0,15920,238,40,7.0,True,8,True,1,0,0,17248,206,40,7.0,False,27.865733333333335,-1328,-5,-1,278,246,32
BR1_2731710093,11,False,1,0,0,18672,197,64,7.2,True,12,True,0,0,0,19139,202,60,7.2,False,29.144866666666665,-467,-1,1,261,262,-1
BR1_2731745183,3,False,0,1,1,16214,232,60,7.4,False,6,True,1,0,0,18747,235,56,7.0,True,27.818483333333333,-2533,-3,-1,292,291,1
BR1_2731716266,4,True,0,1,0,18584,267,80,7.6,False,7,False,1,0,1,19470,264,59,7.6,True,29.877716666666668,-886,-3,-1,347,323,24
BR1_2731564263,5,False,1,1,0,16976,200,75,7.4,False,8,True,0,0,0,18418,234,56,7.6,True,29.802433333333333,-1442,-3,1,275,290,-15
BR1_2731322996,10,False,1,0,0,19030,223,64,7.4,True,9,True,0,1,0,19844,239,56,7.4,False,29.22955,-814,1,1,287,295,-8
BR1_2731307725,8,False,0,0,0,18257,238,61,7.2,True,9,True,0,0,0,19298,251,46,7.6,False,29.36885,-1041,-1,0,299,297,2
BR1_2731822899,5,True,1,0,0,15498,186,52,6.8,True,8,False,0,0,0,17145,209,60,7.2,False,27.057816666666668,-1647,-3,1,238,269,-31
BR1_2731765472,10,False,0,1,0,19418,230,60,7.4,False,7,True,1,0,0,17197,205,48,7.2,True,29.056916666666666,2221,3,-1,290,253,37
BR1_2731278093,7,False,1,0,0,16237,216,48,6.8,True,5,True,0,0,0,15647,203,64,6.8,False,26.19035,590,2,1,264,267,-3
BR1_2731189198,8,True,0,1,0,19060,243,64,7.4,False,9,False,1,0,0,18860,234,48,7.0,True,29.729266666666668,200,-1,-1,307,282,25
BR1_2731897627,4,False,1,0,0,16543,212,56,7.0,True,5,True,0,0,0,17054,199,72,6.8,False,27.70335,-511,-1,1,268,271,-3
BR1_2730579236,10,False,0,1,0,19127,203,54,7.0,True,10,True,1,0,0,19017,238,55,7.4,False,28.2785,110,0,-1,257,293,-36
BR1_2731532404,3,False,0,0,0,14180,188,44,6.6,False,9,True,1,1,0,18485,214,52,7.0,True,25.178366666666665,-4305,-6,-1,232,266,-34
BR1_2729885985,8,True,1,1,0,18623,253,60,7.4,True,4,False,0,0,0,16843,225,52,7.4,False,29.961483333333334,1780,4,1,313,277,36
BR1_2730323825,12,True,0,0,0,17551,181,40,6.6,False,11,False,0,0,0,17999,169,40,6.6,True,25.55355,-448,1,0,221,209,12
BR1_2730306656,8,True,1,0,0,16452,184,44,6.6,True,3,False,0,1,0,16225,235,62,7.0,False,26.9465,227,5,1,228,297,-69
BR1_2730188273,9,False,0,0,0,17822,185,56,7.0,False,10,True,1,0,0,18158,198,64,7.2,True,26.593883333333334,-336,-1,-1,241,262,-21
BR1_2689244393,7,False,0,0,0,16028,167,40,6.2,False,10,True,1,0,0,16674,174,48,6.6,True,27.165583333333334,-646,-3,-1,207,222,-15
BR1_2688783549,7,True,1,0,0,19365,234,72,7.6,True,4,False,0,1,0,16003,204,52,7.0,False,28.462033333333334,3362,3,1,306,256,50
BR1_2688771555,5,False,1,0,0,15838,191,68,6.8,True,5,True,0,0,0,15594,194,56,6.4,False,26.095066666666668,244,0,1,259,250,9
BR1_2721643081,5,False,0,0,0,15558,224,52,7.0,False,11,True,1,0,0,17298,188,43,6.8,True,25.436983333333334,-1740,-6,-1,276,231,45
BR1_2721618801,5,True,1,0,0,15243,186,49,6.6,False,7,False,0,0,0,16392,198,50,7.0,True,26.362416666666668,-1149,-2,1,235,248,-13
BR1_2723530620,10,True,0,0,0,18200,200,56,7.0,False,13,False,1,0,0,20463,223,48,7.6,True,27.812033333333332,-2263,-3,-1,256,271,-15
BR1_2723340085,3,True,1,0,0,14630,229,68,7.0,False,6,False,0,1,0,16918,213,60,7.2,True,26.19815,-2288,-3,1,297,273,24
BR1_2727682726,3,False,0,0,0,16156,229,50,7.6,True,4,True,0,1,0,17858,256,74,7.6,False,28.091083333333334,-1702,-1,0,279,330,-51
BR1_2726113315,7,False,0,1,0,18066,209,68,7.4,True,6,True,1,0,0,17713,232,50,7.4,False,29.131416666666667,353,1,-1,277,282,-5
BR1_2728708926,5,True,0,1,0,15478,177,56,6.6,False,7,False,1,0,0,16944,199,55,7.0,True,26.092016666666666,-1466,-2,-1,233,254,-21
BR1_2731430802,6,False,0,0,0,14687,186,31,6.6,False,9,True,1,0,0,16746,172,50,6.4,True,26.01805,-2059,-3,-1,217,222,-5
BR1_2731375884,11,False,0,0,0,17102,174,44,6.2,True,11,True,1,0,0,17846,156,66,7.0,False,27.423083333333334,-744,0,-1,218,222,-4
BR1_2731374029,4,False,0,0,0,16688,231,60,7.2,True,7,True,1,0,0,17598,239,56,7.4,False,28.04085,-910,-3,-1,291,295,-4
BR1_2726222711,11,False,1,0,0,18198,200,40,6.6,False,16,True,0,0,0,20606,191,48,7.2,True,27.479783333333334,-2408,-5,1,240,239,1
BR1_2725903938,7,False,1,0,0,15631,151,51,6.4,True,11,True,0,1,0,16998,176,51,6.6,False,25.11675,-1367,-4,1,202,227,-25
BR1_2731214273,7,False,0,0,0,19066,217,44,7.0,False,11,True,1,0,0,19974,199,72,7.2,True,27.956016666666667,-908,-4,-1,261,271,-10
BR1_2731171061,3,True,0,0,1,15077,167,64,7.0,False,14,False,1,1,0,21777,194,68,7.8,True,27.6821,-6700,-11,-1,231,262,-31
BR1_2731796318,5,True,0,0,0,17089,215,48,7.0,True,8,False,1,1,0,18560,249,63,7.4,False,28.48665,-1471,-3,-1,263,312,-49
BR1_2731769500,13,True,0,0,0,20704,228,50,7.6,True,7,False,0,1,0,18589,236,62,7.4,False,29.34035,2115,6,0,278,298,-20
BR1_2731739890,11,False,0,0,0,18630,210,48,7.0,True,13,True,1,0,0,21079,207,64,7.4,False,27.574016666666665,-2449,-2,-1,258,271,-13
BR1_2720075505,15,True,0,0,0,18938,193,44,7.0,True,9,False,0,0,0,16627,172,48,6.8,False,26.897616666666668,2311,6,0,237,220,17
BR1_2719460022,12,False,0,0,1,21521,219,48,7.2,True,7,True,0,1,0,18046,195,45,6.8,False,28.254433333333335,3475,5,0,267,240,27
BR1_2731768433,8,False,0,1,0,18509,213,52,7.6,False,13,True,1,0,0,20111,204,56,7.2,True,28.284316666666665,-1602,-5,-1,265,260,5
BR1_2723017004,5,True,0,0,0,17564,227,56,7.0,False,4,False,0,0,0,16436,205,52,7.4,True,29.694466666666667,1128,1,0,283,257,26
BR1_2715508136,6,False,0,0,0,15961,174,57,6.6,False,7,True,1,0,0,17217,189,50,6.4,True,27.138916666666667,-1256,-1,-1,231,239,-8
BR1_2715482230,5,False,1,0,0,15329,200,44,6.6,False,6,True,0,0,0,16904,213,52,6.8,True,26.154683333333335,-1575,-1,1,244,265,-21
BR1_2715466250,5,False,0,0,0,17548,204,68,7.0,True,10,True,0,0,0,18046,229,44,6.8,False,25.205383333333334,-498,-5,0,272,273,-1
BR1_2724956613,5,False,0,0,0,15896,211,64,7.0,True,10,True,1,0,0,17735,186,56,6.8,False,27.42095,-1839,-5,-1,275,242,33
BR1_2730619923,4,True,0,0,0,14720,172,56,6.6,False,5,False,1,0,0,16082,226,56,6.8,True,27.021966666666668,-1362,-1,-1,228,282,-54
BR1_2730607269,5,True,0,0,0,16441,191,56,6.8,False,11,False,1,0,0,18817,223,51,7.0,True,25.06908333333333,-2376,-6,-1,247,274,-27
BR1_2730950367,6,True,0,1,0,17790,229,56,7.4,True,6,False,1,0,0,16420,150,79,7.0,False,29.658833333333334,1370,0,-1,285,229,56
BR1_2721510314,11,False,1,0,0,20278,252,76,7.4,True,4,True,0,1,0,15542,181,48,6.8,False,28.074883333333332,4736,7,1,328,229,99
BR1_2721076472,6,True,1,1,0,18538,207,70,7.2,True,6,False,0,0,0,17332,180,54,7.2,False,29.036233333333332,1206,0,1,277,234,43
BR1_2726599505,8,True,1,0,0,17502,214,64,6.8,True,4,False,0,0,0,14176,165,52,6.8,False,26.50325,3326,4,1,278,217,61
BR1_2730792136,6,True,0,0,0,14985,159,52,6.4,False,11,False,0,0,0,16882,182,28,6.6,True,26.20093333333333,-1897,-5,0,211,210,1
BR1_2721299970,14,True,0,0,0,20353,224,36,7.0,True,9,False,0,1,0,19732,235,52,6.8,False,27.999916666666667,621,5,0,260,287,-27
BR1_2729793449,11,True,1,0,0,18166,221,56,6.6,True,2,False,0,0,0,14628,203,52,6.6,False,26.760683333333333,3538,9,1,277,255,22
BR1_2726047341,11,True,1,0,0,20216,233,49,7.4,False,8,False,0,1,0,18788,233,51,7.4,True,28.36955,1428,3,1,282,284,-2
BR1_2724514888,5,False,0,1,0,17254,237,68,7.2,False,5,True,0,0,0,17452,248,52,7.2,True,27.6229,-198,0,0,305,300,5
BR1_2716631220,9,True,0,0,0,19289,236,55,7.4,False,12,False,1,0,0,20278,247,68,7.4,True,27.763266666666667,-989,-3,-1,291,315,-24
BR1_2731259665,7,False,0,1,1,17015,198,52,6.8,True,10,True,1,0,0,19193,207,56,6.6,False,25.249333333333333,-2178,-3,-1,250,263,-13
BR1_2730778561,10,True,0,0,0,18831,191,52,6.8,False,6,False,1,0,0,17810,224,58,7.0,True,28.316333333333333,1021,4,-1,243,282,-39
BR1_2731771025,10,True,0,0,0,19289,212,68,7.6,True,3,False,1,0,0,15617,210,56,6.8,False,27.610566666666667,3672,7,-1,280,266,14
BR1_2727554949,5,True,0,0,0,16737,235,37,6.8,True,7,False,0,0,0,16649,194,66,6.8,False,26.0986,88,-2,0,272,260,12
BR1_2722188695,7,True,0,0,0,15855,202,51,6.4,False,5,False,1,0,0,16306,206,68,7.0,True,25.762416666666667,-451,2,-1,253,274,-21
BR1_2725846662,4,False,0,0,0,15625,209,60,7.0,True,2,True,1,0,0,14754,221,54,6.8,False,27.09315,871,2,-1,269,275,-6
BR1_2730311027,6,True,1,0,0,16161,226,60,7.2,True,2,False,0,0,0,14739,223,52,7.0,False,26.989916666666666,1422,4,1,286,275,11
BR1_2729893206,4,True,1,0,0,16497,231,67,7.6,False,6,False,0,0,0,17815,213,58,7.4,True,27.659133333333333,-1318,-2,1,298,271,27
BR1_2731367319,8,False,0,0,0,16964,208,54,7.2,False,12,True,1,1,0,21400,227,64,7.6,True,29.979583333333334,-4436,-4,-1,262,291,-29
BR1_2729892410,4,True,1,0,0,16956,239,61,7.4,False,10,False,0,0,0,19723,255,60,7.6,True,29.094116666666668,-2767,-6,1,300,315,-15
BR1_2729872601,11,True,1,0,0,17180,164,72,6.6,False,6,False,0,1,0,15907,212,40,6.4,True,27.186016666666667,1273,5,1,236,252,-16
BR1_2730638276,11,False,1,0,0,18834,206,68,7.2,False,10,True,0,1,0,19644,221,64,7.0,True,29.685216666666665,-810,1,1,274,285,-11
BR1_2730202031,11,False,1,1,0,18324,186,48,7.0,True,6,True,0,0,0,16419,234,43,6.8,False,26.0733,1905,5,1,234,277,-43
BR1_2727984674,6,True,0,1,0,16902,221,52,7.2,False,11,False,1,0,0,18356,209,56,7.2,True,26.831416666666666,-1454,-5,-1,273,265,8
BR1_2731610902,8,True,1,0,0,17967,225,60,7.2,True,5,False,0,1,1,18297,190,44,7.0,False,29.789483333333333,-330,3,1,285,234,51
BR1_2729072367,1,False,0,0,0,15275,226,45,7.2,False,5,True,1,1,0,17561,198,67,7.4,True,28.740816666666667,-2286,-4,-1,271,265,6
BR1_2729024230,6,True,1,0,0,17577,216,64,7.0,False,9,False,0,0,0,18880,198,63,7.6,True,28.6996,-1303,-3,1,280,261,19
BR1_2731514799,12,True,1,0,0,19239,199,55,7.0,False,7,False,0,0,0,18276,225,44,7.4,True,29.357166666666668,963,5,1,254,269,-15
BR1_2731500591,7,True,0,0,0,17898,201,52,7.2,True,9,False,1,1,0,18874,199,64,7.0,False,29.942716666666666,-976,-2,-1,253,263,-10
BR1_2729219611,8,True,1,0,0,18148,199,64,7.4,False,9,False,0,0,0,18607,234,72,7.2,True,28.113316666666666,-459,-1,1,263,306,-43
BR1_2725402097,6,True,0,0,0,17177,230,75,7.8,True,7,False,0,1,0,17670,248,51,7.6,False,29.9303,-493,-1,0,305,299,6
BR1_2731717249,5,False,0,0,0,14754,158,44,6.2,False,7,True,0,0,0,15807,190,51,6.6,True,25.751966666666668,-1053,-2,0,202,241,-39
BR1_2730007558,12,False,0,1,0,19177,194,48,7.4,False,12,True,1,0,0,19443,204,48,7.2,True,28.410416666666666,-266,0,-1,242,252,-10
BR1_2729887614,3,True,0,0,0,15294,193,44,6.8,True,4,False,0,0,0,14925,180,31,6.2,False,25.500233333333334,369,-1,0,237,211,26
BR1_2729872657,11,False,0,1,0,19662,208,64,7.0,True,9,True,1,0,0,17978,177,52,6.6,False,29.9123,1684,2,-1,272,229,43
BR1_2731285871,7,True,1,0,0,17900,210,62,7.2,True,5,False,0,1,0,16917,221,48,7.0,False,28.9658,983,2,1,272,269,3
BR1_2731182510,6,True,0,1,0,19244,249,60,7.8,True,7,False,0,0,0,17131,210,48,7.6,False,28.404666666666667,2113,-1,0,309,258,51
BR1_2731878620,6,True,1,0,0,16481,202,63,6.8,True,5,False,0,0,0,15149,211,48,6.8,False,25.579783333333335,1332,1,1,265,259,6
BR1_2731870806,5,False,0,0,0,14877,190,48,6.6,False,7,True,1,0,0,15761,195,44,6.8,True,27.22821666666667,-884,-2,-1,238,239,-1
BR1_2731865286,8,True,0,0,0,17676,193,76,7.0,False,4,False,1,1,0,15807,209,56,6.8,True,25.8222,1869,4,-1,269,265,4
BR1_2729168598,6,True,1,0,0,16700,181,71,6.8,True,2,False,0,0,0,12805,138,32,6.4,False,27.172016666666668,3895,4,1,252,170,82
BR1_2729119038,15,True,1,1,0,21230,213,64,7.6,True,6,False,0,0,0,16675,153,48,6.6,False,27.988433333333333,4555,9,1,277,201,76
BR1_2729095448,9,True,0,1,0,18334,217,52,7.2,True,7,False,0,0,0,17770,196,52,7.4,False,27.9329,564,2,0,269,248,21
BR1_2727618166,10,False,1,0,0,18782,212,60,7.4,True,13,True,0,0,0,22544,247,48,8.0,False,28.55465,-3762,-3,1,272,295,-23
BR1_2718156167,9,True,0,0,0,18069,224,52,7.0,True,1,False,1,1,0,15613,214,60,7.2,False,27.722483333333333,2456,8,-1,276,274,2
BR1_2717346869,6,False,0,0,0,15866,167,50,6.2,True,9,True,1,0,0,17092,185,44,6.6,False,25.99005,-1226,-3,-1,217,229,-12
BR1_2717325067,9,False,1,0,0,18943,218,52,7.4,False,7,True,0,0,0,18315,215,56,7.0,True,27.862716666666667,628,2,1,270,271,-1
BR1_2731337222,9,True,1,1,0,18263,226,52,7.0,True,9,False,0,0,0,18159,204,52,7.2,False,27.10585,104,0,1,278,256,22
BR1_2728620169,8,False,1,0,0,15908,175,56,6.6,True,10,True,0,0,0,16896,168,44,6.8,False,27.17895,-988,-2,1,231,212,19
BR1_2726533729,12,True,1,0,0,19276,176,52,7.2,True,7,False,0,1,0,16780,172,44,7.2,False,27.522933333333334,2496,5,1,228,216,12
BR1_2731594119,2,False,0,0,0,15481,179,68,7.0,False,14,True,1,0,0,21001,220,64,7.6,True,29.1776,-5520,-12,-1,247,284,-37
BR1_2730135425,16,True,1,1,0,22555,228,72,7.4,True,5,False,0,0,0,17405,220,60,7.4,False,28.859616666666668,5150,11,1,300,280,20
BR1_2730106876,13,True,0,0,0,19057,181,59,6.8,False,15,False,1,1,0,21251,193,52,6.8,True,25.480316666666667,-2194,-2,-1,240,245,-5
BR1_2730861629,8,False,0,1,0,19595,243,79,8.0,True,4,True,1,0,0,17872,263,56,7.4,False,27.525583333333334,1723,4,-1,322,319,3
BR1_2728050423,4,False,0,0,0,13720,162,50,6.6,False,8,True,1,0,0,17219,228,64,6.8,True,25.6829,-3499,-4,-1,212,292,-80
BR1_2730110283,10,True,1,1,0,18977,209,56,7.2,True,4,False,0,0,0,16740,211,76,7.6,False,29.8893,2237,6,1,265,287,-22
BR1_2728891253,4,False,1,1,0,16853,225,64,7.2,True,7,True,0,0,0,17190,224,56,7.2,False,28.874116666666666,-337,-3,1,289,280,9
BR1_2728425680,6,True,0,0,0,15765,195,52,6.8,False,4,False,0,0,0,14793,216,52,6.8,True,26.9263,972,2,0,247,268,-21
BR1_2729046171,9,False,1,0,0,19186,228,68,7.4,True,7,True,0,0,0,17981,225,44,7.2,False,28.638833333333334,1205,2,1,296,269,27
BR1_2731281735,6,False,0,0,0,16431,186,48,6.6,False,7,True,1,1,0,17319,197,68,7.0,True,25.98518333333333,-888,-1,-1,234,265,-31
BR1_2731559719,5,False,0,0,0,17525,217,43,7.2,False,9,True,1,1,0,19838,229,64,7.4,True,29.00883333333333,-2313,-4,-1,260,293,-33
BR1_2731559090,8,True,0,0,0,17319,193,68,7.4,False,3,False,1,0,0,17537,239,56,7.4,True,29.248083333333334,-218,5,-1,261,295,-34
BR1_2731550119,9,True,1,0,0,18238,189,72,7.2,True,2,False,0,1,0,15880,218,44,7.0,False,27.54468333333333,2358,7,1,261,262,-1
BR1_2731501946,9,True,1,0,0,19452,239,52,7.4,True,4,False,0,0,0,16543,236,60,7.4,False,29.379833333333334,2909,5,1,291,296,-5
BR1_2731474815,6,True,0,0,0,16064,197,52,6.4,False,8,False,1,0,0,18022,205,52,6.8,True,26.262966666666667,-1958,-2,-1,249,257,-8
BR1_2731477664,7,True,0,0,0,17122,235,60,7.0,True,4,False,1,0,0,15334,201,60,7.0,False,26.068033333333332,1788,3,-1,295,261,34
BR1_2731240163,7,True,0,0,0,17192,198,47,7.2,False,9,False,0,1,0,19010,206,64,7.6,True,28.62085,-1818,-2,0,245,270,-25
BR1_2730162314,4,True,0,0,0,14404,154,44,6.8,False,5,False,1,0,0,15192,190,56,6.8,True,27.31598333333333,-788,-1,-1,198,246,-48
BR1_2731691025,5,True,0,0,0,15196,205,39,6.6,False,6,False,1,0,0,15887,197,44,6.8,True,26.858216666666667,-691,-1,-1,244,241,3
BR1_2665262577,10,False,1,0,0,19157,218,60,7.8,True,5,True,0,0,0,16583,218,56,7.4,False,27.776966666666667,2574,5,1,278,274,4
BR1_2664695120,12,True,0,0,1,21676,232,60,7.6,False,9,False,0,1,0,21633,211,64,7.8,True,29.973783333333333,43,3,0,292,275,17
BR1_2731740029,12,False,0,0,0,18908,223,44,7.2,False,10,True,1,0,1,20282,232,60,7.4,True,29.844566666666665,-1374,2,-1,267,292,-25
BR1_2731216943,3,True,0,0,0,15383,187,65,7.2,True,7,False,0,1,0,16743,200,13,6.8,False,27.75735,-1360,-4,0,252,213,39
BR1_2727944825,6,True,0,0,2,19701,252,47,7.2,True,5,False,1,0,0,17666,184,60,7.0,False,29.219816666666667,2035,1,-1,299,244,55
BR1_2708811494,5,False,0,1,0,16839,223,60,7.4,False,2,True,1,0,0,16061,246,68,7.2,True,28.2813,778,3,-1,283,314,-31
BR1_2708613011,8,True,0,1,1,18263,217,48,6.6,True,2,False,1,0,0,14345,208,52,6.4,False,25.620566666666665,3918,6,-1,265,260,5
BR1_2728523994,4,True,0,1,0,15934,215,72,7.4,False,5,False,1,0,0,18848,270,68,7.6,True,28.160383333333332,-2914,-1,-1,287,338,-51
BR1_2724471349,2,False,0,1,0,16703,238,47,7.2,False,8,True,1,0,0,17984,230,52,7.4,True,28.669233333333334,-1281,-6,-1,285,282,3
BR1_2723627164,4,False,0,0,0,15474,209,52,6.8,False,5,True,0,1,0,16601,230,52,7.2,True,25.576733333333333,-1127,-1,0,261,282,-21
BR1_2726540038,5,False,0,0,0,16490,224,36,7.4,False,7,True,1,1,0,18301,206,67,7.2,True,29.098033333333333,-1811,-2,-1,260,273,-13
BR1_2719297874,14,False,0,1,0,18775,198,52,7.0,False,8,True,0,0,0,17024,170,42,6.4,True,26.779966666666667,1751,6,0,250,212,38
BR1_2731798264,9,True,1,0,0,19669,238,76,7.6,False,7,False,0,1,1,19387,229,56,7.2,True,27.668483333333334,282,2,1,314,285,29
BR1_2731769888,10,False,0,0,0,18093,194,52,6.8,False,10,True,1,0,0,18031,178,44,6.2,True,25.3622,62,0,-1,246,222,24
BR1_2731792391,2,True,0,0,0,13917,176,56,6.4,False,8,False,1,1,0,16859,218,64,7.4,True,26.1165,-2942,-6,-1,232,282,-50
BR1_2731588743,8,True,0,1,0,17403,190,52,7.0,True,6,False,1,0,0,16382,218,68,7.0,False,26.123866666666668,1021,2,-1,242,286,-44
BR1_2717528912,13,True,0,0,0,18387,162,64,7.0,True,8,False,1,0,0,16217,180,40,6.6,False,27.081983333333334,2170,5,-1,226,220,6
BR1_2731637968,11,True,1,0,0,20235,219,54,6.8,True,10,False,0,1,0,17933,166,53,6.2,False,25.417816666666667,2302,1,1,273,219,54
BR1_2722619081,12,True,0,0,0,17758,194,44,7.2,True,4,False,0,0,0,14566,195,44,6.4,False,25.0887,3192,8,0,238,239,-1
BR1_2722574574,5,True,0,0,0,14463,152,48,6.4,False,6,False,1,0,0,16556,218,60,7.0,True,26.39285,-2093,-1,-1,200,278,-78
BR1_2722047595,6,False,0,0,0,16288,199,40,6.4,True,6,True,1,0,0,15157,188,53,6.8,False,25.53465,1131,0,-1,239,241,-2
BR1_2731647872,8,True,1,0,0,17069,214,40,6.8,True,4,False,0,0,0,15663,198,64,6.6,False,26.64816666666667,1406,4,1,254,262,-8
BR1_2731201029,11,False,0,0,0,20383,216,52,7.2,True,18,True,0,0,0,21347,186,55,7.0,False,28.147516666666668,-964,-7,0,268,241,27
BR1_2729625131,15,True,0,1,0,22528,229,64,7.8,False,7,False,1,0,0,16701,191,76,7.2,True,27.865316666666665,5827,8,-1,293,267,26
BR1_2729572568,7,True,0,0,0,17868,205,60,7.2,True,7,False,1,0,0,18567,229,64,7.2,False,29.21935,-699,0,-1,265,293,-28
BR1_2729186736,6,False,0,0,0,16093,222,44,6.8,False,2,True,1,0,0,14771,217,64,6.6,True,25.263633333333335,1322,4,-1,266,281,-15
BR1_2729162436,10,False,0,0,0,18401,207,58,7.4,False,6,True,1,0,0,16333,212,46,6.8,True,27.259,2068,4,-1,265,258,7
BR1_2728605031,9,True,1,1,0,17514,196,47,6.8,True,1,False,0,0,0,13892,194,56,6.2,False,26.734416666666668,3622,8,1,243,250,-7
BR1_2731830629,4,True,0,0,0,16485,242,52,7.0,False,12,False,0,0,0,21538,259,56,7.4,True,27.945333333333334,-5053,-8,0,294,315,-21
BR1_2731807383,4,True,0,1,0,16058,185,72,7.6,True,6,False,0,0,0,16852,238,44,7.4,False,29.842366666666667,-794,-2,0,257,282,-25
BR1_2731782623,6,False,1,0,0,17676,229,56,7.4,True,4,True,0,1,0,17519,218,72,7.4,False,28.21275,157,2,1,285,290,-5
BR1_2731746400,7,False,1,0,0,18691,263,64,7.2,False,8,True,0,0,0,19140,247,56,7.2,True,28.483,-449,-1,1,327,303,24
BR1_2722239954,4,True,0,0,0,15974,223,64,7.4,False,10,False,1,1,0,20724,269,80,8.0,True,28.521733333333334,-4750,-6,-1,287,349,-62
BR1_2722186687,10,True,0,1,0,18052,178,40,6.8,True,6,False,1,0,0,16896,217,56,6.8,False,26.378416666666666,1156,4,-1,218,273,-55
BR1_2722146809,7,False,0,0,0,15908,164,48,6.6,False,12,True,1,1,0,19109,177,56,7.0,True,25.174683333333334,-3201,-5,-1,212,233,-21
BR1_2731817248,5,True,0,0,0,16243,204,64,7.2,False,7,False,1,1,0,18632,238,79,7.8,True,28.428566666666665,-2389,-2,-1,268,317,-49
BR1_2731706180,11,True,0,0,0,19176,194,60,7.2,True,4,False,1,0,0,14695,159,68,6.4,False,26.07435,4481,7,-1,254,227,27
BR1_2721774737,3,False,0,0,0,15016,194,44,6.6,False,5,True,0,0,0,15694,203,56,6.8,True,26.251,-678,-2,0,238,259,-21
BR1_2731671965,5,False,1,1,0,17148,207,76,7.6,True,7,True,0,0,0,19287,253,60,7.6,False,29.591633333333334,-2139,-2,1,283,313,-30
BR1_2731802024,2,False,0,0,0,14322,205,60,6.8,False,8,True,0,0,0,18249,222,60,7.0,True,26.105666666666668,-3927,-6,0,265,282,-17
BR1_2731828229,9,True,0,0,0,17727,191,48,6.6,True,5,False,1,0,0,14023,148,43,6.6,False,26.9218,3704,4,-1,239,191,48
BR1_2730085410,19,False,1,0,0,23827,203,52,7.6,True,12,True,0,0,0,19418,168,63,7.0,False,29.30056666666667,4409,7,1,255,231,24
BR1_2731805764,4,True,0,0,0,15243,175,52,6.2,True,7,False,0,0,0,16548,186,48,6.6,False,27.006333333333334,-1305,-3,0,227,234,-7
BR1_2704706670,6,True,1,0,0,18071,215,56,7.4,True,5,False,0,0,0,15328,194,56,6.8,False,28.99395,2743,1,1,271,250,21
BR1_2704670991,4,False,0,0,0,14471,170,48,6.4,False,5,True,1,0,0,16262,231,56,7.0,True,27.11635,-1791,-1,-1,218,287,-69
BR1_2726328314,6,True,1,0,0,15532,191,48,6.8,True,2,False,0,0,0,16013,237,64,7.0,False,25.599183333333333,-481,4,1,239,301,-62
BR1_2731788475,2,True,0,0,0,14232,207,44,6.6,True,3,False,0,0,0,15006,206,60,7.2,False,27.1189,-774,-1,0,251,266,-15
BR1_2731749519,5,False,0,0,0,15233,168,48,6.4,True,2,True,0,0,0,14192,196,56,6.6,False,26.150866666666666,1041,3,0,216,252,-36
BR1_2731425586,14,True,1,0,0,21024,239,51,7.4,True,7,False,0,0,0,17342,213,41,7.2,False,29.013666666666666,3682,7,1,290,254,36
BR1_2731740628,2,False,0,0,0,16434,200,76,7.4,False,3,True,0,1,1,18198,248,60,7.2,True,29.175266666666666,-1764,-1,0,276,308,-32
BR1_2729827158,7,True,0,1,0,18567,230,56,7.4,True,7,False,1,0,0,17450,207,64,7.6,False,27.821483333333333,1117,0,-1,286,271,15
BR1_2729819793,7,True,1,0,1,18826,219,64,7.6,True,5,False,0,0,0,17965,237,52,7.2,False,29.467316666666665,861,2,1,283,289,-6
BR1_2729432883,8,False,0,0,0,16241,194,55,6.8,False,5,True,1,1,0,15605,205,60,6.8,True,27.36075,636,3,-1,249,265,-16
BR1_2726241907,6,False,1,0,0,14761,173,52,6.4,False,9,True,0,1,0,17842,209,52,6.8,True,26.8884,-3081,-3,1,225,261,-36
BR1_2726215792,14,True,0,0,0,19903,207,48,7.0,False,14,False,1,1,0,21232,198,52,7.4,True,29.517383333333335,-1329,0,-1,255,250,5
BR1_2731210047,3,False,0,0,0,15487,203,46,6.8,False,6,True,0,1,0,17728,221,60,7.4,True,28.365633333333335,-2241,-3,0,249,281,-32
BR1_2725811765,6,False,0,0,0,17919,203,64,7.0,True,3,True,1,0,0,16611,190,76,7.2,False,29.684966666666668,1308,3,-1,267,266,1
BR1_2731471997,9,True,0,0,0,18037,182,39,7.0,False,9,False,1,0,0,19088,221,64,7.6,True,27.94335,-1051,0,-1,221,285,-64
BR1_2731728465,7,True,1,1,0,18288,221,68,7.2,True,5,False,0,0,0,17155,214,44,7.2,False,28.81035,1133,2,1,289,258,31
BR1_2731323309,10,True,0,0,0,18199,218,52,6.6,True,8,False,1,0,0,15988,166,40,6.4,False,26.46676666666667,2211,2,-1,270,206,64
BR1_2731221650,7,False,1,0,0,16899,177,35,6.6,False,12,True,0,0,0,19804,220,44,7.0,True,29.981183333333334,-2905,-5,1,212,264,-52
BR1_2731196423,4,False,0,0,0,13707,156,48,6.4,False,2,True,0,0,0,15453,236,56,6.8,True,26.747166666666665,-1746,2,0,204,292,-88
BR1_2731565467,11,True,1,1,0,19736,234,56,7.6,True,8,False,0,0,0,16752,210,43,7.2,False,29.661283333333333,2984,3,1,290,253,37
BR1_2703401730,6,False,0,0,0,17724,197,56,7.2,False,7,True,0,0,0,18169,232,52,7.6,True,28.702666666666666,-445,-1,0,253,284,-31
BR1_2703373333,8,False,0,1,0,17435,227,60,7.0,True,4,True,0,0,0,14392,172,44,6.6,False,26.679116666666665,3043,4,0,287,216,71
BR1_2703355964,6,False,0,1,0,16677,183,60,7.0,False,5,True,1,0,0,17321,212,60,7.2,True,25.28548333333333,-644,1,-1,243,272,-29
BR1_2703282114,12,False,0,0,0,20203,185,42,7.0,False,18,True,1,1,0,24105,230,56,7.4,True,28.8719,-3902,-6,-1,227,286,-59
BR1_2690900973,6,False,1,1,0,15658,175,60,6.8,True,4,True,0,0,0,16269,242,52,6.6,False,26.455883333333333,-611,2,1,235,294,-59
BR1_2723796017,8,False,0,0,0,17672,187,56,7.2,True,9,True,1,0,0,19245,240,52,7.4,False,28.74565,-1573,-1,-1,243,292,-49
BR1_2731496773,7,True,1,0,0,16952,208,50,7.0,True,2,False,0,0,0,14143,177,44,6.6,False,26.731733333333334,2809,5,1,258,221,37
BR1_2723069073,7,True,1,1,0,16056,196,44,7.0,True,5,False,0,0,0,15352,179,56,6.8,False,27.030566666666665,704,2,1,240,235,5
BR1_2721000818,6,True,1,0,0,16623,197,56,6.8,True,1,False,0,1,0,14154,214,52,6.8,False,25.9609,2469,5,1,253,266,-13
BR1_2720685446,6,False,0,0,0,18282,247,60,7.2,False,8,True,0,0,0,18982,239,67,7.6,True,28.8123,-700,-2,0,307,306,1
BR1_2730273230,5,False,1,0,0,16871,200,59,7.0,False,5,True,0,1,0,17120,219,60,7.6,True,28.665216666666666,-249,0,1,259,279,-20
BR1_2696183209,3,False,0,0,0,15723,196,56,7.0,False,12,True,1,0,0,20771,214,64,7.6,True,28.655383333333333,-5048,-9,-1,252,278,-26
BR1_2691268621,5,False,0,0,0,14160,173,44,6.4,False,10,True,1,0,0,17776,197,52,7.0,True,26.45395,-3616,-5,-1,217,249,-32
BR1_2691246656,15,True,0,0,0,22772,242,66,8.0,True,3,False,0,0,0,15554,198,54,6.8,False,27.602666666666668,7218,12,0,308,252,56
BR1_2730319257,4,False,0,0,0,14684,183,48,6.6,True,6,True,0,0,0,15208,185,37,6.6,False,27.478366666666666,-524,-2,0,231,222,9
BR1_2728926824,11,True,1,0,0,16216,170,33,6.2,False,8,False,0,0,0,16001,198,40,6.4,True,25.9081,215,3,1,203,238,-35
BR1_2728465206,7,False,1,0,0,17002,200,44,6.6,True,9,True,0,0,0,17162,181,44,6.4,False,25.063716666666668,-160,-2,1,244,225,19
BR1_2707151193,6,True,1,1,0,18476,222,64,7.4,False,4,False,0,0,0,16872,227,64,7.4,True,28.306533333333334,1604,2,1,286,291,-5
BR1_2700691331,13,False,1,0,0,19594,194,64,6.6,True,3,True,0,0,0,13377,140,32,6.0,False,26.601766666666666,6217,10,1,258,172,86
BR1_2731376986,3,False,0,0,0,12860,141,52,6.4,False,7,True,0,1,0,16916,237,48,7.0,True,25.046166666666668,-4056,-4,0,193,285,-92
BR1_2731296753,3,False,0,0,0,13691,161,44,6.6,True,8,True,1,1,0,16827,204,52,6.6,False,27.39218333333333,-3136,-5,-1,205,256,-51
BR1_2729966213,7,True,1,1,0,16728,189,52,6.8,True,4,False,0,0,0,14981,174,60,6.8,False,26.581,1747,3,1,241,234,7
BR1_2710125637,10,True,1,1,0,20088,232,54,7.2,True,11,False,0,0,0,19386,229,57,7.0,False,28.1933,702,-1,1,286,286,0
BR1_2709896325,10,False,0,0,0,18577,227,26,7.2,False,16,True,1,0,0,20762,202,60,7.4,True,28.111516666666667,-2185,-6,-1,253,262,-9
BR1_2730948643,4,False,0,0,0,16924,223,52,7.4,True,8,True,1,0,0,18606,253,55,7.6,False,29.08795,-1682,-4,-1,275,308,-33
BR1_2722529654,6,True,0,0,0,16232,206,57,6.8,False,6,False,1,0,0,16210,208,54,7.0,True,26.4608,22,0,-1,263,262,1
BR1_2694080191,7,True,0,0,0,15819,168,60,6.6,False,4,False,1,1,0,15675,183,59,6.8,True,26.607016666666667,144,3,-1,228,242,-14
BR1_2694078393,12,True,1,0,0,20300,222,48,7.0,True,7,False,0,0,0,16180,173,54,6.6,False,26.746566666666666,4120,5,1,270,227,43
BR1_2693971869,13,True,1,0,0,20338,204,68,7.6,True,8,False,0,0,0,18224,221,43,7.0,False,29.152116666666668,2114,5,1,272,264,8
BR1_2722537396,2,True,0,0,0,15600,245,46,7.2,False,4,False,1,0,0,16926,232,54,7.8,True,28.883033333333334,-1326,-2,-1,291,286,5
BR1_2720644176,4,True,0,0,0,15012,178,48,7.0,False,9,False,1,0,0,18475,233,76,7.4,True,26.4575,-3463,-5,-1,226,309,-83
BR1_2731615461,7,True,1,0,0,16005,185,60,6.6,True,6,False,0,1,0,17589,215,45,6.8,False,26.621,-1584,1,1,245,260,-15
BR1_2731857937,8,True,1,0,0,19023,203,72,7.2,True,9,False,0,1,0,17782,229,48,7.2,False,27.98915,1241,-1,1,275,277,-2
BR1_2731681929,5,False,1,1,0,14858,175,60,6.6,False,15,True,0,0,0,19960,231,44,7.2,True,27.4259,-5102,-10,1,235,275,-40
BR1_2731603858,12,False,1,0,0,19012,190,44,7.2,False,8,True,0,0,0,18590,227,55,6.8,True,29.218183333333332,422,4,1,234,282,-48
BR1_2731523500,12,True,1,0,0,20113,211,45,7.2,False,6,False,0,0,0,17165,197,50,6.8,True,29.325433333333333,2948,6,1,256,247,9
BR1_2675019800,7,True,1,0,0,18335,226,56,7.4,True,7,False,0,0,0,17950,207,48,7.4,False,27.690966666666668,385,0,1,282,255,27
BR1_2674968341,3,False,0,1,0,13434,166,40,6.6,False,5,True,0,0,0,16191,204,52,6.8,True,26.970233333333333,-2757,-2,0,206,256,-50
BR1_2674824690,5,False,1,0,0,16428,205,44,7.0,False,12,True,0,0,0,20714,216,76,7.6,True,28.055783333333334,-4286,-7,1,249,292,-43
BR1_2674439151,16,True,1,0,0,20594,156,35,7.0,False,12,False,0,0,0,19576,192,50,7.2,True,29.625233333333334,1018,4,1,191,242,-51
BR1_2731599807,3,False,0,0,0,17145,234,58,7.0,False,12,True,1,0,0,19154,209,62,7.6,True,28.848583333333334,-2009,-9,-1,292,271,21
BR1_2731247925,7,True,1,0,0,18699,208,48,7.6,True,2,False,0,1,0,16583,237,80,7.6,False,27.607516666666665,2116,5,1,256,317,-61
BR1_2731174481,15,True,1,0,0,20702,233,52,7.4,True,3,False,0,1,0,14164,158,55,6.6,False,26.07095,6538,12,1,285,213,72
BR1_2726075810,7,True,0,1,0,18222,214,60,7.2,True,3,False,1,0,0,16529,251,64,7.2,False,29.698,1693,4,-1,274,315,-41
BR1_2720605813,8,True,0,1,0,17960,213,64,6.8,False,8,False,1,0,0,17112,175,52,7.0,True,28.621733333333335,848,0,-1,277,227,50
BR1_2731161770,7,False,0,0,0,17242,196,68,6.8,False,10,True,1,0,0,17555,219,38,7.0,True,25.667133333333332,-313,-3,-1,264,257,7
BR1_2731818177,9,True,0,0,0,19772,250,72,7.4,False,6,False,1,1,0,18136,228,72,7.6,True,28.36345,1636,3,-1,322,300,22
BR1_2730475873,13,False,1,1,0,22050,242,63,7.6,True,10,True,0,0,0,19737,227,62,7.2,False,29.6939,2313,3,1,305,289,16
BR1_2730265329,1,True,1,0,0,14361,209,64,6.8,False,7,False,0,0,0,16604,184,60,7.6,True,25.604016666666666,-2243,-6,1,273,244,29
BR1_2692067525,7,True,1,0,0,18200,250,56,7.2,True,4,False,0,1,0,16945,221,55,7.4,False,27.6796,1255,3,1,306,276,30
BR1_2730850338,9,True,0,1,0,19433,232,68,7.8,True,1,False,0,0,0,14561,177,72,6.8,False,28.189866666666667,4872,8,0,300,249,51
BR1_2730820730,8,True,0,1,0,17554,205,48,7.0,True,2,False,0,0,0,12911,182,40,6.8,False,26.524233333333335,4643,6,0,253,222,31
BR1_2730781431,2,False,0,0,0,14994,204,59,7.6,False,6,True,1,0,0,18737,275,73,7.8,True,29.605766666666668,-3743,-4,-1,263,348,-85
BR1_2727311930,10,True,0,0,0,17920,203,40,6.8,True,4,False,0,1,0,14803,185,52,6.6,False,25.41105,3117,6,0,243,237,6
BR1_2726444014,3,False,1,1,0,16083,211,64,7.2,True,4,True,0,0,0,16872,245,59,7.6,False,29.601483333333334,-789,-1,1,275,304,-29
BR1_2722048942,8,True,1,0,0,16801,210,76,7.0,True,3,False,0,0,0,13902,179,39,6.4,False,25.3725,2899,5,1,286,218,68
BR1_2731306099,4,False,0,1,1,16928,190,60,6.8,True,8,True,1,0,0,16003,190,58,6.6,False,26.7966,925,-4,-1,250,248,2
BR1_2730235044,7,False,1,1,0,17806,227,80,7.4,False,5,True,0,0,0,17924,245,56,7.2,True,29.76675,-118,2,1,307,301,6
BR1_2726314122,1,True,0,0,0,14700,212,56,7.2,False,2,False,1,1,0,16630,244,72,7.4,True,27.62235,-1930,-1,-1,268,316,-48
BR1_2731819300,10,True,0,1,0,19518,195,78,7.6,True,4,False,1,0,0,15973,227,48,7.0,False,29.779316666666666,3545,6,-1,273,275,-2
BR1_2731883020,8,True,0,0,0,18464,244,48,7.4,False,7,False,1,1,0,19477,255,64,7.6,True,29.067633333333333,-1013,1,-1,292,319,-27
BR1_2731779401,7,True,0,0,0,17216,203,52,6.8,True,5,False,0,0,0,15557,192,48,6.6,False,26.2262,1659,2,0,255,240,15
BR1_2729444491,11,False,0,0,0,17040,141,50,6.6,False,9,True,0,0,0,17476,175,49,6.8,True,26.9243,-436,2,0,191,224,-33
BR1_2729128760,7,True,0,0,0,17384,208,61,6.8,True,3,False,0,0,0,13968,173,46,6.4,False,25.16583333333333,3416,4,0,269,219,50
BR1_2731790210,1,False,0,0,0,15977,270,68,7.4,False,8,True,0,0,0,18472,241,60,7.6,True,29.160516666666666,-2495,-7,0,338,301,37
BR1_2729586212,6,True,1,1,0,17034,219,64,7.0,True,4,False,0,0,0,15632,208,56,6.8,False,25.2756,1402,2,1,283,264,19
BR1_2731864015,7,False,0,0,0,17757,220,60,7.4,False,6,True,1,0,0,17711,247,64,7.2,True,28.545516666666668,46,1,-1,280,311,-31
BR1_2731828033,4,False,0,0,0,16660,256,60,7.6,False,8,True,1,0,0,19103,242,68,7.8,True,29.61655,-2443,-4,-1,316,310,6
BR1_2731676781,12,True,1,0,0,19354,188,52,7.2,True,1,False,0,1,0,15291,215,56,6.8,False,28.050466666666665,4063,11,1,240,271,-31
BR1_2730989384,17,True,1,0,0,23885,253,68,7.8,True,7,False,0,0,0,17367,174,64,7.4,False,29.890516666666667,6518,10,1,321,238,83
BR1_2731739956,2,False,0,0,0,14054,189,52,6.6,False,10,True,1,1,0,17555,239,48,7.0,True,27.263366666666666,-3501,-8,-1,241,287,-46
BR1_2727927098,12,True,0,0,0,19027,188,40,7.0,False,4,False,1,0,0,16553,203,52,6.4,True,28.161583333333333,2474,8,-1,228,255,-27
BR1_2698795486,7,False,0,1,0,17278,211,52,6.6,True,6,True,1,0,0,16092,224,38,7.0,False,27.000033333333334,1186,1,-1,263,262,1
BR1_2698494119,11,True,0,1,0,20081,226,44,7.2,True,6,False,1,0,0,17081,236,52,7.0,False,29.920366666666666,3000,5,-1,270,288,-18
BR1_2728799880,5,True,0,0,0,14730,187,40,6.4,False,12,False,1,0,0,17985,205,48,6.8,True,25.713083333333334,-3255,-7,-1,227,253,-26
BR1_2726186227,5,False,0,0,0,16898,231,51,7.4,True,12,True,1,0,0,20079,237,68,7.4,False,29.473583333333334,-3181,-7,-1,282,305,-23
BR1_2727186091,10,False,1,1,0,19257,225,60,7.4,True,5,True,0,0,0,16387,208,40,7.0,False,28.29446666666667,2870,5,1,285,248,37
BR1_2727176323,8,True,1,1,0,18034,243,64,6.8,True,1,False,0,0,0,13697,192,52,6.8,False,26.4798,4337,7,1,307,244,63
BR1_2727168371,7,True,1,0,0,17317,185,40,6.6,True,8,False,0,1,0,16792,199,48,6.8,False,25.173333333333332,525,-1,1,225,247,-22
BR1_2728062518,7,True,0,0,0,18604,227,55,7.4,False,10,False,1,1,0,20169,232,50,7.6,True,29.14555,-1565,-3,-1,282,282,0
BR1_2720525060,4,True,1,0,0,14648,177,52,6.4,False,8,False,0,0,0,16221,202,48,6.8,True,25.828383333333335,-1573,-4,1,229,250,-21
BR1_2726901269,6,True,0,1,0,17829,230,76,7.0,True,8,False,1,0,0,18267,215,60,7.4,False,29.3474,-438,-2,-1,306,275,31
BR1_2724896007,6,False,0,1,0,16180,229,50,6.8,True,6,True,0,0,0,16399,220,53,7.0,False,26.175633333333334,-219,0,0,279,273,6
BR1_2694560187,2,False,0,0,0,15240,197,60,7.2,False,7,True,1,1,0,17601,190,62,7.2,True,29.05255,-2361,-5,-1,257,252,5
BR1_2731408369,10,False,1,0,0,18000,203,56,7.2,True,4,True,0,1,0,15610,202,56,6.8,False,26.290166666666668,2390,6,1,259,258,1
BR1_2723379087,3,False,1,0,0,15181,209,58,6.6,True,4,True,0,0,0,13958,166,60,6.8,False,26.493533333333332,1223,-1,1,267,226,41
BR1_2723360160,8,True,1,0,0,18704,247,56,7.6,True,5,False,0,1,0,16534,178,56,7.0,False,29.981733333333334,2170,3,1,303,234,69
BR1_2724602584,6,True,0,0,0,18092,229,60,7.8,False,6,False,0,0,0,16910,216,52,7.2,True,29.6117,1182,0,0,289,268,21
BR1_2729616464,6,False,1,1,0,16220,206,56,6.8,True,4,True,0,0,0,14713,222,39,6.4,False,26.006833333333333,1507,2,1,262,261,1
BR1_2731872535,8,False,1,0,0,17553,186,56,6.6,True,6,True,0,0,0,15377,200,40,6.4,False,25.52625,2176,2,1,242,240,2
BR1_2731373269,7,True,1,1,0,18248,244,76,8.2,True,6,False,0,0,0,18532,234,68,7.8,False,29.401283333333332,-284,1,1,320,302,18
BR1_2731361836,7,False,1,0,0,16943,204,64,7.0,True,5,True,0,0,0,15062,191,67,7.0,False,26.524316666666667,1881,2,1,268,258,10
BR1_2731358417,15,False,1,1,0,18700,177,48,6.2,True,10,True,0,0,0,17325,171,48,6.6,False,27.15345,1375,5,1,225,219,6
BR1_2731871189,15,False,1,0,0,21310,199,50,7.2,False,12,True,0,1,0,21037,220,60,7.2,True,28.903316666666665,273,3,1,249,280,-31
BR1_2731862201,13,True,1,1,1,22824,251,68,7.6,True,9,False,0,0,0,18902,229,51,7.2,False,29.162183333333335,3922,4,1,319,280,39
BR1_2731841150,3,True,0,0,0,17333,252,68,7.4,True,2,False,1,0,0,16066,257,52,7.2,False,28.62076666666667,1267,1,-1,320,309,11
BR1_2705732468,8,True,0,0,0,17566,205,56,7.2,True,3,False,0,0,0,13345,164,40,6.8,False,26.193666666666665,4221,5,0,261,204,57
BR1_2722942405,5,False,0,1,0,15515,194,48,6.6,False,10,True,0,0,0,18477,216,56,7.0,True,26.52713333333333,-2962,-5,0,242,272,-30
BR1_2728113720,9,True,1,1,0,18965,247,64,7.4,True,7,False,0,0,0,18734,217,60,7.0,False,28.50273333333333,231,2,1,311,277,34
BR1_2731733673,10,True,1,1,0,19746,229,60,7.4,True,3,False,0,0,0,15439,197,52,7.0,False,27.640766666666668,4307,7,1,289,249,40
BR1_2731710438,8,True,1,0,0,17160,219,56,7.0,True,4,False,0,0,0,15822,206,56,7.2,False,28.704633333333334,1338,4,1,275,262,13
BR1_2731644716,9,False,0,0,0,16533,186,48,6.8,True,7,True,1,0,0,16137,187,48,6.8,False,27.259816666666666,396,2,-1,234,235,-1
BR1_2718067923,7,False,1,0,0,18428,217,60,7.6,True,5,True,0,0,0,16636,224,60,7.0,False,29.40585,1792,2,1,277,284,-7
BR1_2730659716,11,True,0,1,1,21403,219,44,7.2,True,9,False,1,0,0,18987,179,84,7.4,False,28.934616666666667,2416,2,-1,263,263,0
BR1_2731830314,5,False,1,1,0,16628,196,60,7.2,True,4,True,0,0,0,16678,219,56,6.8,False,28.788783333333335,-50,1,1,256,275,-19
BR1_2731809365,3,False,1,0,0,16626,220,59,7.2,False,7,True,0,0,0,17864,231,52,7.4,True,28.26321666666667,-1238,-4,1,279,283,-4
BR1_2731553297,7,True,0,0,0,18409,232,54,7.4,True,9,False,1,1,0,17827,172,73,7.0,False,28.640783333333335,582,-2,-1,286,245,41
BR1_2730632309,6,False,1,0,0,15432,178,48,6.6,False,4,True,0,0,0,15264,194,52,6.6,True,27.03386666666667,168,2,1,226,246,-20
BR1_2730583828,5,False,1,0,0,16204,225,40,7.2,False,5,True,0,0,0,17002,234,48,7.0,True,27.960083333333333,-798,0,1,265,282,-17
BR1_2728960350,10,True,1,0,0,19013,218,68,7.6,True,6,False,0,0,0,17435,202,56,7.0,False,29.5005,1578,4,1,286,258,28
BR1_2728458962,13,True,0,0,0,21051,210,64,7.4,False,14,False,1,1,0,21743,214,52,7.4,True,28.713916666666666,-692,-1,-1,274,266,8
BR1_2727845002,6,False,0,1,0,16995,184,52,7.0,True,7,True,1,0,0,17340,200,72,7.2,False,28.349,-345,-1,-1,236,272,-36
BR1_2731425759,6,False,0,0,0,17680,219,52,7.4,True,5,True,1,0,0,16344,221,44,7.0,False,28.973316666666665,1336,1,-1,271,265,6
BR1_2731099794,6,False,0,0,0,15373,177,60,6.6,False,13,True,1,0,0,19708,204,71,7.6,True,26.292683333333333,-4335,-7,-1,237,275,-38
BR1_2729474442,6,True,0,0,0,16995,202,36,6.8,False,12,False,1,1,0,20841,253,64,7.6,True,28.356683333333333,-3846,-6,-1,238,317,-79
BR1_2731023251,5,True,0,0,0,16247,212,44,7.0,False,6,False,1,1,0,15919,199,56,7.0,True,25.672283333333333,328,-1,-1,256,255,1
BR1_2731308435,6,False,0,0,0,16828,220,52,7.0,False,11,True,0,0,0,19209,222,60,7.6,True,29.356316666666668,-2381,-5,0,272,282,-10
BR1_2730592695,6,False,0,0,0,16316,197,44,7.0,True,7,True,1,0,0,16169,177,51,6.8,False,27.49915,147,-1,-1,241,228,13
BR1_2730579159,4,False,0,1,0,15976,215,55,7.0,True,5,True,1,0,0,16583,224,56,7.2,False,27.667283333333334,-607,-1,-1,270,280,-10
BR1_2730941378,4,True,1,0,0,17802,250,64,7.4,True,5,False,0,0,0,16878,210,52,7.4,False,29.25958333333333,924,-1,1,314,262,52
BR1_2731081949,9,True,0,0,0,18040,213,52,7.0,True,7,False,0,0,0,16167,228,45,6.8,False,26.389366666666668,1873,2,0,265,273,-8
BR1_2716504473,10,False,1,1,0,19231,246,64,7.2,True,8,True,0,0,0,17698,203,52,7.2,False,27.920683333333333,1533,2,1,310,255,55
BR1_2687230819,9,True,1,0,0,17051,204,52,6.6,True,3,False,0,0,0,15121,177,56,6.6,False,26.136666666666667,1930,6,1,256,233,23
BR1_2731847102,6,True,1,0,0,17344,217,64,7.2,True,5,False,0,0,0,16601,219,44,7.0,False,29.509766666666668,743,1,1,281,263,18
BR1_2708422516,12,False,1,0,0,20266,211,48,7.4,True,10,True,0,0,0,20740,222,68,7.4,False,28.625566666666668,-474,2,1,259,290,-31
BR1_2721899200,1,False,0,0,0,14811,212,56,7.2,False,6,True,1,0,0,18281,254,64,7.6,True,29.147,-3470,-5,-1,268,318,-50
BR1_2731175180,6,True,0,0,0,15011,174,43,6.4,False,9,False,1,0,0,17491,194,64,6.8,True,25.175116666666668,-2480,-3,-1,217,258,-41
BR1_2731869307,4,False,1,1,0,17121,252,52,7.4,True,5,True,0,0,0,17734,242,48,7.4,False,27.614616666666667,-613,-1,1,304,290,14
BR1_2731858377,6,False,0,1,0,16024,185,60,6.6,False,10,True,1,0,0,18315,191,56,6.8,True,26.603783333333332,-2291,-4,-1,245,247,-2
BR1_2731847264,4,False,1,0,0,17102,242,62,7.4,True,3,True,0,1,0,16175,240,46,7.6,False,28.582833333333333,927,1,1,304,286,18
BR1_2730758134,7,True,1,0,0,17923,245,48,7.2,True,2,False,0,1,0,15383,202,40,7.0,False,27.921266666666668,2540,5,1,293,242,51
BR1_2730167537,6,True,0,0,0,16618,233,64,7.6,False,5,False,1,0,0,17264,227,68,7.4,True,29.32315,-646,1,-1,297,295,2
BR1_2711194331,3,False,0,1,0,15484,223,64,7.4,False,7,True,0,0,0,18277,200,62,7.4,True,27.894033333333333,-2793,-4,0,287,262,25
BR1_2689024970,5,True,0,0,0,14885,175,41,6.8,True,5,False,1,0,0,16213,225,59,7.0,False,27.480633333333333,-1328,0,-1,216,284,-68
BR1_2729547124,8,False,0,1,0,18036,215,52,6.8,True,9,True,1,0,0,17149,155,52,6.4,False,25.87565,887,-1,-1,267,207,60
BR1_2729460719,7,True,0,0,0,17793,251,60,7.4,False,1,False,1,0,0,14529,214,52,7.0,True,29.394116666666665,3264,6,-1,311,266,45
BR1_2730934887,10,False,1,0,0,17683,188,44,7.4,False,10,True,0,1,0,19391,256,56,7.4,True,28.410583333333335,-1708,0,1,232,312,-80
BR1_2730771198,3,True,1,0,0,16968,268,60,7.6,True,2,False,0,1,0,16878,241,52,7.4,False,29.77465,90,1,1,328,293,35
BR1_2729256949,4,False,0,0,0,14893,175,48,6.6,False,8,True,0,0,0,17311,233,60,6.8,True,26.801333333333332,-2418,-4,0,223,293,-70
BR1_2711520330,5,False,0,0,0,16994,220,48,7.2,False,12,True,1,1,0,19265,194,44,7.4,True,29.50195,-2271,-7,-1,268,238,30
BR1_2728857966,4,True,0,0,0,16900,254,44,7.2,False,6,False,1,1,0,17073,218,60,7.2,True,29.66433333333333,-173,-2,-1,298,278,20
BR1_2728800828,8,False,0,0,0,19808,270,56,7.4,True,7,True,1,0,0,18714,262,48,7.4,False,29.0922,1094,1,-1,326,310,16
BR1_2729344929,5,False,1,0,0,16919,236,48,7.6,False,13,True,0,0,0,20762,233,84,7.8,True,28.092666666666666,-3843,-8,1,284,317,-33
BR1_2729966817,16,True,1,0,0,22238,231,52,7.6,True,7,False,0,0,0,18893,213,68,7.4,False,27.989766666666668,3345,9,1,283,281,2
BR1_2727806669,10,False,1,0,0,16374,182,60,6.8,True,5,True,0,0,0,14327,176,48,6.2,False,25.326716666666666,2047,5,1,242,224,18
BR1_2726956538,7,False,1,0,0,16964,206,60,7.2,True,13,True,0,0,0,18933,209,52,7.2,False,26.291666666666668,-1969,-6,1,266,261,5
BR1_2729459897,10,True,0,0,0,19879,287,48,7.6,False,2,False,1,1,0,15673,215,68,7.4,True,29.253683333333335,4206,8,-1,335,283,52
BR1_2729222363,10,False,0,0,0,18617,205,44,6.8,True,9,True,1,0,0,18793,214,68,7.2,False,29.31051666666667,-176,1,-1,249,282,-33
BR1_2731916807,12,True,1,0,0,17903,174,58,6.6,True,8,False,0,1,0,16384,187,42,6.4,False,26.60905,1519,4,1,232,229,3
BR1_2725880929,9,True,1,0,0,17697,198,56,6.8,False,4,False,0,1,0,15626,221,56,7.0,True,26.333233333333332,2071,5,1,254,277,-23
BR1_2731201709,4,True,0,0,0,16316,213,64,7.2,False,7,False,1,0,0,17343,227,48,7.2,True,28.898983333333334,-1027,-3,-1,277,275,2
BR1_2731070094,14,True,1,0,0,20755,193,63,7.0,True,11,False,0,0,0,18776,206,52,7.6,False,28.12565,1979,3,1,256,258,-2
BR1_2727474752,9,True,1,0,0,20796,288,52,7.6,True,5,False,0,0,0,16873,230,52,7.2,False,28.915816666666668,3923,4,1,340,282,58
BR1_2727397373,6,True,0,0,0,15306,195,40,6.6,False,11,False,1,0,0,18600,216,66,7.0,True,27.318933333333334,-3294,-5,-1,235,282,-47
BR1_2715156519,5,False,0,1,0,17605,208,68,7.2,False,11,True,1,0,0,20885,240,64,7.8,True,28.7017,-3280,-6,-1,276,304,-28
BR1_2715141917,0,False,0,0,0,13357,203,63,7.0,False,8,True,0,0,0,16695,216,31,7.0,True,26.01055,-3338,-8,0,266,247,19
BR1_2731612899,7,True,1,1,0,16470,196,64,7.2,True,4,False,0,0,0,14994,214,40,6.8,False,25.213066666666666,1476,3,1,260,254,6
BR1_2729966732,9,True,0,0,0,16728,186,31,6.8,False,5,False,0,1,0,16925,229,60,7.2,True,26.364566666666665,-197,4,0,217,289,-72
BR1_2731578529,7,True,0,0,0,16924,206,48,6.8,True,6,False,0,0,0,15133,172,51,6.8,False,25.046633333333332,1791,1,0,254,223,31
BR1_2731533948,5,True,0,0,0,15168,191,52,7.0,True,7,False,0,0,0,16357,176,52,6.6,False,26.0462,-1189,-2,0,243,228,15
BR1_2730030571,11,True,1,1,0,21428,247,76,7.8,True,8,False,0,0,0,16216,169,46,6.6,False,27.870383333333333,5212,3,1,323,215,108
BR1_2721476751,15,True,0,0,0,18935,146,44,7.0,True,9,False,0,0,0,16925,177,36,6.6,False,26.151866666666667,2010,6,0,190,213,-23
BR1_2721228350,12,False,1,1,1,21915,238,56,7.6,True,9,True,0,0,0,17542,198,44,7.2,False,28.308433333333333,4373,3,1,294,242,52
BR1_2731854343,10,True,0,0,0,18030,212,41,7.0,True,2,False,0,0,0,14199,187,62,6.4,False,27.003316666666667,3831,8,0,253,249,4
BR1_2731824265,9,False,1,0,0,19936,256,60,7.4,True,4,True,0,0,0,17714,253,52,7.2,False,28.60225,2222,5,1,316,305,11
BR1_2709940364,15,False,1,0,0,19626,175,40,6.6,True,9,True,0,0,0,17353,198,38,6.4,False,25.360283333333335,2273,6,1,215,236,-21
BR1_2731231081,15,False,1,1,0,21334,229,60,7.2,True,11,True,0,0,0,20360,188,68,7.8,False,27.725683333333333,974,4,1,289,256,33
BR1_2731174530,12,False,0,1,2,22877,260,60,7.8,False,6,True,1,0,0,17708,220,73,7.2,True,27.825566666666667,5169,6,-1,320,293,27
BR1_2731098932,7,True,1,0,0,18233,226,52,7.4,False,7,False,0,0,0,18288,234,52,7.4,True,28.49535,-55,0,1,278,286,-8
BR1_2727511777,5,False,1,0,0,16594,219,71,7.2,False,11,True,0,0,0,19929,232,58,7.6,True,27.622683333333335,-3335,-6,1,290,290,0
BR1_2727489566,6,False,0,0,0,15659,232,44,6.6,False,8,True,1,1,0,17743,202,60,6.8,True,26.20255,-2084,-2,-1,276,262,14
BR1_2668128946,8,True,0,1,0,18593,189,48,7.6,True,6,False,1,0,0,17709,248,68,7.4,False,28.93245,884,2,-1,237,316,-79
BR1_2730082532,16,True,1,1,0,23292,202,67,7.4,True,12,False,0,0,0,18847,180,52,6.8,False,27.988466666666667,4445,4,1,269,232,37
BR1_2726149627,7,False,1,0,0,15512,190,48,6.8,False,6,True,0,0,0,17224,211,32,6.8,True,26.837083333333332,-1712,1,1,238,243,-5
BR1_2718768177,19,True,1,1,0,23243,150,69,7.2,False,12,False,0,0,0,19311,155,51,6.6,True,27.75935,3932,7,1,219,206,13
BR1_2730232530,9,False,0,1,0,18918,238,56,7.4,True,6,True,1,0,0,16856,219,56,6.8,False,29.05895,2062,3,-1,294,275,19
BR1_2665489694,7,False,0,0,0,17715,235,50,7.2,True,6,True,1,0,0,16026,202,60,7.0,False,25.104533333333332,1689,1,-1,285,262,23
BR1_2665223725,8,False,0,0,0,16795,179,52,7.0,False,5,True,1,0,0,15731,187,40,6.4,True,27.22223333333333,1064,3,-1,231,227,4
BR1_2664308644,2,False,0,0,0,14799,201,56,7.2,False,13,True,1,0,0,21076,237,56,8.0,True,28.0112,-6277,-11,-1,257,293,-36
BR1_2731341252,5,False,0,0,0,17140,228,72,7.6,True,7,True,1,0,0,17729,235,56,7.6,False,28.30875,-589,-2,-1,300,291,9
BR1_2730538611,9,True,0,0,0,17019,138,44,6.0,False,12,False,1,1,0,19396,196,56,7.0,True,26.6094,-2377,-3,-1,182,252,-70
BR1_2731604647,4,False,0,1,0,16324,208,52,7.0,False,11,True,1,0,0,18974,225,52,7.2,True,27.94483333333333,-2650,-7,-1,260,277,-17
BR1_2731444766,3,False,0,0,0,13762,175,20,6.6,False,14,True,0,0,0,20329,194,55,7.0,True,25.53475,-6567,-11,0,195,249,-54
BR1_2731434545,4,False,1,0,0,16648,224,56,6.8,False,7,True,0,1,1,20228,238,76,7.4,True,27.686066666666665,-3580,-3,1,280,314,-34
BR1_2731041315,7,False,1,0,0,17481,204,44,7.2,True,7,True,0,0,0,17012,183,56,7.0,False,28.317383333333332,469,0,1,248,239,9
BR1_2731002032,3,False,0,0,0,14440,189,52,6.4,False,8,True,1,0,0,15966,190,65,7.0,True,27.37526666666667,-1526,-5,-1,241,255,-14
BR1_2728150142,8,True,0,0,0,18167,239,57,7.2,False,5,False,1,1,0,18632,254,70,7.4,True,27.7134,-465,3,-1,296,324,-28
BR1_2730739819,7,True,1,0,0,16177,202,48,7.0,False,7,False,0,0,0,17904,219,68,7.2,True,26.0433,-1727,0,1,250,287,-37
BR1_2730338949,3,False,0,0,0,14006,164,48,6.2,False,12,True,1,1,0,19512,206,56,7.0,True,25.782916666666665,-5506,-9,-1,212,262,-50
BR1_2729376587,10,True,1,0,0,19081,199,63,7.0,True,6,False,0,0,0,16636,182,44,7.2,False,29.058083333333332,2445,4,1,262,226,36
BR1_2729815217,9,False,0,0,0,18431,236,42,7.0,False,13,True,1,0,0,20501,208,72,7.4,True,27.799883333333334,-2070,-4,-1,278,280,-2
BR1_2729807519,13,False,1,1,0,21871,250,76,8.0,True,9,True,0,0,0,18009,197,47,7.2,False,27.623666666666665,3862,4,1,326,244,82
BR1_2729792605,2,False,0,0,0,14767,197,72,6.8,False,4,True,1,1,0,16014,208,72,7.0,True,25.96885,-1247,-2,-1,269,280,-11
BR1_2729778735,3,False,1,0,0,14819,183,68,6.8,True,7,True,0,0,0,16407,190,48,6.8,False,26.606983333333332,-1588,-4,1,251,238,13
BR1_2725222333,7,False,1,0,0,16834,210,71,7.2,False,7,True,0,0,0,17970,241,48,7.0,True,25.168683333333334,-1136,0,1,281,289,-8
BR1_2730287376,13,True,0,1,0,20942,239,52,7.4,True,7,False,0,0,0,18020,208,59,7.2,False,28.7063,2922,6,0,291,267,24
BR1_2729738091,7,True,0,0,0,18862,232,56,7.4,True,10,False,0,0,0,18810,238,52,7.4,False,29.21935,52,-3,0,288,290,-2
BR1_2731845667,6,True,0,1,0,18996,267,76,7.8,False,7,False,1,0,0,18358,245,72,7.6,True,29.128983333333334,638,-1,-1,343,317,26
BR1_2731809930,6,False,1,1,0,16383,202,52,7.0,True,4,True,0,0,0,15428,220,60,6.8,False,27.419016666666668,955,2,1,254,280,-26
BR1_2729588576,9,False,1,1,0,17149,175,46,7.2,False,4,True,0,0,0,17029,210,61,7.2,True,29.868216666666665,120,5,1,221,271,-50
BR1_2727925096,7,True,0,1,0,16846,194,48,6.8,True,3,False,0,0,0,14461,198,38,6.6,False,26.98135,2385,4,0,242,236,6
BR1_2729690080,9,True,1,0,0,20008,247,68,7.6,False,5,False,0,1,0,17466,250,56,7.2,True,29.184166666666666,2542,4,1,315,306,9
BR1_2731666593,2,True,1,0,0,14581,217,52,6.8,True,6,False,0,0,0,15246,178,56,6.8,False,26.331866666666667,-665,-4,1,269,234,35
BR1_2731190775,11,True,0,0,0,18345,174,51,6.8,True,10,False,0,0,0,17006,167,44,6.2,False,26.028266666666667,1339,1,0,225,211,14
BR1_2731571647,6,False,1,0,0,17328,223,53,7.4,True,7,True,0,0,0,18114,245,54,7.6,False,27.6815,-786,-1,1,276,299,-23
BR1_2731276931,8,True,1,0,0,16482,154,60,6.6,False,11,False,0,0,0,18915,224,24,6.6,True,26.582516666666667,-2433,-3,1,214,248,-34
BR1_2730177687,4,True,0,0,0,14657,175,52,6.6,False,8,False,0,0,0,17009,210,48,6.8,True,27.199266666666666,-2352,-4,0,227,258,-31
BR1_2694277307,6,True,0,1,0,18141,221,70,7.4,True,3,False,1,0,0,16329,229,65,7.2,False,29.9166,1812,3,-1,291,294,-3
BR1_2694246426,7,False,1,0,0,16806,198,44,6.8,False,13,True,0,1,1,20063,204,56,7.2,True,27.011366666666667,-3257,-6,1,242,260,-18
BR1_2730759483,14,True,0,1,0,22462,276,68,7.6,True,8,False,1,0,0,17756,206,40,7.2,False,28.265133333333335,4706,6,-1,344,246,98
BR1_2731633822,9,True,0,0,0,16865,182,42,6.8,False,8,False,0,0,0,17931,220,48,7.0,True,25.2067,-1066,1,0,224,268,-44
BR1_2731245059,10,True,0,1,0,20318,238,72,7.6,True,7,False,1,0,0,17666,218,56,7.2,False,29.669166666666666,2652,3,-1,310,274,36
BR1_2730532408,6,True,1,0,0,16379,196,48,6.6,False,4,False,0,0,0,14270,196,44,6.6,True,27.484116666666665,2109,2,1,244,240,4
BR1_2730520395,3,False,0,0,0,14811,222,50,6.8,False,4,True,1,0,0,15937,237,56,7.0,True,25.565466666666666,-1126,-1,-1,272,293,-21
BR1_2731140428,4,True,0,0,0,17345,255,68,7.4,False,5,False,0,0,0,16810,234,44,7.2,True,28.5583,535,-1,0,323,278,45
BR1_2731649468,5,True,1,0,0,16793,205,64,7.6,True,6,False,0,0,0,18517,251,58,7.6,False,27.699033333333333,-1724,-1,1,269,309,-40
BR1_2731528451,3,False,0,1,0,18204,282,76,7.4,False,12,True,1,0,0,20475,247,60,7.6,True,29.720416666666665,-2271,-9,-1,358,307,51
BR1_2731578388,19,True,1,0,1,24985,250,51,7.6,True,3,False,0,0,0,14986,166,48,6.8,False,29.023083333333332,9999,16,1,301,214,87
BR1_2674348051,9,True,0,0,0,17850,209,48,7.4,True,10,False,0,0,0,17475,214,48,6.8,False,25.085516666666667,375,-1,0,257,262,-5
BR1_2673792983,9,False,0,0,0,19538,222,56,7.4,False,7,True,1,0,0,17131,202,51,7.0,True,29.821616666666667,2407,2,-1,278,253,25
BR1_2710911605,12,True,1,1,0,22039,254,64,7.6,True,5,False,0,0,0,16994,215,68,7.4,False,29.4025,5045,7,1,318,283,35
BR1_2690681051,1,False,0,1,0,14695,222,56,6.8,False,4,True,1,0,0,15921,218,60,6.8,True,26.92135,-1226,-3,-1,278,278,0
BR1_2730019866,3,False,0,0,0,15515,209,54,6.8,False,11,True,1,1,1,20961,215,48,7.4,True,28.99185,-5446,-8,-1,263,263,0
BR1_2731843358,6,False,0,1,0,16937,209,51,7.0,True,7,True,1,0,0,16884,187,56,6.6,False,27.29565,53,-1,-1,260,243,17
BR1_2731749227,13,True,0,0,0,20178,216,52,7.4,False,11,False,0,1,0,19785,213,64,7.4,True,27.7128,393,2,0,268,277,-9
BR1_2731107087,5,False,0,0,0,16940,228,56,7.2,False,5,True,1,1,0,18842,287,60,7.4,True,28.414116666666665,-1902,0,-1,284,347,-63
BR1_2730182627,8,True,1,1,0,20795,248,64,7.4,True,9,False,0,0,0,18137,192,76,7.8,False,27.964916666666667,2658,-1,1,312,268,44
BR1_2731613370,8,False,1,0,0,17343,183,51,7.0,False,12,True,0,0,0,20189,208,52,7.2,True,28.5599,-2846,-4,1,234,260,-26
BR1_2718086596,6,False,0,0,0,16380,191,40,6.6,False,16,True,0,1,0,21029,190,64,7.2,True,27.400783333333333,-4649,-10,0,231,254,-23
BR1_2694884114,6,True,1,0,0,16511,211,60,6.8,True,7,False,0,0,0,16501,192,64,7.0,False,27.2701,10,-1,1,271,256,15
BR1_2724153195,5,False,0,0,0,17487,227,60,7.8,False,8,True,0,0,0,18612,230,60,7.4,True,29.795083333333334,-1125,-3,0,287,290,-3
BR1_2727536728,9,True,0,1,0,20191,216,56,7.2,True,7,False,1,0,0,17554,228,48,7.2,False,28.925866666666668,2637,2,-1,272,276,-4
BR1_2727512505,8,False,0,0,0,18348,208,68,7.4,False,9,True,1,1,0,18378,198,56,7.4,True,28.52788333333333,-30,-1,-1,276,254,22
BR1_2730706459,10,True,1,0,0,19213,230,56,7.0,True,7,False,0,0,0,16247,192,44,6.6,False,25.890033333333335,2966,3,1,286,236,50
BR1_2730681586,5,False,0,0,0,17527,224,52,7.2,True,6,True,0,0,0,17135,225,60,7.2,False,27.858316666666667,392,-1,0,276,285,-9
BR1_2731319611,7,False,0,0,0,15815,187,56,7.2,True,10,True,1,0,0,18492,206,72,7.2,False,26.109,-2677,-3,-1,243,278,-35
BR1_2731645429,3,False,0,0,0,16712,242,44,7.2,True,7,True,1,0,0,18316,238,64,7.8,False,27.59723333333333,-1604,-4,-1,286,302,-16
BR1_2731782763,6,True,0,1,0,17474,239,50,7.0,True,5,False,1,0,0,15214,198,60,7.0,False,26.002666666666666,2260,1,-1,289,258,31
BR1_2711957162,16,True,1,0,0,21917,241,60,7.4,True,4,False,0,0,0,16380,202,56,6.8,False,29.784,5537,12,1,301,258,43
BR1_2710286795,6,True,0,0,0,15991,196,53,6.6,False,7,False,1,1,0,16773,177,69,7.2,True,26.936466666666668,-782,-1,-1,249,246,3
BR1_2708124429,4,True,0,1,0,16722,210,46,6.6,False,11,False,1,0,0,17535,161,40,6.8,True,28.249833333333335,-813,-7,-1,256,201,55
BR1_2699458636,6,True,0,1,0,16983,201,58,7.0,True,3,False,1,0,0,16049,234,48,7.2,False,27.771483333333332,934,3,-1,259,282,-23
BR1_2721719434,3,False,0,0,0,14858,186,56,6.4,True,4,True,0,1,0,15560,212,54,6.8,False,25.563283333333334,-702,-1,0,242,266,-24
BR1_2731823312,7,False,0,0,0,16353,167,56,7.4,False,8,True,1,0,0,18652,231,43,7.0,True,28.179516666666668,-2299,-1,-1,223,274,-51
BR1_2731697363,11,True,1,0,0,20860,240,73,7.4,True,5,False,0,1,0,17670,224,38,7.2,False,29.181716666666667,3190,6,1,313,262,51
BR1_2726006601,3,False,0,0,0,15464,220,52,7.0,False,7,True,1,1,0,17697,221,52,7.0,True,25.533783333333332,-2233,-4,-1,272,273,-1
BR1_2680601771,8,True,0,0,0,19827,271,68,7.4,True,1,False,1,0,0,14920,209,68,7.2,False,29.32555,4907,7,-1,339,277,62
BR1_2728712068,12,False,0,1,0,19104,204,60,7.2,True,5,True,0,0,0,15781,198,51,6.6,False,25.562516666666667,3323,7,0,264,249,15
BR1_2727517743,6,True,0,1,0,16638,205,52,7.0,True,5,False,1,0,0,14854,176,72,6.8,False,27.395366666666668,1784,1,-1,257,248,9
BR1_2682452423,4,False,0,0,0,16150,235,40,7.4,False,10,True,1,0,0,19740,210,100,8.0,True,29.133633333333332,-3590,-6,-1,275,310,-35
BR1_2714785243,5,False,0,1,0,17852,214,53,7.2,False,6,True,1,0,0,17233,237,54,7.2,True,28.639433333333333,619,-1,-1,267,291,-24
BR1_2715730807,6,False,0,0,0,16304,213,60,7.0,True,3,True,0,0,0,14755,203,51,6.6,False,25.689333333333334,1549,3,0,273,254,19
BR1_2715686682,3,False,0,0,0,14717,168,52,6.2,False,11,True,0,0,0,19200,218,52,6.8,True,25.95243333333333,-4483,-8,0,220,270,-50
BR1_2715665384,7,True,1,1,0,18330,251,64,7.4,True,4,False,0,0,0,15436,218,40,7.0,False,27.042833333333334,2894,3,1,315,258,57
BR1_2730830876,2,False,1,0,0,15969,252,60,7.4,True,6,True,0,1,0,18088,278,52,7.6,False,27.5261,-2119,-4,1,312,330,-18
BR1_2729218049,2,False,0,0,0,15305,215,75,7.0,False,6,True,1,0,0,15202,169,48,6.2,True,26.925416666666667,103,-4,-1,290,217,73
BR1_2699446992,9,True,1,0,0,19344,245,64,7.6,True,5,False,0,0,0,16580,192,68,7.2,False,29.040616666666665,2764,4,1,309,260,49
BR1_2731164047,6,False,0,1,0,17507,219,60,7.2,True,8,True,1,0,0,19281,276,72,7.6,False,29.913333333333334,-1774,-2,-1,279,348,-69
BR1_2687614566,5,False,0,1,0,17219,218,71,7.4,False,5,True,1,0,0,17424,238,72,7.6,True,27.670233333333332,-205,0,-1,289,310,-21
BR1_2687566680,4,True,0,1,0,13557,146,48,6.2,False,10,False,1,0,0,19027,187,44,6.8,True,25.800916666666666,-5470,-6,-1,194,231,-37
BR1_2729830632,9,True,0,0,0,17122,179,45,6.4,True,8,False,0,0,0,17463,229,39,6.8,False,26.670116666666665,-341,1,0,224,268,-44
BR1_2729361096,12,True,0,0,0,20951,262,56,7.6,True,7,False,1,1,0,19217,206,76,7.2,False,28.264966666666666,1734,5,-1,318,282,36
BR1_2731459153,7,True,0,0,0,15663,164,55,6.8,False,10,False,1,0,0,17035,192,48,6.6,True,25.35905,-1372,-3,-1,219,240,-21
BR1_2731326863,6,False,0,1,0,16151,205,52,6.8,False,6,True,1,0,0,15996,190,48,6.8,True,27.481,155,0,-1,257,238,19
BR1_2720615363,5,True,1,1,0,18007,220,56,7.0,True,10,False,0,0,0,20030,222,64,7.6,False,28.41655,-2023,-5,1,276,286,-10
BR1_2731474948,7,True,0,0,0,17111,176,68,6.8,False,7,False,1,0,0,18315,220,76,7.4,True,28.44735,-1204,0,-1,244,296,-52
BR1_2731429835,10,False,1,0,1,20358,234,50,7.2,True,10,True,0,0,0,19525,217,50,7.0,False,28.811233333333334,833,0,1,284,267,17
BR1_2714412054,15,True,0,0,0,22083,244,56,7.6,True,8,False,1,0,0,18945,207,56,7.4,False,28.866333333333333,3138,7,-1,300,263,37
BR1_2711783845,6,False,1,0,0,16629,205,68,6.8,True,3,True,0,0,0,15432,204,56,6.6,False,26.760883333333332,1197,3,1,273,260,13
BR1_2681325452,9,False,1,0,0,18620,198,60,7.4,False,8,True,0,1,0,19009,240,64,7.4,True,29.70093333333333,-389,1,1,258,304,-46
BR1_2681249635,12,False,1,0,0,19998,201,56,7.4,True,10,True,0,0,0,19565,212,60,7.6,False,29.646916666666666,433,2,1,257,272,-15
BR1_2728944351,10,False,1,0,0,17208,179,48,6.8,True,5,True,0,1,0,17168,206,64,7.0,False,25.012916666666666,40,5,1,227,270,-43
BR1_2723201582,10,True,1,0,0,19386,227,56,7.2,True,8,False,0,0,0,17208,187,56,7.2,False,29.3734,2178,2,1,283,243,40
BR1_2731568687,7,True,1,0,0,16634,184,64,7.2,False,7,False,0,1,0,17486,209,56,7.2,True,27.75035,-852,0,1,248,265,-17
BR1_2715804480,4,False,1,0,0,15594,215,64,7.0,True,6,True,0,0,0,16171,195,48,6.6,False,25.042916666666667,-577,-2,1,279,243,36
BR1_2715781063,7,False,1,1,0,16903,197,47,6.8,True,10,True,0,0,0,18602,221,43,7.0,False,27.447266666666668,-1699,-3,1,244,264,-20
BR1_2731822441,10,False,1,0,0,19316,241,50,7.2,False,14,True,0,1,1,22883,261,56,7.8,True,28.4809,-3567,-4,1,291,317,-26
BR1_2729415122,5,True,1,0,0,15903,218,48,6.8,True,8,False,0,0,0,16835,185,44,6.4,False,26.3014,-932,-3,1,266,229,37
BR1_2729358705,11,False,1,1,0,19922,199,72,7.4,True,5,True,0,0,0,17982,245,64,7.0,False,27.50305,1940,6,1,271,309,-38
BR1_2731215938,12,False,0,0,0,19547,233,66,7.4,True,10,True,0,0,0,18577,218,48,7.4,False,27.513633333333335,970,2,0,299,266,33
BR1_2728638386,10,True,0,1,1,17992,187,40,7.2,True,3,False,0,0,0,14408,195,48,6.4,False,26.180883333333334,3584,7,0,227,243,-16
BR1_2728633087,17,True,0,0,0,19354,155,36,6.6,True,5,False,0,0,0,15515,189,52,6.4,False,26.284316666666665,3839,12,0,191,241,-50
BR1_2693216762,7,False,0,1,0,18344,233,60,7.4,False,8,True,1,0,0,19137,247,72,7.6,True,29.611666666666668,-793,-1,-1,293,319,-26
BR1_2729082099,8,False,0,0,0,18815,252,51,7.4,False,9,True,0,0,0,18520,228,46,7.2,True,28.229133333333333,295,-1,0,303,274,29
BR1_2729057080,3,False,0,0,0,15453,201,48,7.2,False,14,True,1,1,0,20774,228,52,7.4,True,28.739583333333332,-5321,-11,-1,249,280,-31
BR1_2730098157,3,True,1,0,0,15842,221,44,6.8,False,10,False,0,1,0,19446,234,63,7.2,True,28.687133333333332,-3604,-7,1,265,297,-32
BR1_2730049524,5,True,0,0,0,15692,215,55,7.0,True,4,False,1,0,0,14729,184,52,6.8,False,25.5853,963,1,-1,270,236,34
BR1_2722522764,6,True,0,0,0,17531,210,60,7.0,True,12,False,0,0,0,20007,184,49,7.2,False,29.8683,-2476,-6,0,270,233,37
BR1_2718791771,4,True,1,1,0,15885,221,56,6.8,True,7,False,0,0,0,17665,243,44,7.0,False,25.51275,-1780,-3,1,277,287,-10
BR1_2722360524,8,True,0,0,0,17579,210,48,7.2,False,7,False,1,0,0,17841,255,52,7.2,True,27.935866666666666,-262,1,-1,258,307,-49
BR1_2729537990,6,True,1,1,0,18253,234,68,7.0,True,5,False,0,0,0,15972,198,52,7.0,False,29.906333333333333,2281,1,1,302,250,52
BR1_2726693169,2,False,0,0,0,14708,199,44,6.4,False,8,True,1,1,0,16635,202,56,6.4,True,25.541066666666666,-1927,-6,-1,243,258,-15
BR1_2715219137,5,True,1,0,0,15576,158,52,7.2,True,4,False,0,0,0,14435,188,47,6.6,False,26.420283333333334,1141,1,1,210,235,-25
BR1_2715179143,4,False,1,0,0,16115,200,64,7.0,False,9,True,0,1,0,19379,219,57,7.8,True,29.055716666666665,-3264,-5,1,264,276,-12
BR1_2715163150,7,True,1,0,0,15891,206,48,6.8,True,1,False,0,0,0,13770,201,52,6.4,False,25.817516666666666,2121,6,1,254,253,1
BR1_2699802111,5,False,0,0,0,17726,241,55,7.2,False,5,True,1,0,0,17318,227,72,7.0,True,29.285933333333332,408,0,-1,296,299,-3
BR1_2681915184,7,False,1,0,0,17673,212,56,7.0,True,6,True,0,0,0,17437,253,40,7.4,False,29.50615,236,1,1,268,293,-25
BR1_2692521668,7,True,1,0,0,18163,204,54,6.8,True,2,False,0,0,0,14687,224,60,7.0,False,25.948266666666665,3476,5,1,258,284,-26
BR1_2731576429,10,False,0,0,0,18078,188,60,6.8,True,9,True,0,0,0,15985,176,44,6.4,False,26.231716666666667,2093,1,0,248,220,28
BR1_2731547303,4,True,1,1,0,15543,200,68,6.8,False,6,False,0,0,0,16655,210,60,6.8,True,25.2601,-1112,-2,1,268,270,-2
BR1_2728813645,6,True,0,0,0,16690,210,40,6.8,False,9,False,0,1,0,19244,207,60,7.2,True,28.37875,-2554,-3,0,250,267,-17
BR1_2731328061,5,True,0,0,0,17317,222,56,7.2,False,5,False,1,1,0,17616,215,56,7.4,True,29.247583333333335,-299,0,-1,278,271,7
BR1_2716084158,7,False,1,0,0,17601,208,52,7.2,True,6,True,0,0,0,17164,241,56,7.2,False,28.909116666666666,437,1,1,260,297,-37
BR1_2730631537,8,False,1,0,0,18488,200,68,7.0,True,4,True,0,1,0,17019,251,52,7.2,False,27.533683333333332,1469,4,1,268,303,-35
BR1_2731595853,4,False,0,0,0,15435,213,61,6.8,True,4,True,1,0,0,15087,204,54,6.8,False,25.811366666666668,348,0,-1,274,258,16
BR1_2731494483,6,False,0,1,0,18231,221,58,7.4,True,6,True,1,0,0,18939,218,78,7.6,False,29.17095,-708,0,-1,279,296,-17
BR1_2730625516,7,True,1,0,0,19594,279,55,7.6,True,2,False,0,1,0,16108,211,80,7.4,False,29.507633333333334,3486,5,1,334,291,43
BR1_2731044072,3,True,0,0,0,15279,202,52,6.6,False,5,False,1,1,0,15646,177,68,7.0,True,27.236166666666666,-367,-2,-1,254,245,9
BR1_2712728413,4,False,0,0,0,16179,227,52,7.2,False,8,True,1,1,0,18910,251,68,7.6,True,28.590633333333333,-2731,-4,-1,279,319,-40
BR1_2729434094,5,False,1,0,0,16942,206,47,7.2,True,6,True,0,0,0,15290,170,60,6.8,False,25.8956,1652,-1,1,253,230,23
BR1_2728925471,11,True,1,1,1,22095,258,56,7.8,True,4,False,0,0,0,16652,210,64,7.4,False,28.700583333333334,5443,7,1,314,274,40
BR1_2731435891,6,False,0,0,0,16744,204,60,6.8,False,14,True,1,0,0,20600,214,68,7.8,True,29.5208,-3856,-8,-1,264,282,-18
BR1_2731407515,7,False,0,0,0,16815,200,44,7.2,True,9,True,0,1,0,18017,206,56,7.0,False,27.077216666666665,-1202,-2,0,244,262,-18
BR1_2715857631,5,True,0,0,0,17609,229,76,7.2,False,8,False,1,1,0,19448,218,59,7.6,True,29.55835,-1839,-3,-1,305,277,28
BR1_2715118583,8,True,0,0,0,17489,208,60,7.0,True,7,False,1,0,0,16519,202,59,6.8,False,27.2652,970,1,-1,268,261,7
BR1_2731339386,5,True,1,0,0,18090,208,52,7.2,True,8,False,0,0,0,18457,219,48,7.2,False,29.6192,-367,-3,1,260,267,-7
BR1_2730349738,10,True,0,0,0,17156,173,52,6.6,False,8,False,1,1,0,18275,205,56,7.0,True,25.711016666666666,-1119,2,-1,225,261,-36
BR1_2731770650,3,False,0,0,0,16569,232,56,7.2,True,4,True,0,0,0,18230,265,60,7.4,False,28.2918,-1661,-1,0,288,325,-37
BR1_2731631416,8,True,0,0,0,17286,192,40,6.4,True,11,False,0,0,1,19131,180,52,6.8,False,25.170116666666665,-1845,-3,0,232,232,0
BR1_2731070034,12,True,1,0,0,20203,223,63,7.2,True,5,False,0,0,0,17616,257,39,7.0,False,27.623183333333333,2587,7,1,286,296,-10
BR1_2731034617,13,True,1,0,0,17446,190,52,7.2,True,2,False,0,1,0,13903,183,61,6.8,False,25.54025,3543,11,1,242,244,-2
BR1_2731021657,7,True,0,0,0,16744,202,44,6.8,False,10,False,1,1,0,17693,175,68,6.8,True,25.184166666666666,-949,-3,-1,246,243,3
BR1_2731774338,13,False,0,0,0,20098,206,56,7.2,False,8,True,1,0,0,18055,203,64,7.2,True,29.778083333333335,2043,5,-1,262,267,-5
BR1_2731746102,13,True,0,1,0,20426,194,52,7.0,True,13,False,1,0,0,19311,171,56,7.4,False,28.640533333333334,1115,0,-1,246,227,19
BR1_2731138632,3,True,1,0,0,14185,203,48,6.4,True,3,False,0,0,0,13758,191,48,6.4,False,26.552033333333334,427,0,1,251,239,12
BR1_2731135282,4,True,0,1,0,14722,169,58,6.6,False,9,False,1,0,0,16501,194,56,6.8,True,27.466283333333333,-1779,-5,-1,227,250,-23
BR1_2725152887,8,False,0,0,0,17360,192,56,6.6,False,13,True,1,0,0,21029,224,52,7.4,True,29.35195,-3669,-5,-1,248,276,-28
BR1_2723715373,5,False,0,0,0,15437,179,40,6.4,False,8,True,0,1,0,17364,190,44,6.6,True,27.1618,-1927,-3,0,219,234,-15
BR1_2687138504,10,False,0,0,0,16729,180,32,6.8,True,12,True,0,1,0,18107,172,48,6.6,False,25.1508,-1378,-2,0,212,220,-8
BR1_2686638992,10,False,1,0,0,18651,233,48,7.2,False,8,True,0,0,0,19054,226,67,7.2,True,28.50485,-403,2,1,281,293,-12
BR1_2730832522,8,True,0,1,0,17012,178,52,6.6,True,7,False,1,0,0,16042,159,44,6.8,False,26.622083333333332,970,1,-1,230,203,27
BR1_2729500545,6,True,0,0,0,15804,215,60,6.8,False,4,False,1,1,0,15755,221,52,7.0,True,27.18965,49,2,-1,275,273,2
BR1_2731553344,6,False,1,0,0,15480,183,40,6.4,False,13,True,0,0,0,19821,180,60,7.0,True,26.94386666666667,-4341,-7,1,223,240,-17
BR1_2731317855,9,False,0,1,0,20178,266,54,7.6,True,3,True,1,0,0,16282,223,66,7.6,False,29.122133333333334,3896,6,-1,320,289,31
BR1_2731292732,7,True,0,0,0,16093,191,38,6.6,False,5,False,0,0,0,16053,216,56,7.0,True,26.658483333333333,40,2,0,229,272,-43
BR1_2731272351,10,False,1,1,0,19706,216,71,7.8,True,5,True,0,0,0,17185,251,40,7.2,False,28.121716666666668,2521,5,1,287,291,-4
BR1_2730761647,7,True,0,0,0,16108,184,36,6.6,False,11,False,1,0,0,18649,205,62,6.8,True,25.859016666666665,-2541,-4,-1,220,267,-47
BR1_2730569538,8,False,0,0,0,19477,246,56,7.6,False,7,True,1,1,0,17474,200,68,7.4,True,29.221566666666668,2003,1,-1,302,268,34
BR1_2731789731,4,True,1,0,0,15439,202,64,6.6,True,5,False,0,0,0,15169,213,56,7.0,False,25.12076666666667,270,-1,1,266,269,-3
BR1_2731729239,12,False,0,0,0,21997,261,72,7.8,True,9,True,0,0,0,19548,219,60,7.4,False,28.7505,2449,3,0,333,279,54
BR1_2731680406,14,True,1,0,0,20353,240,54,7.6,True,1,False,0,0,0,15317,207,68,6.8,False,27.515166666666666,5036,13,1,294,275,19
BR1_2731662630,6,False,1,0,0,17369,197,56,7.4,False,4,True,0,1,0,16719,204,72,7.4,True,28.151583333333335,650,2,1,253,276,-23
BR1_2731582788,6,False,0,0,0,16976,209,52,7.0,False,6,True,1,0,0,17371,210,56,6.8,True,28.10585,-395,0,-1,261,266,-5
BR1_2701992456,5,False,0,1,0,17066,207,62,7.0,False,7,True,1,0,0,18133,234,50,7.2,True,28.661216666666668,-1067,-2,-1,269,284,-15
BR1_2730782360,4,False,0,0,0,17926,271,59,7.6,False,4,True,1,1,0,18271,274,72,7.6,True,28.433183333333332,-345,0,-1,330,346,-16
BR1_2713577270,10,False,0,0,0,16019,127,32,6.2,False,11,True,1,0,0,18373,207,56,6.8,True,25.070783333333335,-2354,-1,-1,159,263,-104
BR1_2694557126,7,True,1,1,0,17473,190,80,7.6,True,2,False,0,0,0,15815,209,56,7.4,False,29.973666666666666,1658,5,1,270,265,5
BR1_2694501764,10,True,0,0,0,17791,183,51,7.2,False,9,False,0,0,0,18665,202,44,7.4,True,28.1468,-874,1,0,234,246,-12
BR1_2700352210,12,False,0,0,0,19975,230,68,7.2,False,9,True,0,1,0,17936,171,48,6.4,True,25.16225,2039,3,0,298,219,79
BR1_2700176153,7,True,0,0,0,17336,196,56,7.2,False,9,False,1,0,0,20486,265,76,7.8,True,27.589466666666667,-3150,-2,-1,252,341,-89
BR1_2722718624,10,False,0,0,0,16126,184,44,6.6,True,9,True,0,1,0,17958,182,52,6.8,False,27.45318333333333,-1832,1,0,228,234,-6
BR1_2721105771,9,False,1,0,0,17726,207,52,7.0,True,6,True,0,0,1,18261,210,64,7.2,False,28.11915,-535,3,1,259,274,-15
BR1_2717654658,4,False,1,1,0,16913,246,48,7.4,True,4,True,0,0,0,16363,222,56,7.2,False,29.05045,550,0,1,294,278,16
BR1_2717585336,4,False,0,0,0,14913,194,52,6.8,False,10,True,0,0,0,18719,231,48,7.0,True,25.35975,-3806,-6,0,246,279,-33
BR1_2730174052,5,False,1,0,0,15759,216,48,6.8,True,5,True,0,0,0,15593,214,52,6.8,False,26.949033333333333,166,0,1,264,266,-2
BR1_2709898881,2,False,0,0,0,14147,177,64,6.6,True,4,True,1,1,0,15914,210,56,7.2,False,27.325433333333333,-1767,-2,-1,241,266,-25
BR1_2716825419,1,False,0,0,0,13827,198,44,6.8,False,3,True,0,1,0,15079,197,48,6.6,True,25.59075,-1252,-2,0,242,245,-3
BR1_2705157948,8,True,1,1,0,16493,159,64,6.4,False,9,False,0,0,0,18693,203,48,6.6,True,25.475816666666667,-2200,-1,1,223,251,-28
BR1_2731784413,10,True,1,0,0,16901,183,52,6.4,True,6,False,0,0,0,15900,196,48,6.4,False,26.497466666666668,1001,4,1,235,244,-9
BR1_2698268450,3,True,0,0,0,15278,208,47,6.6,True,4,False,0,0,0,15294,236,52,7.0,False,26.337083333333332,-16,-1,0,255,288,-33
BR1_2723392873,2,False,0,0,0,15568,236,52,7.2,False,6,True,1,0,0,17922,243,80,7.4,True,28.04315,-2354,-4,-1,288,323,-35
BR1_2731248373,4,True,0,0,0,15514,239,52,6.6,False,7,False,0,0,0,15865,204,56,6.8,True,27.466716666666667,-351,-3,0,291,260,31
BR1_2704569404,9,True,0,0,0,19091,185,56,7.4,False,5,False,1,0,0,18197,234,68,7.4,True,29.650983333333333,894,4,-1,241,302,-61
BR1_2728611520,7,True,0,0,0,15262,176,36,6.6,True,5,False,0,0,0,14094,169,32,6.4,False,26.962583333333335,1168,2,0,212,201,11
BR1_2731910313,5,True,1,1,0,16974,180,63,7.0,False,10,False,0,0,0,19012,223,57,7.4,True,28.122866666666667,-2038,-5,1,243,280,-37
BR1_2731127704,7,False,0,0,0,16492,221,39,7.0,False,5,True,1,0,0,15238,190,52,6.8,True,27.19333333333333,1254,2,-1,260,242,18
BR1_2730590043,7,False,0,1,0,15656,149,48,6.8,True,15,True,1,0,0,19789,217,36,7.2,False,27.93395,-4133,-8,-1,197,253,-56
BR1_2731557647,5,True,1,0,0,14177,136,52,6.4,False,7,False,0,0,0,16230,199,56,6.8,True,25.744316666666666,-2053,-2,1,188,255,-67
BR1_2731544305,6,False,1,0,0,16099,210,52,6.8,False,5,True,0,0,0,16313,216,56,7.0,True,27.163483333333332,-214,1,1,262,272,-10
BR1_2730206441,13,True,0,1,0,19634,198,44,6.8,True,4,False,1,0,0,15575,221,52,6.6,False,26.862283333333334,4059,9,-1,242,273,-31
BR1_2729927538,18,True,1,0,0,21713,207,64,7.8,True,6,False,0,1,0,16404,200,52,6.8,False,27.7117,5309,12,1,271,252,19
BR1_2729917052,6,True,0,0,0,15009,173,38,6.2,False,16,False,1,0,0,20261,220,62,7.4,True,25.43045,-5252,-10,-1,211,282,-71
BR1_2727139859,7,False,0,0,0,16698,188,40,6.8,False,7,True,0,0,0,17811,201,64,7.2,True,27.943366666666666,-1113,0,0,228,265,-37
BR1_2729278077,8,False,1,1,0,19417,219,68,7.6,True,5,True,0,0,0,16247,187,60,7.4,False,28.168333333333333,3170,3,1,287,247,40
BR1_2729257751,6,True,0,0,0,14285,115,48,6.0,False,12,False,1,0,0,18617,211,60,7.2,True,27.20415,-4332,-6,-1,163,271,-108
BR1_2729248397,4,False,1,1,0,16262,213,52,7.2,False,7,True,0,0,0,18336,211,48,7.4,True,29.768983333333335,-2074,-3,1,265,259,6
BR1_2729986938,14,False,0,0,0,18678,174,44,6.4,True,10,True,1,0,0,17163,153,56,6.6,False,25.113733333333332,1515,4,-1,218,209,9
BR1_2708288680,9,False,0,1,0,19739,216,72,7.6,False,14,True,1,0,0,20229,198,56,7.4,True,28.058583333333335,-490,-5,-1,288,254,34
BR1_2706200575,8,True,0,0,0,19064,223,48,7.4,False,6,False,1,0,0,17218,215,76,7.2,True,28.278916666666667,1846,2,-1,271,291,-20
BR1_2705552938,5,True,0,0,0,17886,259,64,7.4,False,8,False,1,1,0,19456,227,64,8.0,True,28.2613,-1570,-3,-1,323,291,32
BR1_2731515183,8,True,1,1,0,18614,222,55,7.6,True,5,False,0,0,0,17318,223,58,7.2,False,29.443933333333334,1296,3,1,277,281,-4
BR1_2731448688,6,False,0,0,0,16272,176,42,6.6,True,9,True,0,1,0,17894,173,40,6.8,False,29.545466666666666,-1622,-3,0,218,213,5
BR1_2727829121,9,True,0,0,0,17531,187,52,7.0,False,10,False,1,1,0,19766,215,44,7.8,True,28.557466666666667,-2235,-1,-1,239,259,-20
BR1_2721354047,3,False,1,0,0,15803,227,58,7.4,True,3,True,0,1,0,16351,237,61,7.2,False,28.3161,-548,0,1,285,298,-13
BR1_2731003439,8,False,0,0,1,19363,244,55,7.6,False,12,True,1,1,0,21881,223,54,7.4,True,28.445766666666668,-2518,-4,-1,299,277,22
BR1_2731187440,10,True,0,0,0,18209,224,44,7.6,True,9,False,0,0,0,19003,225,60,7.6,False,28.244316666666666,-794,1,0,268,285,-17
BR1_2730206896,5,False,0,0,0,15703,210,56,7.0,False,6,True,0,0,0,17447,231,48,6.8,True,25.0217,-1744,-1,0,266,279,-13
BR1_2729882953,6,False,0,0,0,17381,234,52,7.2,False,7,True,1,0,0,18531,235,68,7.6,True,27.631916666666665,-1150,-1,-1,286,303,-17
BR1_2731721176,5,True,0,0,0,15704,167,48,6.6,False,12,False,1,0,0,18481,222,52,7.0,True,26.056316666666667,-2777,-7,-1,215,274,-59
BR1_2727567792,13,True,0,0,0,21424,265,52,7.6,True,5,False,1,0,0,16140,186,68,7.2,False,27.709,5284,8,-1,317,254,63
BR1_2727541913,10,True,1,0,0,19147,227,55,7.2,True,6,False,0,1,0,17505,218,68,7.2,False,28.880516666666665,1642,4,1,282,286,-4
BR1_2731432571,9,True,0,0,0,18907,190,52,6.8,False,13,False,1,0,0,20127,210,50,7.4,True,29.1221,-1220,-4,-1,242,260,-18
BR1_2731764490,8,True,1,0,0,18525,211,48,7.2,True,2,False,0,1,0,16079,235,55,7.2,False,29.4901,2446,6,1,259,290,-31
BR1_2731691159,3,False,0,0,0,15231,191,60,7.0,False,6,True,0,1,0,17971,243,67,7.6,True,27.878783333333335,-2740,-3,0,251,310,-59
BR1_2720535296,11,False,0,1,1,20008,201,47,7.4,False,11,True,1,0,0,21015,199,57,7.2,True,29.50195,-1007,0,-1,248,256,-8
BR1_2719752181,11,True,0,1,0,19192,206,64,7.6,True,7,False,1,0,0,17342,187,42,6.8,False,28.128033333333335,1850,4,-1,270,229,41
BR1_2731719088,7,False,1,0,0,18015,194,72,7.4,True,4,True,0,0,0,15723,156,60,7.0,False,27.9799,2292,3,1,266,216,50
BR1_2731682979,6,True,1,0,0,16247,164,72,6.6,True,4,False,0,0,0,17086,206,56,7.0,False,27.54435,-839,2,1,236,262,-26
BR1_2731317052,10,False,0,1,0,17846,170,48,7.2,True,5,True,0,0,0,15113,211,44,6.6,False,25.133983333333333,2733,5,0,218,255,-37
BR1_2730369691,14,True,0,0,0,21999,221,60,7.6,False,15,False,1,0,0,19938,194,48,6.8,True,28.677083333333332,2061,-1,-1,281,242,39
BR1_2730359707,3,False,0,0,0,15902,218,64,7.2,False,7,True,0,1,0,17886,214,52,7.4,True,27.511816666666668,-1984,-4,0,282,266,16
BR1_2727939921,6,False,1,0,0,18019,244,76,7.2,False,7,True,0,0,0,18014,221,64,7.2,True,29.552383333333335,5,-1,1,320,285,35
BR1_2730903595,11,True,1,1,0,17568,173,56,6.6,True,6,False,0,0,0,15529,169,52,6.4,False,25.7697,2039,5,1,229,221,8
BR1_2726297041,6,True,1,0,0,18261,256,61,7.4,False,5,False,0,0,1,18137,247,52,7.0,True,28.91036666666667,124,1,1,317,299,18
BR1_2725388180,12,True,0,1,0,18589,204,56,7.0,True,5,False,1,0,0,14292,145,36,6.0,False,26.224033333333335,4297,7,-1,260,181,79
BR1_2702255401,4,False,0,1,0,17352,216,56,7.4,False,8,True,1,0,0,17746,225,56,7.4,True,29.97335,-394,-4,-1,272,281,-9
BR1_2702224192,6,True,0,0,0,17288,215,48,7.4,False,8,False,0,1,0,19293,222,48,7.6,True,28.003633333333333,-2005,-2,0,263,270,-7
BR1_2731041631,8,False,0,1,0,18017,209,52,7.6,False,11,True,1,0,0,20455,248,44,7.2,True,29.15935,-2438,-3,-1,261,292,-31
BR1_2731290617,7,False,0,0,0,15568,164,56,6.4,False,10,True,1,1,0,17162,184,48,6.4,True,27.463816666666666,-1594,-3,-1,220,232,-12
BR1_2730867618,6,True,1,0,0,17846,226,68,7.4,True,2,False,0,0,0,15610,236,72,7.0,False,27.793166666666668,2236,4,1,294,308,-14
BR1_2729340440,4,False,1,0,0,14924,162,42,6.6,False,10,True,0,1,0,17941,195,57,7.0,True,26.343833333333333,-3017,-6,1,204,252,-48
BR1_2727537186,7,True,1,0,0,17227,203,72,7.2,True,3,False,0,0,0,15182,202,44,7.2,False,28.531866666666666,2045,4,1,275,246,29
BR1_2731505358,5,True,0,0,0,15776,208,60,7.0,False,5,False,1,0,0,15904,219,60,6.8,True,27.322566666666667,-128,0,-1,268,279,-11
BR1_2716550887,9,False,0,1,0,19162,222,50,7.2,True,7,True,1,0,0,18305,230,73,7.2,False,29.23975,857,2,-1,272,303,-31
BR1_2724053554,7,False,0,1,0,17017,209,44,6.8,False,12,True,1,0,0,19422,230,56,7.2,True,25.026233333333334,-2405,-5,-1,253,286,-33
BR1_2730797790,12,False,0,1,0,19469,200,52,7.2,True,7,True,0,0,0,17853,212,52,7.4,False,29.666316666666667,1616,5,0,252,264,-12
BR1_2730784043,3,False,0,0,0,15886,212,59,6.6,True,5,True,0,0,0,15925,189,41,6.8,False,26.017733333333332,-39,-2,0,271,230,41
BR1_2730238059,6,True,0,1,0,17204,218,48,6.8,True,8,False,1,0,0,17201,173,48,6.8,False,26.533566666666665,3,-2,-1,266,221,45
BR1_2728879044,10,True,1,0,0,18949,236,54,7.0,True,5,False,0,0,0,16979,188,48,6.8,False,29.586983333333333,1970,5,1,290,236,54
BR1_2731334736,9,True,0,0,0,19019,212,68,7.4,False,8,False,1,1,0,19046,224,60,7.4,True,27.63385,-27,1,-1,280,284,-4
BR1_2730913190,5,True,1,0,0,16599,216,56,6.8,True,4,False,0,0,0,14626,191,52,7.0,False,25.36005,1973,1,1,272,243,29
BR1_2689956954,8,True,1,0,0,16718,183,44,6.6,True,5,False,0,0,0,14724,155,56,6.6,False,26.6129,1994,3,1,227,211,16
BR1_2689937863,8,True,1,0,0,16424,207,56,7.0,False,7,False,0,0,0,16835,227,40,7.0,True,25.979816666666668,-411,1,1,263,267,-4
BR1_2727701264,6,False,0,0,0,15746,211,60,6.8,False,4,True,1,1,0,16008,203,44,6.8,True,25.190466666666666,-262,2,-1,271,247,24
BR1_2715663874,3,True,0,1,0,15338,197,56,6.6,True,8,False,0,0,0,16658,195,60,7.0,False,25.311216666666667,-1320,-5,0,253,255,-2
BR1_2709483332,4,True,1,1,1,18338,227,60,7.2,True,6,False,0,0,0,16636,184,63,7.4,False,28.854416666666665,1702,-2,1,287,247,40
BR1_2722463588,8,True,1,0,0,18572,221,60,7.2,True,9,False,0,0,0,18433,218,55,7.2,False,28.82046666666667,139,-1,1,281,273,8
BR1_2714562912,10,False,0,0,0,18725,214,55,7.2,False,11,True,0,0,0,20436,260,64,7.4,True,29.7892,-1711,-1,0,269,324,-55
BR1_2712961563,8,False,0,0,0,18481,231,56,7.6,True,8,True,1,1,0,18855,189,60,7.4,False,29.8047,-374,0,-1,287,249,38
BR1_2731000021,11,False,1,0,0,20362,230,68,7.6,True,11,True,0,1,0,20196,235,56,7.4,False,27.590883333333334,166,0,1,298,291,7
BR1_2730741402,5,True,0,1,0,17963,215,64,6.8,False,8,False,1,0,0,17758,202,76,7.4,True,28.111383333333333,205,-3,-1,279,278,1
BR1_2730708672,7,True,0,0,0,18775,245,60,7.4,True,7,False,1,0,0,18250,238,68,7.2,False,28.6329,525,0,-1,305,306,-1
BR1_2703222398,8,True,0,0,0,16232,182,52,6.4,True,10,False,1,0,0,18820,185,52,6.6,False,26.8717,-2588,-2,-1,234,237,-3
BR1_2702920842,7,False,1,0,0,18539,242,64,6.8,True,9,True,0,0,0,18783,228,44,7.2,False,29.635083333333334,-244,-2,1,306,272,34
BR1_2702365891,8,True,1,0,0,18476,240,60,7.4,False,4,False,0,1,0,16696,216,59,7.4,True,27.768633333333334,1780,4,1,300,275,25
BR1_2731788724,10,True,0,0,0,18418,218,48,7.2,True,6,False,1,0,0,16600,219,48,7.2,False,27.988616666666665,1818,4,-1,266,267,-1
BR1_2731769179,2,True,1,0,0,13662,187,52,6.4,False,8,False,0,0,0,17183,191,50,6.8,True,25.590883333333334,-3521,-6,1,239,241,-2
BR1_2730181546,8,True,1,0,0,15754,158,41,6.0,False,5,False,0,0,0,14731,170,54,6.4,True,27.40965,1023,3,1,199,224,-25
BR1_2731376262,10,True,0,0,0,19609,253,68,7.6,True,5,False,1,0,0,16538,246,44,7.0,False,29.51605,3071,5,-1,321,290,31
BR1_2731482290,6,False,0,0,0,15942,186,60,6.8,False,5,True,1,0,0,16123,207,60,6.8,True,25.322333333333333,-181,1,-1,246,267,-21
BR1_2728438456,6,False,0,0,0,15804,205,51,6.8,False,8,True,1,1,0,17235,192,52,7.2,True,25.785166666666665,-1431,-2,-1,256,244,12
BR1_2697336413,5,True,0,0,0,17500,190,48,7.0,False,9,False,1,0,0,19004,197,56,7.4,True,28.05455,-1504,-4,-1,238,253,-15
BR1_2724798617,3,False,0,1,0,13874,147,48,5.8,False,7,True,1,0,0,18216,215,56,7.0,True,26.058916666666665,-4342,-4,-1,195,271,-76
BR1_2729711831,7,False,0,0,0,16940,169,54,6.8,False,9,True,1,0,0,18928,257,68,7.4,True,28.77075,-1988,-2,-1,223,325,-102
BR1_2729362051,9,True,0,1,0,18362,221,44,6.8,False,5,False,1,0,0,15143,197,48,6.4,True,25.634933333333333,3219,4,-1,265,245,20
BR1_2729338531,9,True,1,0,0,16714,216,48,7.0,True,6,False,0,1,0,16904,212,63,7.2,False,25.640116666666668,-190,3,1,264,275,-11
BR1_2731644848,9,True,1,0,0,18434,241,48,7.6,True,4,False,0,0,0,16001,229,60,7.0,False,29.15225,2433,5,1,289,289,0
BR1_2730735991,2,False,0,0,0,14471,211,44,6.6,False,8,True,0,1,0,18344,172,68,7.0,True,26.9513,-3873,-6,0,255,240,15
BR1_2716715202,7,True,1,0,0,17334,240,49,6.8,True,2,False,0,0,0,15189,217,60,6.8,False,26.728683333333333,2145,5,1,289,277,12
BR1_2731111562,6,True,1,1,0,18176,212,59,7.4,True,6,False,0,0,0,17922,248,60,7.2,False,27.598983333333333,254,0,1,271,308,-37
BR1_2731052362,11,False,1,1,0,18643,187,64,7.0,True,10,True,0,0,0,16829,164,48,6.4,False,26.3737,1814,1,1,251,212,39
BR1_2731644653,7,True,1,0,0,15325,186,56,6.6,True,4,False,0,0,0,14581,175,44,7.0,False,26.606866666666665,744,3,1,242,219,23
BR1_2731461097,8,True,1,0,0,18648,265,56,7.2,True,7,False,0,1,0,17327,213,68,7.2,False,28.602233333333334,1321,1,1,321,281,40
BR1_2730978225,10,False,0,0,0,19790,221,60,7.6,False,8,True,1,1,0,18534,247,68,7.6,True,27.61175,1256,2,-1,281,315,-34
BR1_2728917918,8,False,1,1,0,16673,185,56,6.8,True,1,True,0,0,0,14959,227,59,7.0,False,27.086816666666667,1714,7,1,241,286,-45
BR1_2731693260,6,False,0,0,0,14372,148,47,7.0,False,6,True,1,0,0,16545,215,56,7.0,True,25.76615,-2173,0,-1,195,271,-76
BR1_2728803582,5,True,1,0,0,14927,199,48,6.4,False,9,False,0,0,0,16891,185,48,7.0,True,26.5671,-1964,-4,1,247,233,14
BR1_2731060306,7,True,0,0,0,17177,221,48,7.4,False,1,False,1,1,0,15766,230,64,7.2,True,29.565883333333332,1411,6,-1,269,294,-25
BR1_2731043576,7,False,0,0,0,15447,175,40,6.4,False,11,True,1,0,0,17712,192,64,7.0,True,25.737883333333333,-2265,-4,-1,215,256,-41
BR1_2729634395,9,True,1,0,0,17670,227,52,7.0,True,3,False,0,0,0,14603,173,64,6.8,False,26.90735,3067,6,1,279,237,42
BR1_2730078121,3,False,0,0,0,13733,173,48,6.6,False,9,True,1,1,0,17499,202,72,7.0,True,26.405366666666666,-3766,-6,-1,221,274,-53
BR1_2715362399,4,False,0,0,0,15989,181,58,7.2,False,9,True,1,1,0,19607,227,56,7.4,True,27.965216666666667,-3618,-5,-1,239,283,-44
BR1_2731820234,5,True,0,0,0,15122,175,48,6.6,False,7,False,0,0,0,16882,212,48,7.0,True,26.11245,-1760,-2,0,223,260,-37
BR1_2729157055,10,True,1,1,0,18866,223,57,7.2,True,6,False,0,0,0,15736,178,50,6.4,False,26.535683333333335,3130,4,1,280,228,52
BR1_2727574255,10,False,1,0,0,17419,171,52,6.6,False,7,True,0,0,0,17476,242,42,7.2,True,29.11765,-57,3,1,223,284,-61
BR1_2719399604,9,False,0,1,1,17850,174,48,6.8,False,13,True,1,0,0,22396,250,50,7.4,True,29.184866666666668,-4546,-4,-1,222,300,-78
BR1_2719336950,7,True,1,1,0,16576,200,56,6.6,True,6,False,0,0,0,14719,177,40,6.2,False,26.1345,1857,1,1,256,217,39
BR1_2725406057,10,True,1,0,0,19721,239,68,7.8,True,5,False,0,1,0,17220,241,68,7.8,False,28.821483333333333,2501,5,1,307,309,-2
BR1_2725403550,9,True,1,1,0,18184,199,68,6.8,True,3,False,0,0,0,13938,176,52,6.2,False,26.023183333333332,4246,6,1,267,228,39
BR1_2720124868,7,False,0,0,0,16185,159,48,6.6,True,11,True,1,0,0,17859,186,63,7.2,False,27.10385,-1674,-4,-1,207,249,-42
BR1_2718071129,14,False,1,0,0,21825,262,60,7.6,True,11,True,0,0,0,20386,207,48,7.0,False,27.603416666666668,1439,3,1,322,255,67
BR1_2718029020,5,True,0,1,0,17689,185,44,7.2,False,11,False,1,0,0,18532,209,56,7.2,True,28.782683333333335,-843,-6,-1,229,265,-36
BR1_2717933140,8,True,0,0,0,16638,179,48,6.8,False,8,False,0,0,0,15605,144,60,6.4,True,26.112366666666667,1033,0,0,227,204,23
BR1_2730021566,6,True,0,0,0,17935,226,43,7.0,False,6,False,0,1,0,17429,196,56,7.2,True,27.575483333333334,506,0,0,269,252,17
BR1_2731435589,8,True,0,1,0,19306,227,64,7.6,False,7,False,0,0,0,18472,245,60,7.4,True,29.141966666666665,834,1,0,291,305,-14
BR1_2731430204,9,False,1,0,0,18730,212,68,7.4,False,6,True,0,1,0,18180,233,72,7.6,True,29.494183333333332,550,3,1,280,305,-25
BR1_2731416784,3,False,0,0,0,13805,164,47,6.2,False,10,True,1,0,0,18120,210,52,6.8,True,25.610533333333333,-4315,-7,-1,211,262,-51
BR1_2731059998,12,True,0,1,0,20351,244,39,7.2,False,11,False,0,0,0,20638,226,64,7.2,True,29.164433333333335,-287,1,0,283,290,-7
BR1_2731684332,7,True,1,0,0,17874,223,44,7.0,True,4,False,0,0,0,16631,223,68,7.0,False,29.475933333333334,1243,3,1,267,291,-24
BR1_2728236500,8,True,0,0,0,16879,207,36,6.6,True,2,False,0,0,0,13203,157,48,6.6,False,26.65185,3676,6,0,243,205,38
BR1_2714832269,7,True,0,0,0,18189,233,63,7.4,True,10,False,1,1,0,19495,216,52,7.2,False,29.455883333333333,-1306,-3,-1,296,268,28
BR1_2714260093,3,False,0,0,0,15322,193,52,6.8,False,7,True,1,0,0,18114,217,80,7.6,True,28.38383333333333,-2792,-4,-1,245,297,-52
BR1_2713626600,12,False,1,1,0,20686,205,72,7.4,True,6,True,0,0,0,17218,210,53,7.2,False,29.290233333333333,3468,6,1,277,263,14
BR1_2730440245,7,True,1,1,0,16648,198,60,7.0,True,2,False,0,0,0,14001,189,48,6.6,False,27.1438,2647,5,1,258,237,21
BR1_2717469169,9,True,1,0,0,18738,247,60,7.6,False,4,False,0,0,0,16943,207,72,7.4,True,27.718983333333334,1795,5,1,307,279,28
BR1_2731880418,14,True,1,0,0,19847,211,52,6.8,True,9,False,0,0,0,16014,169,40,6.2,False,26.44525,3833,5,1,263,209,54
BR1_2731875425,6,True,0,0,0,17351,207,45,7.2,True,7,False,1,0,0,17196,195,50,7.0,False,29.345816666666668,155,-1,-1,252,245,7
BR1_2719739152,7,True,0,1,0,17727,182,56,7.4,True,10,False,1,0,0,18579,204,52,7.4,False,29.681016666666668,-852,-3,-1,238,256,-18
BR1_2726380873,9,True,1,0,0,18412,239,55,7.4,True,5,False,0,0,0,17708,230,36,7.0,False,28.878333333333334,704,4,1,294,266,28
BR1_2731542328,6,False,0,0,0,17781,212,63,7.6,False,6,True,1,1,0,18582,216,64,7.8,True,29.99005,-801,0,-1,275,280,-5
BR1_2731035211,10,False,1,1,0,17291,188,56,6.6,True,9,True,0,0,0,16049,156,44,6.4,False,27.211983333333333,1242,1,1,244,200,44
BR1_2730874654,3,False,0,0,0,15212,201,65,7.0,False,7,True,1,0,0,18003,242,70,7.4,True,29.032633333333333,-2791,-4,-1,266,312,-46
BR1_2727217086,15,True,1,0,0,22580,240,56,7.4,True,4,False,0,0,0,14847,153,44,6.6,False,28.87095,7733,11,1,296,197,99
BR1_2730251236,4,True,0,0,0,16012,240,44,7.0,False,6,False,1,1,0,18548,227,64,7.4,True,28.713916666666666,-2536,-2,-1,284,291,-7
BR1_2729852949,10,True,0,0,0,16960,199,40,6.8,True,4,False,1,1,0,16116,199,68,6.8,False,26.658483333333333,844,6,-1,239,267,-28
BR1_2728935898,7,True,0,0,0,16814,200,56,6.8,False,9,False,1,0,0,17780,190,60,7.2,True,27.436866666666667,-966,-2,-1,256,250,6
BR1_2731857808,14,True,1,0,1,21859,218,60,7.6,True,2,False,0,0,0,15286,211,68,7.2,False,27.9964,6573,12,1,278,279,-1
BR1_2731825679,8,False,1,1,0,17586,189,40,6.8,False,13,True,0,0,0,18619,209,44,7.0,True,25.264533333333333,-1033,-5,1,229,253,-24
BR1_2691003973,16,True,1,1,0,21345,215,55,7.4,True,8,False,0,0,0,19188,243,64,7.2,False,28.677883333333334,2157,8,1,270,307,-37
BR1_2731768938,11,True,1,1,0,20501,281,56,7.6,True,1,False,0,0,0,16148,258,63,7.2,False,28.969116666666668,4353,10,1,337,321,16
BR1_2730756308,10,False,0,0,0,17084,209,52,6.6,False,6,True,0,0,0,16239,172,60,6.4,True,27.088566666666665,845,4,0,261,232,29
BR1_2728945899,8,False,1,1,0,19639,225,72,7.4,False,6,True,0,0,0,17386,229,52,7.4,True,29.9699,2253,2,1,297,281,16
BR1_2731356410,7,False,1,0,0,18152,211,48,7.2,True,9,True,0,0,0,18290,169,68,7.2,False,28.559966666666668,-138,-2,1,259,237,22
BR1_2731342926,4,False,0,0,0,15832,232,40,7.0,False,6,True,1,0,0,15743,219,56,7.0,True,25.004083333333334,89,-2,-1,272,275,-3
BR1_2730039072,4,False,0,0,0,15079,176,56,6.8,False,9,True,0,1,0,20701,248,84,7.8,True,29.789516666666668,-5622,-5,0,232,332,-100
BR1_2730105018,6,False,0,0,0,17382,211,54,6.8,False,13,True,1,0,0,21627,262,53,7.6,True,29.140833333333333,-4245,-7,-1,265,315,-50
BR1_2731827009,9,True,1,0,0,18041,211,44,6.8,True,10,False,0,0,0,16478,172,48,6.6,False,25.249933333333335,1563,-1,1,255,220,35
BR1_2731799905,9,False,0,1,1,19064,164,60,7.0,False,11,True,1,0,0,20292,246,52,7.4,True,28.33985,-1228,-2,-1,224,298,-74
BR1_2731631911,7,False,0,0,0,15317,170,52,7.0,True,6,True,0,0,0,16057,201,64,7.0,False,25.5243,-740,1,0,222,265,-43
BR1_2731243361,6,False,1,0,0,16595,205,48,6.8,True,5,True,0,0,0,14985,200,44,6.8,False,26.67275,1610,1,1,253,244,9
BR1_2731219155,7,True,0,1,0,19405,253,68,7.6,True,1,False,1,0,0,14617,216,52,7.4,False,27.963333333333335,4788,6,-1,321,268,53
BR1_2717851742,12,True,0,1,0,18862,203,52,7.0,True,3,False,0,0,0,14864,172,63,6.6,False,25.165033333333334,3998,9,0,255,235,20
BR1_2717840470,7,False,0,0,0,18102,209,60,7.2,False,12,True,1,1,0,20174,180,71,7.4,True,28.83665,-2072,-5,-1,269,251,18
BR1_2717828165,6,True,0,0,0,17449,204,62,7.2,False,7,False,0,0,0,17219,231,52,7.4,True,28.063666666666666,230,-1,0,266,283,-17
BR1_2731917797,8,False,0,0,0,18412,210,67,7.8,True,9,True,1,0,0,18763,222,68,7.4,False,28.9421,-351,-1,-1,277,290,-13
BR1_2731245682,12,False,0,0,0,17644,164,40,6.4,False,8,True,0,0,0,17033,194,52,6.4,True,25.248683333333332,611,4,0,204,246,-42
BR1_2729799454,5,True,0,0,0,16701,183,68,7.2,True,8,False,1,0,0,17725,219,49,7.4,False,29.907183333333332,-1024,-3,-1,251,268,-17
BR1_2729759479,8,False,0,0,0,17211,216,44,7.4,False,6,True,0,0,0,17397,213,60,7.4,True,27.608416666666667,-186,2,0,260,273,-13
BR1_2730738374,9,False,1,1,0,16557,186,56,6.8,True,6,True,0,0,0,15639,201,43,6.8,False,26.847483333333333,918,3,1,242,244,-2
BR1_2728317167,6,False,1,0,0,16797,200,44,7.2,True,8,True,0,0,0,18565,238,48,7.4,False,29.943266666666666,-1768,-2,1,244,286,-42
BR1_2729942662,9,True,1,0,0,19390,258,57,7.6,False,9,False,0,1,0,19505,219,80,7.6,True,29.41855,-115,0,1,315,299,16
BR1_2729924784,8,True,0,0,0,18077,208,68,7.4,True,5,False,1,0,0,16761,194,56,6.8,False,28.038433333333334,1316,3,-1,276,250,26
BR1_2727768503,10,True,0,0,0,19484,248,68,7.6,False,10,False,1,0,0,19425,183,72,7.2,True,29.607283333333335,59,0,-1,316,255,61
BR1_2725392374,7,False,1,0,0,18431,235,56,7.6,True,4,True,0,1,0,16193,219,60,7.4,False,29.688916666666668,2238,3,1,291,279,12
BR1_2722018067,8,False,0,0,0,17567,201,44,7.0,False,15,True,1,1,0,21992,230,72,7.6,True,28.59745,-4425,-7,-1,245,302,-57
BR1_2723943630,7,False,1,0,0,17407,184,30,6.8,False,13,True,0,0,0,19900,199,76,7.8,True,27.720666666666666,-2493,-6,1,214,275,-61
BR1_2726240002,14,True,0,0,0,21740,198,48,7.0,True,9,False,1,1,0,17866,190,60,7.2,False,29.647933333333334,3874,5,-1,246,250,-4
BR1_2726197695,6,False,0,0,0,16553,220,56,6.6,False,5,True,0,0,0,15626,206,72,6.8,True,25.987183333333334,927,1,0,276,278,-2
BR1_2727484720,4,True,1,0,0,14991,199,51,6.6,True,4,False,0,1,0,15190,186,47,6.6,False,26.32755,-199,0,1,250,233,17
BR1_2715261753,12,True,0,0,0,20493,194,52,7.0,False,7,False,0,0,0,16542,161,52,6.8,True,29.528866666666666,3951,5,0,246,213,33
BR1_2719001894,10,True,0,0,0,17795,176,76,7.0,True,3,False,1,0,0,14348,171,51,6.6,False,27.118066666666667,3447,7,-1,252,222,30
BR1_2718982151,7,True,0,0,0,16124,208,44,6.6,False,8,False,1,0,0,16306,208,52,6.6,True,27.295666666666666,-182,-1,-1,252,260,-8
BR1_2729817238,6,False,0,0,0,16649,185,44,6.4,False,9,True,0,0,0,17072,205,44,7.0,True,26.09005,-423,-3,0,229,249,-20
BR1_2729813258,4,False,1,1,0,14023,145,56,6.6,False,6,True,0,0,0,16008,202,58,7.0,True,25.5746,-1985,-2,1,201,260,-59
BR1_2730026221,4,False,0,1,0,16083,225,52,7.4,False,5,True,0,0,0,17149,279,47,7.6,True,27.680183333333332,-1066,-1,0,277,326,-49
BR1_2731406097,0,False,0,1,0,13776,197,64,7.4,False,4,True,1,0,0,16225,211,48,7.2,True,27.54355,-2449,-4,-1,261,259,2
BR1_2731597198,6,True,0,0,0,15895,206,28,7.4,False,5,False,1,1,0,17681,233,87,7.6,True,28.557333333333332,-1786,1,-1,234,320,-86
BR1_2730647859,5,False,1,0,0,16293,203,48,7.0,False,5,True,0,1,0,17811,221,60,7.6,True,28.718733333333333,-1518,0,1,251,281,-30
BR1_2729092254,3,False,0,1,0,15665,198,56,7.2,False,9,True,0,0,0,18532,222,48,7.4,True,27.642033333333334,-2867,-6,0,254,270,-16
BR1_2730934973,6,False,1,0,0,16221,199,68,7.2,True,5,True,0,0,0,15373,217,52,6.8,False,27.458716666666668,848,1,1,267,269,-2
BR1_2731740381,4,False,0,0,0,14801,172,53,6.4,False,8,True,0,0,0,17109,230,48,6.8,True,25.690016666666665,-2308,-4,0,225,278,-53
BR1_2730623086,10,False,0,1,0,19882,264,56,7.6,True,8,True,1,0,0,18790,225,52,7.4,False,28.728666666666665,1092,2,-1,320,277,43
BR1_2731567102,8,False,1,0,0,16363,193,37,6.8,True,4,True,0,0,0,14139,178,27,6.0,False,25.283166666666666,2224,4,1,230,205,25
BR1_2731554149,9,False,1,1,0,17359,176,44,6.8,True,6,True,0,0,0,16011,197,56,6.6,False,27.449183333333334,1348,3,1,220,253,-33
BR1_2731507491,10,False,1,0,0,17733,193,48,7.0,True,6,True,0,0,0,16153,195,52,6.6,False,25.099516666666666,1580,4,1,241,247,-6
BR1_2726068079,9,False,0,0,0,16898,171,35,6.6,False,11,True,1,1,0,19909,200,76,7.4,True,28.18335,-3011,-2,-1,206,276,-70
BR1_2723475842,5,True,1,1,0,16795,227,52,7.2,True,3,False,0,0,0,15135,193,71,7.4,False,27.520233333333334,1660,2,1,279,264,15
BR1_2728052136,13,True,1,0,0,19024,192,60,6.8,True,2,False,0,0,0,13638,175,40,6.0,False,27.086583333333333,5386,11,1,252,215,37
BR1_2710024234,8,False,0,0,0,17063,195,52,6.4,True,7,True,0,0,0,17759,194,36,6.8,False,29.76905,-696,1,0,247,230,17
BR1_2705945175,3,True,0,0,0,16139,205,76,7.0,True,5,False,1,0,0,14465,179,44,7.0,False,26.83855,1674,-2,-1,281,223,58
BR1_2705624575,9,False,1,0,0,17919,195,48,7.2,False,12,True,0,0,0,20616,221,66,7.4,True,29.927266666666668,-2697,-3,1,243,287,-44
BR1_2730724410,5,False,1,0,0,15826,186,48,7.0,True,1,True,0,0,0,13145,174,52,6.6,False,25.071866666666665,2681,4,1,234,226,8
BR1_2728168027,8,True,0,1,0,19258,266,66,8.0,True,3,False,1,0,0,16060,234,56,7.2,False,29.160966666666667,3198,5,-1,332,290,42
BR1_2695326970,8,True,0,0,0,17070,204,39,6.8,False,6,False,1,0,0,15917,202,64,6.6,True,27.253866666666667,1153,2,-1,243,266,-23
BR1_2696176452,6,False,0,0,0,15728,181,36,6.8,False,8,True,1,0,0,15667,192,52,6.8,True,25.713216666666668,61,-2,-1,217,244,-27
BR1_2731296516,6,True,1,0,0,17201,214,68,7.2,True,3,False,0,0,0,15660,247,48,6.6,False,26.4689,1541,3,1,282,295,-13
BR1_2731267723,10,False,1,0,0,18807,184,54,7.2,False,16,True,0,0,0,20480,207,40,7.2,True,28.197866666666666,-1673,-6,1,238,247,-9
BR1_2729891215,5,False,0,0,0,14799,172,60,6.4,False,5,True,0,0,0,16055,210,48,6.8,True,26.05765,-1256,0,0,232,258,-26
BR1_2719330287,6,True,0,0,0,16530,205,48,6.8,True,6,False,0,0,0,15874,191,54,6.8,False,25.1197,656,0,0,253,245,8
BR1_2730653310,10,True,1,0,0,18395,214,49,7.2,True,4,False,0,1,0,14729,187,62,7.0,False,26.919033333333335,3666,6,1,263,249,14
BR1_2730615467,4,False,1,0,0,17127,238,80,7.2,True,8,True,0,1,0,18531,219,60,7.6,False,29.98115,-1404,-4,1,318,279,39
BR1_2731118956,6,False,0,0,0,16071,213,43,6.8,True,6,True,0,1,0,16509,207,56,6.8,False,25.699916666666667,-438,0,0,256,263,-7
BR1_2731105118,8,False,0,1,2,21132,224,71,7.8,False,9,True,1,0,0,19068,217,58,7.2,True,27.85515,2064,-1,-1,295,275,20
BR1_2731307735,13,True,1,1,0,21481,226,73,7.6,True,5,False,0,0,0,15178,181,52,7.0,False,29.0773,6303,8,1,299,233,66
BR1_2730541229,9,True,0,0,0,18651,206,60,6.8,True,6,False,0,0,0,15674,167,51,6.8,False,25.881283333333332,2977,3,0,266,218,48
BR1_2723918400,9,False,1,1,0,19075,226,48,7.2,True,10,True,0,0,0,18940,232,60,7.6,False,28.251733333333334,135,-1,1,274,292,-18
BR1_2723796326,4,False,1,0,0,15107,179,59,6.6,False,6,True,0,0,0,15671,184,45,6.8,True,27.367766666666668,-564,-2,1,238,229,9
BR1_2720796028,10,False,0,0,0,17713,208,56,6.8,False,6,True,1,1,0,17302,213,56,7.0,True,25.3157,411,4,-1,264,269,-5
BR1_2731638225,7,True,1,0,0,17930,230,56,6.8,True,5,False,0,0,0,16483,177,44,6.6,False,28.532833333333333,1447,2,1,286,221,65
BR1_2715164541,10,False,0,0,0,17757,189,36,7.2,True,9,True,0,0,0,18551,207,60,7.2,False,28.768716666666666,-794,1,0,225,267,-42
BR1_2715148519,4,False,0,0,0,14743,225,44,6.8,False,9,True,1,0,0,17007,200,56,7.0,True,26.8681,-2264,-5,-1,269,256,13
BR1_2674593377,8,False,1,0,0,17362,194,64,7.0,True,6,True,0,0,0,15870,162,52,6.6,False,26.639033333333334,1492,2,1,258,214,44
BR1_2731126141,3,False,0,0,0,15912,237,52,6.6,False,12,True,1,0,0,18776,230,60,7.2,True,26.813133333333333,-2864,-9,-1,289,290,-1
BR1_2730362164,7,True,0,0,0,17168,204,52,6.6,False,7,False,0,0,0,16886,232,56,6.8,True,26.692783333333335,282,0,0,256,288,-32
BR1_2731840289,5,False,0,0,0,17094,205,64,7.4,False,7,True,1,0,0,18728,251,44,7.6,True,29.427,-1634,-2,-1,269,295,-26
BR1_2731821506,10,True,1,0,0,18979,204,52,7.4,True,5,False,0,1,0,17133,198,64,7.2,False,28.90005,1846,5,1,256,262,-6
BR1_2724012589,6,False,0,0,0,17635,217,48,7.2,True,9,True,0,0,0,18466,253,47,7.6,False,29.752883333333333,-831,-3,0,265,300,-35
BR1_2727497942,11,False,0,0,0,17535,161,48,7.2,True,7,True,0,0,0,15562,185,48,6.8,False,25.406866666666666,1973,4,0,209,233,-24
BR1_2726923140,3,False,0,0,0,13868,180,60,6.6,False,3,True,1,0,0,14346,202,64,6.6,True,26.013133333333332,-478,0,-1,240,266,-26
BR1_2727496055,12,False,1,0,0,19695,213,60,7.4,True,7,True,0,0,0,17210,187,40,6.6,False,28.653883333333333,2485,5,1,273,227,46
BR1_2726673175,6,True,0,0,0,17672,218,44,7.4,True,2,False,1,0,0,15802,230,68,7.2,False,29.4171,1870,4,-1,262,298,-36
BR1_2730860280,7,False,0,1,0,16227,197,40,6.4,False,9,True,1,0,0,17114,216,44,6.8,True,26.817616666666666,-887,-2,-1,237,260,-23
BR1_2731463214,6,True,1,0,0,18477,275,62,7.8,True,3,False,0,1,0,15666,217,65,7.2,False,29.975283333333334,2811,3,1,337,282,55
BR1_2731047747,6,True,1,0,0,17187,212,59,7.2,True,7,False,0,0,0,17757,218,60,7.2,False,28.717183333333335,-570,-1,1,271,278,-7
BR1_2727029544,12,True,1,0,0,20033,208,64,7.8,True,6,False,0,0,0,18992,238,60,7.8,False,29.100366666666666,1041,6,1,272,298,-26
BR1_2727006509,6,False,0,0,0,16823,167,60,6.8,False,7,True,0,0,0,19232,248,64,7.6,True,29.088683333333332,-2409,-1,0,227,312,-85
BR1_2729027686,7,True,0,1,0,17271,206,51,7.2,True,4,False,0,0,0,15219,210,60,7.2,False,25.663016666666667,2052,3,0,257,270,-13
BR1_2728974369,8,True,1,1,0,19852,231,76,7.8,True,3,False,0,0,0,15727,230,52,7.2,False,28.517783333333334,4125,5,1,307,282,25
BR1_2731682096,5,True,1,1,0,17194,228,56,7.2,False,3,False,0,0,0,17243,254,78,7.4,True,28.913816666666666,-49,2,1,284,332,-48
BR1_2731262803,4,False,0,0,0,14539,206,32,6.4,False,7,True,1,0,0,17085,246,60,7.4,True,26.626816666666667,-2546,-3,-1,238,306,-68
BR1_2731193616,5,False,1,0,0,15269,177,48,6.6,False,8,True,0,0,0,15749,195,36,6.6,True,26.5818,-480,-3,1,225,231,-6
BR1_2730754713,8,False,1,0,0,18928,235,73,7.6,True,4,True,0,0,0,18127,256,56,7.2,False,28.093733333333333,801,4,1,308,312,-4
BR1_2730561204,6,True,1,0,0,16076,234,52,7.0,True,1,False,0,0,0,14209,204,64,6.8,False,25.13545,1867,5,1,286,268,18
BR1_2730068418,13,True,0,1,0,20248,217,48,7.2,True,8,False,1,0,0,18361,221,52,7.0,False,27.6011,1887,5,-1,265,273,-8
BR1_2730047189,6,False,0,1,0,17287,209,53,7.2,False,10,True,1,0,0,18681,223,52,7.0,True,28.02755,-1394,-4,-1,262,275,-13
BR1_2728747965,9,False,1,0,0,17110,204,64,7.0,True,5,True,0,1,0,15656,204,52,6.6,False,27.088116666666668,1454,4,1,268,256,12
BR1_2731626819,8,True,0,1,0,19017,201,44,7.0,False,9,False,1,0,0,18538,215,69,7.0,True,29.9686,479,-1,-1,245,284,-39
BR1_2730779803,9,True,0,0,0,18536,205,56,7.2,False,12,False,1,1,0,21074,220,64,7.4,True,27.61156666666667,-2538,-3,-1,261,284,-23
BR1_2720611962,2,False,1,0,0,14343,192,48,6.6,True,5,True,0,0,0,14912,162,60,6.6,False,26.415933333333335,-569,-3,1,240,222,18
BR1_2731071289,6,False,0,0,0,15194,177,32,6.8,False,6,True,0,0,0,15748,189,56,6.6,True,26.626266666666666,-554,0,0,209,245,-36
BR1_2731052742,7,True,0,0,0,17592,210,50,7.2,True,6,False,0,0,0,16005,187,61,7.4,False,28.63233333333333,1587,1,0,260,248,12
BR1_2676229363,8,False,1,0,0,17748,198,75,7.8,False,6,True,0,1,0,17761,243,63,7.6,True,29.956216666666666,-13,2,1,273,306,-33
BR1_2675645509,8,True,1,0,0,18799,229,72,7.6,True,4,False,0,0,0,17401,253,52,7.2,False,29.59305,1398,4,1,301,305,-4
BR1_2731338761,9,True,1,0,0,17170,216,44,6.8,True,7,False,0,1,0,16840,208,48,6.8,False,25.52535,330,2,1,260,256,4
BR1_2731523363,4,False,1,0,0,16058,226,52,6.8,False,13,True,0,1,1,22356,244,60,7.2,True,27.923516666666668,-6298,-9,1,278,304,-26
BR1_2731384884,5,False,0,1,0,17344,176,64,7.0,False,14,True,0,0,0,20285,211,52,7.4,True,28.029966666666667,-2941,-9,0,240,263,-23
BR1_2712038737,4,False,0,1,0,16896,215,56,7.2,False,12,True,1,0,0,21543,246,60,7.6,True,27.5959,-4647,-8,-1,271,306,-35
BR1_2711549295,9,False,0,0,0,16733,208,42,6.8,True,6,True,0,0,0,15927,195,42,6.8,False,26.32155,806,3,0,250,237,13
BR1_2693208703,4,True,0,1,0,16200,194,56,6.6,True,5,False,0,0,0,14614,181,32,6.4,False,25.326083333333333,1586,-1,0,250,213,37
BR1_2713258014,7,False,0,1,0,17996,225,64,7.4,True,9,True,1,0,0,18481,215,60,7.2,False,29.213,-485,-2,-1,289,275,14
BR1_2713247853,9,False,0,1,0,19530,267,52,7.4,True,12,True,1,0,0,20829,233,62,7.6,False,29.040466666666667,-1299,-3,-1,319,295,24
BR1_2712780261,7,True,0,1,0,18327,219,52,7.6,True,7,False,0,0,0,18829,239,84,7.4,False,29.566416666666665,-502,0,0,271,323,-52
BR1_2722639945,6,True,0,1,0,16433,194,52,7.2,False,8,False,0,0,0,16111,168,56,6.6,True,25.6602,322,-2,0,246,224,22
BR1_2729410251,4,False,0,1,0,15999,190,55,6.8,True,12,True,1,0,0,20963,209,52,7.2,False,28.192016666666667,-4964,-8,-1,245,261,-16
BR1_2725445346,7,False,0,0,0,16332,193,48,7.2,False,9,True,1,0,0,18472,213,56,7.4,True,29.667833333333334,-2140,-2,-1,241,269,-28
BR1_2725360185,7,True,1,0,0,18566,272,52,7.2,True,3,False,0,0,0,16599,232,64,7.8,False,29.0108,1967,4,1,324,296,28
BR1_2731315892,12,False,0,0,0,17948,153,63,6.8,False,8,True,1,0,0,18312,201,48,6.8,True,26.060266666666667,-364,4,-1,216,249,-33
BR1_2691544417,8,False,0,0,0,15854,159,48,6.8,False,13,True,0,0,0,17960,178,44,6.8,True,27.16615,-2106,-5,0,207,222,-15
BR1_2689563649,5,True,0,1,0,17450,255,56,7.6,True,2,False,1,0,0,16520,252,56,7.4,False,29.887766666666668,930,3,-1,311,308,3
BR1_2689088350,10,True,1,0,0,17998,219,61,7.0,True,4,False,0,0,0,15444,229,40,6.8,False,25.5749,2554,6,1,280,269,11
BR1_2715905928,10,True,1,0,0,18087,193,60,6.6,True,9,False,0,0,0,17266,178,48,7.0,False,27.45855,821,1,1,253,226,27
BR1_2727031424,6,True,0,1,0,18561,268,56,7.6,True,2,False,1,0,0,14822,191,44,7.0,False,28.625466666666668,3739,4,-1,324,235,89
BR1_2727006238,10,False,0,0,0,18479,208,60,7.4,False,12,True,1,1,0,20133,224,48,7.6,True,29.624666666666666,-1654,-2,-1,268,272,-4
BR1_2725570247,9,False,0,0,0,20732,259,48,7.6,True,6,True,1,1,0,16740,214,64,7.2,False,29.68535,3992,3,-1,307,278,29
BR1_2718041148,7,True,0,0,0,16527,216,46,6.8,False,10,False,1,0,0,18635,213,56,6.8,True,29.15835,-2108,-3,-1,262,269,-7
BR1_2717581252,20,False,1,1,0,23182,216,72,7.8,True,6,True,0,0,0,16434,194,46,6.8,False,29.86815,6748,14,1,288,240,48
BR1_2726971257,11,True,0,0,0,17612,185,44,6.8,False,10,False,0,0,0,17773,156,60,6.8,True,26.105316666666667,-161,1,0,229,216,13
BR1_2730066892,4,False,0,1,1,18063,236,52,7.2,True,4,True,0,0,0,16627,234,52,7.0,False,28.806683333333332,1436,0,0,288,286,2
BR1_2731861525,5,False,1,0,0,18129,238,52,7.2,True,7,True,0,0,0,16732,210,52,7.2,False,29.871216666666665,1397,-2,1,290,262,28
BR1_2731732976,5,False,0,0,0,14489,176,48,6.6,False,9,True,1,0,0,17974,192,52,6.6,True,25.16125,-3485,-4,-1,224,244,-20
BR1_2731834400,9,True,0,0,1,19487,214,67,7.2,True,7,False,0,0,0,18220,214,64,7.8,False,28.014416666666666,1267,2,0,281,278,3
BR1_2731816319,10,False,0,0,0,18987,188,48,7.2,False,8,True,1,0,0,17807,205,56,7.4,True,29.868516666666668,1180,2,-1,236,261,-25
BR1_2731847452,7,True,1,0,0,15605,191,55,6.4,False,7,False,0,1,0,17402,206,64,6.8,True,26.5749,-1797,0,1,246,270,-24
BR1_2731819243,7,False,0,1,0,18812,240,70,7.6,True,8,True,1,0,0,17834,234,55,7.6,False,27.76321666666667,978,-1,-1,310,289,21
BR1_2731199458,5,True,1,0,0,17163,210,60,7.2,True,8,False,0,0,0,17298,196,56,7.0,False,28.944533333333332,-135,-3,1,270,252,18
BR1_2730793514,9,True,0,0,0,16307,207,44,6.6,False,6,False,1,0,0,16686,203,54,6.8,True,27.485433333333333,-379,3,-1,251,257,-6
BR1_2706089739,9,True,1,0,0,17681,207,60,6.8,True,4,False,0,0,0,14587,186,36,6.4,False,26.740766666666666,3094,5,1,267,222,45
BR1_2705046412,5,False,1,0,0,14816,166,52,6.6,True,8,True,0,0,0,17207,174,52,6.8,False,25.83555,-2391,-3,1,218,226,-8
BR1_2715510116,4,True,1,0,2,14733,127,40,5.4,True,0,False,0,0,0,13047,153,40,5.6,False,26.8943,1686,4,1,167,193,-26
BR1_2727851024,2,True,0,0,0,13038,148,53,6.6,False,4,False,0,0,0,16019,195,46,6.8,True,25.983133333333335,-2981,-2,0,201,241,-40
BR1_2731173614,3,False,0,0,0,16111,197,52,7.4,False,8,True,1,0,0,19339,250,56,7.4,True,28.8337,-3228,-5,-1,249,306,-57
BR1_2729796468,9,True,1,0,0,16647,166,60,7.0,True,3,False,0,1,0,13736,166,48,6.4,False,27.107483333333334,2911,6,1,226,214,12
BR1_2717687201,15,True,0,0,0,20653,247,48,7.2,True,5,False,1,0,0,15659,160,48,6.8,False,28.2537,4994,10,-1,295,208,87
BR1_2730767810,9,True,0,0,0,18851,195,63,7.2,True,3,False,1,0,0,15373,212,36,7.2,False,27.622533333333333,3478,6,-1,258,248,10
BR1_2730323414,3,True,1,0,0,15779,222,52,6.8,False,11,False,0,0,0,19260,228,52,7.8,True,28.590683333333335,-3481,-8,1,274,280,-6
BR1_2731020594,1,False,0,0,0,15636,218,64,7.0,False,12,True,1,1,0,20656,238,60,7.8,True,28.559066666666666,-5020,-11,-1,282,298,-16
BR1_2731133205,4,False,1,0,0,16455,208,72,7.2,True,2,True,0,1,0,15386,204,40,6.8,False,28.04215,1069,2,1,280,244,36
BR1_2730825311,9,True,0,0,0,17114,188,42,6.6,True,4,False,0,0,0,13378,153,42,6.4,False,26.7821,3736,5,0,230,195,35
BR1_2690145890,3,True,1,1,0,16202,241,60,7.0,True,4,False,0,0,0,14906,190,60,6.8,False,26.258383333333335,1296,-1,1,301,250,51
BR1_2722685518,6,False,0,0,0,16073,163,56,6.8,False,9,True,1,0,1,19825,211,44,6.8,True,29.324583333333333,-3752,-3,-1,219,255,-36
BR1_2722660578,6,True,1,1,0,18360,240,60,7.6,True,4,False,0,0,0,15664,206,56,7.4,False,29.46765,2696,2,1,300,262,38
BR1_2708856015,2,True,0,0,0,16012,230,56,7.2,False,10,False,1,0,0,20664,226,72,7.6,True,27.814966666666667,-4652,-8,-1,286,298,-12
BR1_2708827698,9,True,1,0,0,18755,244,52,7.4,True,7,False,0,0,0,17223,189,56,7.4,False,29.121216666666665,1532,2,1,296,245,51
BR1_2726333232,4,False,0,0,0,16518,242,48,7.4,False,7,True,0,0,0,18337,233,60,7.2,True,28.8109,-1819,-3,0,290,293,-3
BR1_2726302660,3,False,0,0,0,14176,181,56,6.8,False,8,True,1,0,0,16970,181,68,6.8,True,27.051733333333335,-2794,-5,-1,237,249,-12
BR1_2730770881,6,True,0,1,0,17325,220,52,7.6,False,6,False,1,0,0,18357,267,68,7.8,True,28.51096666666667,-1032,0,-1,272,335,-63
BR1_2712750371,4,True,0,0,0,15168,195,48,6.6,False,9,False,1,1,0,18032,183,76,7.2,True,26.531333333333333,-2864,-5,-1,243,259,-16
BR1_2712736446,5,False,0,0,0,15435,198,48,6.8,False,3,True,1,0,0,15355,213,44,6.8,True,27.25025,80,2,-1,246,257,-11
BR1_2731608923,9,True,0,0,0,17100,192,36,6.4,False,9,False,1,0,0,17317,195,52,6.8,True,26.428616666666667,-217,0,-1,228,247,-19
BR1_2731587796,12,False,0,1,0,19461,163,60,6.8,True,6,True,0,0,0,15812,184,40,6.4,False,25.33185,3649,6,0,223,224,-1
BR1_2731789247,4,False,1,0,0,16762,235,62,7.0,False,7,True,0,0,0,20028,244,70,7.4,True,28.486766666666668,-3266,-3,1,297,314,-17
BR1_2731706211,11,True,0,1,0,19872,226,56,7.0,True,5,False,0,0,0,15471,189,46,6.4,False,25.1565,4401,6,0,282,235,47
BR1_2731111683,11,False,0,0,0,20309,236,56,7.6,False,8,True,0,1,0,17998,205,56,7.4,True,28.830133333333333,2311,3,0,292,261,31
BR1_2731683965,11,False,1,0,0,17930,190,44,6.6,False,9,True,0,0,0,15861,170,40,6.2,True,26.037333333333333,2069,2,1,234,210,24
BR1_2723789726,2,False,0,0,0,14199,221,44,6.6,False,9,True,1,0,0,18185,208,64,7.2,True,26.943133333333332,-3986,-7,-1,265,272,-7
BR1_2731785798,6,False,0,1,0,19017,282,56,7.6,True,5,True,1,0,0,17642,251,56,7.6,False,29.509283333333332,1375,1,-1,338,307,31
BR1_2731760750,4,False,1,0,0,15363,228,48,6.8,False,4,True,0,0,0,16286,223,60,6.8,True,26.602566666666668,-923,0,1,276,283,-7
BR1_2731103216,4,True,1,0,0,14643,187,48,6.8,False,2,False,0,0,0,14293,216,46,6.8,True,26.67705,350,2,1,235,262,-27
BR1_2731710240,2,True,1,0,0,16319,247,67,7.4,False,6,False,0,1,0,18621,262,56,7.6,True,28.536233333333332,-2302,-4,1,314,318,-4
BR1_2724107517,1,False,0,0,0,12940,164,24,6.0,False,8,True,1,1,0,19140,235,80,7.8,True,28.56935,-6200,-7,-1,188,315,-127
BR1_2718257042,6,True,0,1,0,15230,152,54,6.0,False,9,False,1,0,0,16197,168,48,6.6,True,25.17295,-967,-3,-1,206,216,-10
BR1_2718177841,6,False,0,0,0,15058,181,28,6.6,False,10,True,0,0,0,17456,149,48,6.6,True,25.645383333333335,-2398,-4,0,209,197,12
BR1_2718158166,3,True,1,0,0,14758,186,48,6.8,False,7,False,0,0,0,17525,203,52,7.2,True,29.10895,-2767,-4,1,234,255,-21
BR1_2731542580,6,True,1,1,0,16832,209,56,7.2,False,3,False,0,0,0,16328,209,72,7.0,True,27.654466666666668,504,3,1,265,281,-16
BR1_2731575624,3,True,0,0,0,16465,210,72,7.2,False,6,False,0,0,0,17285,243,56,7.4,True,29.591516666666667,-820,-3,0,282,299,-17
BR1_2726714754,8,False,0,0,0,17552,247,44,6.8,True,7,True,0,0,0,16392,208,51,6.8,False,26.000466666666668,1160,1,0,291,259,32
BR1_2731832552,9,True,1,1,0,16650,184,56,6.8,True,5,False,0,0,0,15034,206,36,6.8,False,27.234616666666668,1616,4,1,240,242,-2
BR1_2731770953,6,True,1,0,0,16781,209,47,7.0,True,6,False,0,0,0,15424,195,44,6.4,False,25.788316666666667,1357,0,1,256,239,17
BR1_2730101523,7,True,0,0,0,19130,248,68,7.6,False,2,False,0,0,0,14840,168,64,6.8,True,28.179333333333332,4290,5,0,316,232,84
BR1_2730587753,10,True,0,0,0,18103,212,52,6.8,True,5,False,0,0,0,14104,157,44,6.6,False,26.912183333333335,3999,5,0,264,201,63
BR1_2728788386,4,False,0,0,0,16502,226,68,7.2,False,7,True,0,0,0,17009,192,60,7.4,True,28.1295,-507,-3,0,294,252,42
BR1_2729516322,4,True,0,1,0,17413,225,56,7.4,False,4,False,1,0,0,16838,209,76,7.6,True,29.769283333333334,575,0,-1,281,285,-4
BR1_2723996991,11,False,1,1,0,19111,255,52,7.4,True,7,True,0,0,0,18840,258,68,7.6,False,28.3032,271,4,1,307,326,-19
BR1_2731527644,6,True,0,1,0,18618,252,71,7.8,False,4,False,1,0,0,15453,178,53,7.0,True,27.910733333333333,3165,2,-1,323,231,92
BR1_2730499206,10,True,0,0,0,18266,244,52,7.2,True,1,False,0,0,0,12920,162,60,6.6,False,25.662783333333334,5346,9,0,296,222,74
BR1_2709070164,12,False,0,1,0,20619,200,72,7.4,True,4,True,1,0,0,16684,198,68,7.0,False,28.67,3935,8,-1,272,266,6
BR1_2730938490,7,True,1,0,0,15815,133,44,5.8,False,7,False,0,1,1,18891,203,60,6.8,True,26.946116666666665,-3076,0,1,177,263,-86
BR1_2724567056,5,True,0,0,0,17102,213,56,7.4,True,8,False,0,0,0,18443,230,60,7.4,False,29.172533333333334,-1341,-3,0,269,290,-21
BR1_2730095551,10,False,1,0,0,19701,243,72,7.4,True,4,True,0,0,0,17198,264,44,7.4,False,27.89005,2503,6,1,315,308,7
BR1_2689184578,10,True,0,1,0,19622,257,44,8.0,True,2,False,0,0,0,14860,202,52,6.8,False,28.521433333333334,4762,8,0,301,254,47
BR1_2730442019,8,False,1,0,0,17671,224,51,7.2,True,7,True,0,0,0,18014,235,59,7.2,False,29.58625,-343,1,1,275,294,-19
BR1_2725612222,3,False,0,0,0,16903,266,60,7.8,False,3,True,1,1,0,16143,234,52,7.4,True,28.6814,760,0,-1,326,286,40
BR1_2725400950,6,False,0,0,0,16049,159,56,6.6,False,11,True,1,0,0,18826,184,40,6.6,True,25.167183333333334,-2777,-5,-1,215,224,-9
BR1_2731551199,13,True,1,1,0,18463,169,40,6.6,True,5,False,0,0,0,16003,192,48,6.8,False,25.94355,2460,8,1,209,240,-31
BR1_2731639910,1,True,0,0,0,14603,216,60,6.8,True,5,False,1,1,0,15429,185,68,7.0,False,25.948366666666665,-826,-4,-1,276,253,23
BR1_2730760096,10,True,1,0,0,19351,207,60,7.4,True,5,False,0,0,0,16255,197,56,7.0,False,28.2916,3096,5,1,267,253,14
BR1_2729276654,4,True,1,1,0,15092,173,56,7.0,True,6,False,0,0,0,16337,210,44,6.8,False,27.170483333333333,-1245,-2,1,229,254,-25
BR1_2726164431,6,False,1,1,0,17556,239,72,7.4,True,3,True,0,0,0,17375,231,66,7.2,False,29.678983333333335,181,3,1,311,297,14
BR1_2705118416,9,True,0,1,1,20934,247,68,7.6,True,7,False,1,0,0,18296,230,60,7.4,False,29.587816666666665,2638,2,-1,315,290,25
BR1_2704686748,6,True,0,0,0,16972,190,52,6.8,False,5,False,1,0,0,14537,181,52,6.6,True,25.771916666666666,2435,1,-1,242,233,9
BR1_2720162867,7,False,1,0,0,16809,212,54,7.2,True,5,True,0,0,0,15210,211,31,6.4,False,26.04765,1599,2,1,266,242,24
BR1_2727302533,7,True,0,1,1,21151,233,68,7.6,True,4,False,1,0,0,16631,231,64,7.6,False,27.773583333333335,4520,3,-1,301,295,6
BR1_2730633158,5,True,0,0,0,15887,189,50,6.8,False,4,False,1,0,0,15827,209,56,7.0,True,29.693633333333334,60,1,-1,239,265,-26
BR1_2691182707,6,False,1,0,0,16972,231,48,7.4,True,8,True,0,0,0,17739,212,68,7.4,False,29.268383333333333,-767,-2,1,279,280,-1
BR1_2691149383,6,True,0,0,0,14909,173,52,6.8,False,6,False,1,0,0,17743,213,54,7.4,True,27.634566666666668,-2834,0,-1,225,267,-42
BR1_2716809798,7,True,0,1,0,17260,203,60,7.0,False,5,False,1,0,0,16286,243,64,7.2,True,25.489516666666667,974,2,-1,263,307,-44
BR1_2708187486,12,True,1,0,0,18429,182,54,6.6,False,11,False,0,0,0,19894,196,44,7.0,True,28.778233333333333,-1465,1,1,236,240,-4
BR1_2727443787,13,True,1,0,0,20732,220,68,8.0,True,11,False,0,0,0,18998,211,52,7.2,False,29.614166666666666,1734,2,1,288,263,25
BR1_2726091591,2,True,1,0,0,14181,208,52,7.0,False,4,False,0,0,0,16248,229,60,6.8,True,26.995483333333333,-2067,-2,1,260,289,-29
BR1_2722011930,9,False,1,0,0,17838,200,56,6.8,True,3,True,0,0,0,13213,154,34,6.0,False,25.158966666666668,4625,6,1,256,188,68
BR1_2721995737,7,True,0,0,0,14321,122,56,6.4,True,6,False,1,0,0,15540,169,46,6.6,False,26.7263,-1219,1,-1,178,215,-37
BR1_2726485850,7,False,1,0,0,15594,159,32,6.6,False,5,True,0,1,0,16320,179,56,6.8,True,25.224033333333335,-726,2,1,191,235,-44
BR1_2726830257,16,True,0,0,0,22440,188,44,7.6,True,7,False,0,0,0,17305,173,59,7.0,False,29.329516666666667,5135,9,0,232,232,0
BR1_2718338648,10,True,1,1,0,19808,222,58,7.4,True,10,False,0,0,0,19664,229,64,7.4,False,27.587816666666665,144,0,1,280,293,-13
BR1_2714954434,7,True,1,0,0,15910,186,52,6.8,True,6,False,0,0,0,15119,156,56,6.6,False,27.345266666666667,791,1,1,238,212,26
BR1_2730118886,7,False,1,0,0,16890,206,44,6.8,True,6,True,0,1,0,17213,203,51,6.8,False,25.47855,-323,1,1,250,254,-4
BR1_2731648624,11,True,0,0,0,16652,164,36,6.6,False,10,False,1,1,0,18207,161,64,6.8,True,25.9696,-1555,1,-1,200,225,-25
BR1_2731159422,5,True,0,0,0,16067,214,60,6.8,True,2,False,0,0,0,13366,182,33,6.6,False,26.1808,2701,3,0,274,215,59
BR1_2731748256,13,True,0,1,0,19083,182,56,7.4,False,10,False,1,0,0,19115,175,44,6.8,True,29.0035,-32,3,-1,238,219,19
BR1_2731563640,7,True,1,1,0,17186,223,47,7.2,True,5,False,0,0,0,17339,210,63,7.6,False,28.927416666666666,-153,2,1,270,273,-3
BR1_2731901371,7,True,1,1,0,17293,199,60,6.8,True,6,False,0,0,0,16606,201,56,7.2,False,25.3871,687,1,1,259,257,2
BR1_2731295159,5,True,0,1,0,15468,183,52,6.4,False,5,False,0,0,0,16572,183,56,6.6,True,25.04083333333333,-1104,0,0,235,239,-4
BR1_2730990196,10,True,0,0,0,18601,209,68,7.4,True,5,False,1,0,0,16982,231,60,7.4,False,29.558983333333334,1619,5,-1,277,291,-14
BR1_2728420263,17,True,1,1,0,22367,172,57,7.0,True,8,False,0,0,0,17441,187,46,6.6,False,29.09636666666667,4926,9,1,229,233,-4
BR1_2729751418,5,False,0,0,0,17101,251,48,7.4,True,4,True,0,0,0,16476,194,67,7.4,False,28.362716666666667,625,1,0,299,261,38
BR1_2724357361,5,False,0,0,0,16298,199,52,7.2,False,9,True,1,1,0,19583,229,88,7.6,True,27.6364,-3285,-4,-1,251,317,-66
BR1_2731870202,8,False,0,1,0,17124,210,39,7.4,True,5,True,1,0,0,15765,193,54,6.8,False,27.762183333333333,1359,3,-1,249,247,2
BR1_2730257442,6,False,1,0,0,17472,210,59,7.0,True,5,True,0,1,0,14725,170,40,6.6,False,26.64175,2747,1,1,269,210,59
BR1_2729947180,3,False,0,0,0,14499,205,36,6.8,False,7,True,1,0,0,16149,168,56,7.0,True,25.696716666666667,-1650,-4,-1,241,224,17
BR1_2711234384,9,False,1,0,0,19049,224,48,7.2,True,7,True,0,1,0,17362,178,59,7.4,False,29.6886,1687,2,1,272,237,35
BR1_2711205371,7,True,0,1,0,17654,197,44,7.0,False,7,False,1,0,0,17730,228,56,7.2,True,27.773966666666666,-76,0,-1,241,284,-43
BR1_2730758559,3,False,1,1,0,16794,213,76,7.2,True,4,True,0,0,0,15786,229,54,7.2,False,29.976416666666665,1008,-1,1,289,283,6
BR1_2724115174,8,True,0,1,0,16868,187,44,6.4,False,6,False,1,0,0,14904,169,42,6.4,True,27.142566666666667,1964,2,-1,231,211,20
BR1_2731512593,6,False,0,0,0,15820,180,44,6.8,True,4,True,0,0,0,14936,218,52,6.8,False,25.062716666666667,884,2,0,224,270,-46
BR1_2730848723,8,True,1,0,0,17837,225,64,7.4,True,4,False,0,0,0,15929,164,60,7.4,False,29.610016666666667,1908,4,1,289,224,65
BR1_2731802980,9,False,0,0,0,18339,216,60,7.4,False,12,True,1,0,0,19426,184,64,7.2,True,29.965116666666667,-1087,-3,-1,276,248,28
BR1_2687912060,5,True,0,0,0,14397,183,40,6.8,True,4,False,0,0,0,15189,201,44,6.6,False,25.203983333333333,-792,1,0,223,245,-22
BR1_2725412581,5,False,0,0,0,16703,221,48,7.2,False,10,True,0,1,0,20243,220,48,7.2,True,29.3724,-3540,-5,0,269,268,1
BR1_2729977757,7,True,0,0,0,16823,179,48,6.8,False,6,False,0,0,0,17962,203,56,7.2,True,28.175866666666668,-1139,1,0,227,259,-32
BR1_2729957770,18,True,1,0,1,21239,200,44,6.6,True,5,False,0,0,0,14070,137,52,6.2,False,26.492116666666668,7169,13,1,244,189,55
BR1_2731775863,6,True,1,0,0,16671,199,52,7.2,True,4,False,0,0,0,16218,208,60,7.4,False,29.291633333333333,453,2,1,251,268,-17
BR1_2710872024,4,False,0,0,0,14666,186,51,6.6,False,8,True,1,0,0,18296,197,74,7.0,True,26.376716666666667,-3630,-4,-1,237,271,-34
BR1_2721160781,5,False,0,0,0,15269,175,64,6.8,False,12,True,1,0,0,17784,167,52,7.2,True,27.101783333333334,-2515,-7,-1,239,219,20
BR1_2731869263,8,False,1,0,0,16390,172,52,6.6,True,9,True,0,0,0,17241,187,44,6.6,False,26.638633333333335,-851,-1,1,224,231,-7
BR1_2731858388,9,False,0,0,0,17147,149,43,6.4,False,16,True,0,0,0,19764,207,44,7.4,True,25.175916666666666,-2617,-7,0,192,251,-59
BR1_2731841449,9,False,1,0,0,18539,222,64,7.2,True,9,True,0,1,0,18933,230,52,7.2,False,29.93975,-394,0,1,286,282,4
BR1_2706397738,4,False,0,1,0,14946,214,48,6.6,False,11,True,1,0,0,17569,211,60,7.0,True,26.727966666666667,-2623,-7,-1,262,271,-9
BR1_2716720563,10,True,0,0,0,18397,237,28,6.8,True,2,False,1,0,0,13886,165,56,6.6,False,25.70935,4511,8,-1,265,221,44
BR1_2731327166,7,True,0,0,0,18471,259,52,7.4,False,6,False,1,0,0,17895,218,62,7.0,True,29.169033333333335,576,1,-1,311,280,31
BR1_2731834525,3,True,0,0,0,17128,249,48,7.2,False,7,False,1,1,0,17613,238,56,7.6,True,27.91215,-485,-4,-1,297,294,3
BR1_2731739122,11,True,0,1,0,20848,240,56,7.4,True,7,False,1,0,0,17098,190,48,7.0,False,29.907066666666665,3750,4,-1,296,238,58
BR1_2730318570,7,True,1,0,0,16755,222,56,6.6,False,6,False,0,1,0,16295,190,52,6.8,True,27.113083333333332,460,1,1,278,242,36
BR1_2730617003,11,True,0,1,0,19312,159,52,7.0,False,13,False,0,0,0,20100,219,40,7.2,True,28.228533333333335,-788,-2,0,211,259,-48
BR1_2730592502,12,True,0,1,0,20555,215,60,7.6,False,5,False,1,0,0,16683,214,60,7.4,True,29.49165,3872,7,-1,275,274,1
BR1_2730576579,5,True,0,1,0,15194,200,36,6.8,True,3,False,1,0,0,14655,169,64,6.4,False,26.8598,539,2,-1,236,233,3
BR1_2731471324,9,True,1,0,0,18174,213,53,7.0,True,5,False,0,0,0,14658,194,46,6.6,False,25.04535,3516,4,1,266,240,26
BR1_2731444479,13,True,1,0,0,19381,208,52,7.6,True,5,False,0,1,0,16853,203,64,7.2,False,29.292333333333332,2528,8,1,260,267,-7
BR1_2731578766,5,False,0,0,0,15797,177,40,6.4,False,12,True,1,0,0,18862,224,56,6.8,True,25.21265,-3065,-7,-1,217,280,-63
BR1_2731566803,10,True,0,1,0,21207,266,44,7.6,True,5,False,0,0,0,16670,229,52,7.2,False,27.818966666666668,4537,5,0,310,281,29
BR1_2720975096,7,False,0,1,0,17341,226,60,7.4,True,3,True,0,0,0,13933,194,40,6.6,False,27.112616666666668,3408,4,0,286,234,52
BR1_2720801961,3,False,0,0,0,15670,206,56,7.4,False,7,True,1,1,1,18234,210,52,7.4,True,28.1129,-2564,-4,-1,262,262,0
BR1_2731874974,6,True,0,0,0,15147,189,41,6.6,False,4,False,0,0,0,15640,205,59,6.6,True,26.69215,-493,2,0,230,264,-34
BR1_2731877044,10,False,1,0,0,19115,210,47,7.4,True,10,True,0,0,0,19510,214,68,7.4,False,29.185466666666667,-395,0,1,257,282,-25
BR1_2729155694,11,False,0,1,1,21564,204,68,7.8,False,3,True,1,0,0,15495,199,52,6.8,True,27.775716666666668,6069,8,-1,272,251,21
BR1_2720717155,8,True,1,0,0,18384,218,64,7.4,True,10,False,0,0,0,17915,201,60,7.2,False,28.75085,469,-2,1,282,261,21
BR1_2718529925,12,True,0,0,0,19880,229,52,6.8,True,6,False,1,1,0,15311,158,52,6.6,False,25.972616666666667,4569,6,-1,281,210,71
BR1_2730921743,7,False,0,0,0,16430,187,52,7.2,True,4,True,1,0,0,15728,237,52,6.8,False,26.041783333333335,702,3,-1,239,289,-50
BR1_2730918285,6,True,0,1,0,15851,175,54,6.6,False,5,False,0,0,0,15901,198,48,6.4,True,25.297166666666666,-50,1,0,229,246,-17
BR1_2730565995,10,False,0,0,0,17986,197,28,6.8,False,10,True,1,0,0,19827,210,60,7.2,True,29.68105,-1841,0,-1,225,270,-45
BR1_2731677903,9,True,1,0,0,19811,236,56,7.0,True,9,False,0,1,0,18195,226,44,7.0,False,27.59958333333333,1616,0,1,292,270,22
BR1_2729478220,8,False,1,0,0,18792,232,68,7.4,True,6,True,0,0,0,16974,205,44,7.2,False,27.63985,1818,2,1,300,249,51
BR1_2729417129,10,True,1,0,0,18124,201,58,7.4,False,6,False,0,1,0,18750,220,64,7.4,True,28.114983333333335,-626,4,1,259,284,-25
BR1_2729393491,11,True,0,0,0,18088,176,48,6.6,True,6,False,0,0,0,16142,160,60,6.4,False,25.097066666666667,1946,5,0,224,220,4
BR1_2731210509,9,False,0,1,0,16656,182,48,6.4,True,9,True,0,0,0,16968,189,35,7.0,False,25.984783333333333,-312,0,0,230,224,6
BR1_2721455485,10,False,1,0,0,17603,206,56,6.8,False,6,True,0,0,0,14809,177,35,6.6,True,26.891016666666665,2794,4,1,262,212,50
BR1_2725052805,6,False,0,1,1,18538,232,42,7.0,False,12,True,1,0,0,20127,208,67,7.6,True,27.98925,-1589,-6,-1,274,275,-1
BR1_2731802849,9,False,1,0,0,18811,210,72,7.2,True,4,True,0,0,0,16524,250,40,7.2,False,27.81025,2287,5,1,282,290,-8
BR1_2731782711,13,False,0,0,0,19665,206,56,7.4,False,9,True,1,0,1,20210,223,52,7.4,True,28.751666666666665,-545,4,-1,262,275,-13
BR1_2731532582,6,False,0,1,0,16597,202,44,7.2,False,9,True,1,0,0,18847,245,56,7.2,True,28.63915,-2250,-3,-1,246,301,-55
BR1_2731870239,9,True,0,0,0,19215,213,50,7.4,False,14,False,1,0,0,22060,250,62,8.0,True,29.3184,-2845,-5,-1,263,312,-49
BR1_2721837219,9,False,0,0,0,16671,173,44,6.6,True,9,True,0,0,0,17209,168,36,6.6,False,26.442033333333335,-538,0,0,217,204,13
BR1_2730718189,3,False,0,0,0,13814,188,0,5.8,False,6,True,1,0,0,17531,224,56,7.0,True,25.66435,-3717,-3,-1,188,280,-92
BR1_2730359943,11,False,0,0,0,19853,217,60,7.2,False,10,True,1,0,0,19405,177,56,7.0,True,28.171766666666667,448,1,-1,277,233,44
BR1_2731250675,7,True,1,0,0,17572,193,60,7.6,True,5,False,0,0,0,16296,231,52,7.0,False,29.918383333333335,1276,2,1,253,283,-30
BR1_2729406351,12,True,1,0,0,19349,214,48,7.0,True,4,False,0,0,0,14461,204,44,6.8,False,25.189666666666668,4888,8,1,262,248,14
BR1_2729384415,9,False,0,1,0,16601,190,44,6.8,True,7,True,1,0,0,16125,160,52,6.2,False,26.638933333333334,476,2,-1,234,212,22
BR1_2730567239,10,True,1,0,0,18112,230,42,6.6,True,11,False,0,0,0,17251,166,64,6.8,False,26.09095,861,-1,1,272,230,42
BR1_2729183531,4,True,0,0,0,16631,209,41,6.4,False,8,False,1,0,0,17932,222,48,7.0,True,28.372833333333332,-1301,-4,-1,250,270,-20
BR1_2727809000,4,True,0,0,0,15448,204,60,7.0,False,5,False,1,0,0,15373,204,52,6.8,True,25.7091,75,-1,-1,264,256,8
BR1_2711503850,8,True,1,1,0,16716,169,56,6.8,True,4,False,0,0,0,14604,170,51,6.4,False,27.212016666666667,2112,4,1,225,221,4
BR1_2731860990,1,False,0,0,0,13602,199,56,6.6,False,9,True,1,0,0,17335,199,60,7.0,True,26.503716666666666,-3733,-8,-1,255,259,-4
BR1_2729593931,14,True,1,1,0,19155,187,60,7.2,True,7,False,0,0,0,16173,134,60,6.8,False,28.60775,2982,7,1,247,194,53
BR1_2726395566,9,True,0,0,0,19716,253,64,7.6,True,3,False,1,1,0,16150,249,56,7.0,False,29.827683333333333,3566,6,-1,317,305,12
BR1_2723173448,6,False,0,0,0,18012,233,60,7.4,False,7,True,1,1,0,18326,220,68,7.6,True,28.269383333333334,-314,-1,-1,293,288,5
BR1_2726570795,5,False,0,0,0,14734,153,50,6.2,False,9,True,0,0,0,17671,197,44,6.8,True,27.174966666666666,-2937,-4,0,203,241,-38
BR1_2724190254,6,False,1,0,0,18352,213,68,7.4,False,8,True,0,1,0,18030,187,48,7.2,True,28.899833333333333,322,-2,1,281,235,46
BR1_2714184278,10,True,1,0,0,17223,213,48,6.6,True,4,False,0,0,0,15426,177,52,6.4,False,26.472133333333332,1797,6,1,261,229,32
BR1_2709633813,13,False,1,0,0,19370,206,48,7.4,True,8,True,0,1,0,18169,199,72,7.2,False,28.19415,1201,5,1,254,271,-17
BR1_2729282916,7,False,0,0,0,15381,190,43,6.6,False,7,True,0,1,0,17397,203,46,6.8,True,25.73235,-2016,0,0,233,249,-16
BR1_2702300117,12,True,0,0,0,18580,201,56,6.8,True,4,False,1,0,0,15676,190,48,6.4,False,25.57895,2904,8,-1,257,238,19
BR1_2701812005,7,False,0,0,0,18527,232,48,7.2,False,11,True,1,1,0,20361,250,56,7.6,True,27.72298333333333,-1834,-4,-1,280,306,-26
BR1_2726874299,9,True,0,0,0,20366,257,83,7.8,True,9,False,0,0,0,17660,216,48,7.6,False,28.574116666666665,2706,0,0,340,264,76
BR1_2730250621,12,False,0,0,0,20376,235,51,7.8,False,9,True,0,0,0,18399,217,61,7.2,True,28.937483333333333,1977,3,0,286,278,8
BR1_2731522130,15,True,1,0,0,20009,187,60,7.2,True,6,False,0,0,0,17621,202,44,6.8,False,29.182616666666668,2388,9,1,247,246,1
BR1_2731473329,12,False,1,0,0,18005,168,52,6.6,True,6,True,0,1,0,16627,175,52,6.6,False,25.320533333333334,1378,6,1,220,227,-7
BR1_2731797491,9,True,1,0,0,18648,236,58,7.0,True,6,False,0,1,0,17157,213,66,7.4,False,27.627666666666666,1491,3,1,294,279,15
BR1_2719771572,7,False,0,0,0,17915,235,48,7.6,True,9,True,1,0,0,18804,218,60,7.4,False,29.15041666666667,-889,-2,-1,283,278,5
BR1_2730950267,4,True,1,0,0,15326,182,45,6.8,True,3,False,0,1,0,14285,194,42,6.4,False,26.06845,1041,1,1,227,236,-9
BR1_2730943058,7,False,1,1,1,16293,169,64,6.8,True,18,True,0,0,0,23813,249,72,7.8,False,29.276933333333332,-7520,-11,1,233,321,-88
BR1_2703254858,10,True,0,0,0,18564,259,59,7.6,False,8,False,0,1,0,18139,204,44,7.2,True,29.995666666666665,425,2,0,318,248,70
BR1_2703248816,9,False,1,0,0,16884,201,43,6.8,False,5,True,0,1,0,16034,208,48,6.8,True,26.47975,850,4,1,244,256,-12
BR1_2730546659,7,False,1,1,0,15402,174,56,7.0,True,6,True,0,0,0,16033,177,48,6.8,False,27.0108,-631,1,1,230,225,5
BR1_2730535742,5,True,1,1,1,17287,217,44,7.0,True,7,False,0,0,0,16778,231,44,6.8,False,25.082316666666667,509,-2,1,261,275,-14
BR1_2730335498,3,False,0,0,0,13913,167,44,6.2,False,8,True,1,0,0,17219,211,59,7.0,True,27.364966666666668,-3306,-5,-1,211,270,-59
BR1_2731840265,6,False,0,1,0,17011,197,60,7.0,False,11,True,1,0,0,20062,231,44,7.2,True,29.44311666666667,-3051,-5,-1,257,275,-18
BR1_2731823477,6,True,1,1,0,18006,233,56,7.4,False,4,False,0,0,0,17076,245,56,7.2,True,28.48581666666667,930,2,1,289,301,-12
BR1_2731090124,12,False,0,1,1,21665,281,52,7.6,True,10,True,1,0,0,19294,175,56,7.2,False,29.554733333333335,2371,2,-1,333,231,102
BR1_2727694955,11,True,1,0,0,18686,192,44,7.0,True,3,False,0,0,0,15288,188,60,6.6,False,29.559066666666666,3398,8,1,236,248,-12
BR1_2688116988,7,False,1,0,0,16103,195,56,7.0,False,4,True,0,1,0,15386,194,58,6.8,True,25.14056666666667,717,3,1,251,252,-1
BR1_2729548452,10,True,0,0,0,18697,208,44,7.0,False,9,False,0,0,0,17726,178,56,7.4,True,28.13495,971,1,0,252,234,18
BR1_2729957980,8,False,0,1,1,16980,205,46,6.6,False,8,True,1,0,0,16894,166,36,6.4,True,27.095583333333334,86,0,-1,251,202,49
BR1_2729938937,10,False,1,0,0,19362,213,82,7.4,False,10,True,0,1,0,19336,191,52,7.2,True,28.64765,26,0,1,295,243,52
BR1_2729923562,5,False,0,0,0,14771,176,48,6.6,False,8,True,0,0,0,16628,192,59,7.2,True,25.0979,-1857,-3,0,224,251,-27
BR1_2692777260,4,True,0,0,0,14206,181,44,6.6,False,7,False,0,0,0,16308,202,48,6.8,True,25.871566666666666,-2102,-3,0,225,250,-25
BR1_2719723488,7,True,0,0,0,17113,190,48,6.6,True,8,False,0,1,1,17839,191,51,6.4,False,26.410233333333334,-726,-1,0,238,242,-4
BR1_2719704649,5,False,0,0,0,16499,204,59,7.2,False,12,True,1,0,0,18029,216,48,7.2,True,26.346383333333332,-1530,-7,-1,263,264,-1
BR1_2719692724,13,True,0,1,0,20196,196,60,7.2,True,8,False,0,0,0,16882,184,48,6.4,False,25.402416666666667,3314,5,0,256,232,24
BR1_2730030922,13,True,1,0,0,19762,227,68,7.4,True,5,False,0,0,0,17590,241,60,7.2,False,27.90275,2172,8,1,295,301,-6
BR1_2731526231,8,False,1,1,0,16982,193,65,7.2,True,4,True,0,0,0,15696,190,52,7.0,False,29.89855,1286,4,1,258,242,16
BR1_2731042634,15,True,1,0,0,20197,196,52,6.8,True,4,False,0,0,0,14838,171,56,6.4,False,27.1963,5359,11,1,248,227,21
BR1_2729051620,7,False,1,0,0,16680,180,76,7.2,False,10,True,0,0,0,20145,271,32,7.4,True,28.600716666666667,-3465,-3,1,256,303,-47
BR1_2726860756,12,True,1,1,0,19628,253,52,7.8,True,4,False,0,0,0,16595,238,56,7.4,False,27.611066666666666,3033,8,1,305,294,11
BR1_2726843425,8,True,0,1,1,20451,258,64,7.6,False,7,False,1,0,0,17405,209,48,7.4,True,28.385033333333332,3046,1,-1,322,257,65
BR1_2726170458,3,False,0,0,0,15206,184,56,6.8,False,14,True,1,1,0,21717,213,60,7.2,True,27.507616666666667,-6511,-11,-1,240,273,-33
BR1_2730793419,9,False,0,0,0,19743,231,44,7.2,True,7,True,1,1,0,18270,239,68,7.2,False,29.329716666666666,1473,2,-1,275,307,-32
BR1_2730724161,3,False,1,1,0,15946,210,60,7.0,True,9,True,0,0,0,15994,183,40,6.4,False,26.129616666666667,-48,-6,1,270,223,47
BR1_2729724811,8,True,0,1,0,17837,205,68,6.8,True,7,False,0,0,0,15132,171,40,6.8,False,26.416066666666666,2705,1,0,273,211,62
BR1_2712668075,4,True,0,0,0,15073,212,51,6.8,False,6,False,1,0,0,17728,219,64,7.2,True,29.416933333333333,-2655,-2,-1,263,283,-20
BR1_2729994101,7,True,0,0,0,14243,173,4,6.2,False,7,False,1,0,0,15831,185,48,7.0,True,25.667816666666667,-1588,0,-1,177,233,-56
BR1_2726912639,4,True,0,0,0,15574,219,36,7.6,True,5,False,1,0,0,15734,206,60,7.6,False,28.46745,-160,-1,-1,255,266,-11
BR1_2729985761,6,False,0,0,0,16575,163,56,7.0,False,9,True,1,1,0,20226,221,72,7.2,True,28.27765,-3651,-3,-1,219,293,-74
BR1_2716363885,3,True,0,0,0,16337,232,52,7.0,True,3,False,0,0,0,15182,200,60,7.2,False,27.667666666666666,1155,0,0,284,260,24
BR1_2716340184,8,True,0,1,0,17677,208,76,7.8,True,4,False,1,0,0,16427,216,68,7.4,False,28.429666666666666,1250,4,-1,284,284,0
BR1_2726065255,5,True,1,1,0,15534,197,54,6.6,True,5,False,0,0,0,15295,183,48,6.6,False,27.483183333333333,239,0,1,251,231,20
BR1_2731326537,5,False,1,0,0,15873,228,47,6.8,False,3,True,0,1,0,15227,201,56,6.6,True,26.080333333333332,646,2,1,275,257,18
BR1_2731918514,11,False,1,1,0,18754,223,54,7.6,True,8,True,0,0,0,18544,213,54,7.6,False,28.050283333333333,210,3,1,277,267,10
BR1_2731411747,6,False,0,0,0,16228,214,52,7.2,False,9,True,1,0,0,19628,252,72,7.6,True,27.993583333333333,-3400,-3,-1,266,324,-58
BR1_2724725235,4,False,0,0,0,16180,214,64,7.2,False,6,True,1,1,0,15475,185,60,6.8,True,26.1562,705,-2,-1,278,245,33
BR1_2729779705,8,True,1,0,0,17615,235,56,7.2,True,3,False,0,0,0,13524,167,48,6.6,False,26.9807,4091,5,1,291,215,76
BR1_2724271827,11,False,0,1,0,18867,172,52,6.8,False,16,True,1,0,0,20839,172,51,6.8,True,29.179966666666665,-1972,-5,-1,224,223,1
BR1_2731765184,9,False,1,0,0,18756,236,56,7.0,True,4,True,0,0,0,16180,214,60,7.2,False,28.0035,2576,5,1,292,274,18
BR1_2731155112,7,True,0,0,0,17219,215,52,7.4,False,3,False,1,0,0,16452,236,68,7.4,True,29.777366666666666,767,4,-1,267,304,-37
BR1_2731436593,6,False,0,0,0,17576,235,51,7.4,True,11,True,1,0,0,18977,205,52,7.2,False,29.6432,-1401,-5,-1,286,257,29
BR1_2730951404,12,True,1,0,0,19296,213,60,6.8,True,3,False,0,1,0,15067,183,44,6.4,False,26.620116666666668,4229,9,1,273,227,46
BR1_2730930263,4,True,0,1,0,16342,222,60,7.0,False,6,False,1,0,0,16020,191,63,6.8,True,25.571833333333334,322,-2,-1,282,254,28
BR1_2730777701,6,False,0,0,0,16808,206,58,7.6,False,3,True,1,0,0,16526,250,62,7.6,True,28.123233333333335,282,3,-1,264,312,-48
BR1_2729371659,8,True,1,0,0,16801,235,40,7.0,False,4,False,0,0,0,14433,188,60,6.8,True,27.123683333333332,2368,4,1,275,248,27
BR1_2731642577,9,True,1,1,1,21086,220,72,7.4,True,5,False,0,0,0,17591,244,59,7.6,False,29.051233333333332,3495,4,1,292,303,-11
BR1_2731600720,4,False,1,0,0,14827,205,56,6.6,True,13,True,0,1,0,19723,205,60,7.2,False,25.218933333333332,-4896,-9,1,261,265,-4
BR1_2731651346,10,True,0,0,0,17427,164,49,6.4,True,9,False,0,0,0,16122,153,42,6.2,False,26.74855,1305,1,0,213,195,18
BR1_2731177069,6,True,1,0,0,16350,179,44,6.4,True,7,False,0,1,0,15790,162,52,7.0,False,27.32595,560,-1,1,223,214,9
BR1_2730636114,6,True,0,0,0,17499,221,56,7.4,False,8,False,0,1,0,18323,216,52,7.2,True,28.914283333333334,-824,-2,0,277,268,9
BR1_2730214008,10,True,1,1,0,20429,228,72,7.8,True,8,False,0,0,0,18385,235,68,7.4,False,28.1076,2044,2,1,300,303,-3
BR1_2729679386,5,True,0,1,0,17571,230,66,7.6,True,0,False,1,0,0,16042,276,48,7.4,False,29.194366666666667,1529,5,-1,296,324,-28
BR1_2696507303,6,True,0,1,0,17404,210,47,7.0,True,6,False,1,0,0,14511,170,52,6.4,False,25.110866666666666,2893,0,-1,257,222,35
BR1_2725321076,9,False,1,0,0,17763,215,60,6.8,True,11,True,0,0,0,17042,175,32,6.8,False,27.34515,721,-2,1,275,207,68
BR1_2714385699,8,True,1,1,0,17616,180,64,7.0,True,10,False,0,0,0,17318,177,52,6.8,False,26.594516666666667,298,-2,1,244,229,15
BR1_2731410722,6,True,1,0,0,15886,196,55,6.8,True,6,False,0,0,0,16044,188,60,6.8,False,25.20265,-158,0,1,251,248,3
BR1_2688581450,3,False,0,1,0,15037,190,60,7.0,False,7,True,1,0,0,17022,238,60,7.0,True,27.319266666666667,-1985,-4,-1,250,298,-48
BR1_2687507760,7,True,0,0,0,17879,215,56,7.0,False,2,False,0,0,0,15238,214,52,7.0,True,29.343016666666667,2641,5,0,271,266,5
BR1_2729747344,4,False,0,0,0,15312,206,44,6.8,False,8,True,1,0,0,16642,188,52,6.8,True,27.23975,-1330,-4,-1,250,240,10
BR1_2731857423,6,True,0,0,0,15499,171,68,6.6,False,4,False,1,0,0,14655,197,48,6.6,True,26.470933333333335,844,2,-1,239,245,-6
BR1_2731711453,5,True,1,0,0,16753,237,48,7.2,True,4,False,0,0,0,17406,216,68,7.2,False,28.4664,-653,1,1,285,284,1
BR1_2731651870,10,False,1,0,0,17573,199,56,6.8,True,4,True,0,0,0,14886,207,48,6.8,False,26.610866666666666,2687,6,1,255,255,0
BR1_2731796061,2,False,1,1,0,14180,189,52,6.4,True,8,True,0,0,0,17112,178,60,6.8,False,26.559933333333333,-2932,-6,1,241,238,3
BR1_2731743028,4,False,0,0,0,17210,212,60,7.4,False,12,True,1,1,0,20351,226,60,7.6,True,28.256333333333334,-3141,-8,-1,272,286,-14
BR1_2729257214,10,False,1,1,0,19443,236,72,7.4,True,6,True,0,0,0,18918,240,72,7.2,False,27.59101666666667,525,4,1,308,312,-4
BR1_2731798357,8,True,1,1,0,18114,208,60,7.0,False,8,False,0,0,0,18497,228,63,7.4,True,29.003933333333332,-383,0,1,268,291,-23
BR1_2731642907,3,True,0,0,0,16696,254,52,7.2,False,4,False,1,1,0,17400,214,52,7.2,True,28.14755,-704,-1,-1,306,266,40
BR1_2716005570,7,False,1,1,0,18781,225,64,7.4,True,5,True,0,0,0,16774,220,51,7.2,False,29.7521,2007,2,1,289,271,18
BR1_2728517709,10,True,0,0,0,16520,147,48,6.4,False,10,False,0,0,0,17539,194,44,7.0,True,25.853183333333334,-1019,0,0,195,238,-43
BR1_2729433028,8,True,1,0,0,17522,223,60,6.8,True,2,False,0,0,0,13528,191,48,6.6,False,25.561583333333335,3994,6,1,283,239,44
BR1_2731742779,4,False,0,1,0,16137,178,48,7.2,False,8,True,1,0,0,19006,231,56,7.0,True,27.625616666666666,-2869,-4,-1,226,287,-61
BR1_2731714549,9,True,1,0,0,17803,195,52,7.4,False,9,False,0,0,1,20579,259,60,7.6,True,29.1082,-2776,0,1,247,319,-72
BR1_2731690364,6,True,0,0,0,16594,199,52,7.2,False,12,False,1,0,0,19341,246,48,7.4,True,29.508166666666668,-2747,-6,-1,251,294,-43
BR1_2731668246,6,True,0,1,0,17427,201,68,7.4,True,6,False,1,0,0,15862,172,59,7.0,False,28.01706666666667,1565,0,-1,269,231,38
BR1_2709141507,9,False,1,1,0,19106,216,72,7.6,False,9,True,0,0,0,18571,221,52,7.4,True,29.626466666666666,535,0,1,288,273,15
BR1_2719539662,4,True,0,0,0,14920,215,48,6.6,False,3,False,1,1,0,14762,204,56,7.0,True,25.621016666666666,158,1,-1,263,260,3
BR1_2719541079,4,True,1,0,0,15958,230,80,7.4,True,0,False,0,0,0,13686,216,64,7.0,False,26.651833333333332,2272,4,1,310,280,30
BR1_2719254029,2,False,0,0,0,14573,209,40,6.8,False,11,True,1,0,0,21111,250,64,7.6,True,29.59295,-6538,-9,-1,249,314,-65
BR1_2710380350,11,True,1,0,0,17720,187,48,6.8,True,6,False,0,0,0,16031,156,52,6.8,False,27.213733333333334,1689,5,1,235,208,27
BR1_2730195204,7,True,1,0,0,16138,217,56,6.8,True,2,False,0,0,0,13729,191,44,6.8,False,25.609466666666666,2409,5,1,273,235,38
BR1_2730132825,12,True,1,1,0,20435,218,60,7.0,True,9,False,0,0,0,18796,208,47,6.6,False,29.643866666666668,1639,3,1,278,255,23
BR1_2725843994,4,False,1,0,0,13849,136,44,6.0,False,9,True,0,0,0,18544,224,68,6.8,True,25.43945,-4695,-5,1,180,292,-112
BR1_2725822203,4,True,0,0,0,14942,183,60,6.4,False,9,False,1,0,0,17687,222,64,7.2,True,25.958266666666667,-2745,-5,-1,243,286,-43
BR1_2722028368,7,True,1,1,0,17866,217,64,7.2,True,1,False,0,0,0,13269,174,64,6.8,False,26.0946,4597,6,1,281,238,43
BR1_2717071085,5,False,0,0,0,16196,194,44,6.8,False,17,True,1,0,0,21604,248,52,7.6,True,29.3131,-5408,-12,-1,238,300,-62
BR1_2731076892,3,True,0,0,0,16089,215,72,7.2,False,7,False,1,0,0,18266,232,52,7.4,True,28.153,-2177,-4,-1,287,284,3
BR1_2730187695,7,False,0,1,0,17954,238,68,7.4,True,6,True,0,0,0,17753,243,52,7.2,False,27.941666666666666,201,1,0,306,295,11
BR1_2731803007,9,True,1,1,0,18705,217,72,7.8,True,8,False,0,0,0,17163,171,59,7.2,False,28.05575,1542,1,1,289,230,59
BR1_2730369458,11,False,0,0,0,19014,184,60,7.0,True,14,True,1,1,0,21028,191,59,7.2,False,28.374433333333332,-2014,-3,-1,244,250,-6
BR1_2718265176,2,True,1,1,0,17446,261,72,7.6,True,1,False,0,0,0,15306,231,56,7.4,False,29.863983333333334,2140,1,1,333,287,46
BR1_2718237754,7,True,1,1,0,16296,190,44,6.8,True,1,False,0,0,0,12836,141,48,6.4,False,27.082966666666668,3460,6,1,234,189,45
BR1_2718205213,7,True,1,0,0,16770,199,60,7.2,True,4,False,0,1,0,14999,206,48,6.8,False,25.198033333333335,1771,3,1,259,254,5
BR1_2728553144,3,False,1,0,0,14382,172,60,6.6,True,5,True,0,0,0,16328,188,67,7.0,False,26.309533333333334,-1946,-2,1,232,255,-23
BR1_2728316161,9,True,0,0,0,18170,205,65,7.4,False,9,False,1,1,0,19017,183,60,7.4,True,29.755233333333333,-847,0,-1,270,243,27
BR1_2722292063,12,True,0,0,0,19294,210,52,7.4,True,7,False,1,1,0,17460,207,44,7.2,False,27.575483333333334,1834,5,-1,262,251,11
BR1_2731800105,4,False,0,0,0,15513,195,60,7.0,False,7,True,1,0,0,16539,213,43,7.0,True,26.5389,-1026,-3,-1,255,256,-1
BR1_2727721373,10,False,1,1,0,19647,222,68,7.4,True,7,True,0,0,0,18261,215,68,7.2,False,29.5508,1386,3,1,290,283,7
BR1_2727713037,5,True,0,0,0,15609,189,40,6.8,False,5,False,1,1,0,15522,175,56,6.4,True,27.34435,87,0,-1,229,231,-2
BR1_2698331627,11,True,0,0,0,19925,243,52,7.8,False,10,False,1,0,0,19696,216,56,7.4,True,28.162783333333334,229,1,-1,295,272,23
BR1_2698311573,10,False,0,0,0,18786,219,60,7.8,False,5,True,1,1,0,18031,207,48,7.2,True,28.58745,755,5,-1,279,255,24
BR1_2729672137,4,False,0,0,0,15965,204,55,7.2,False,8,True,0,1,0,18662,209,47,7.4,True,27.94845,-2697,-4,0,259,256,3
BR1_2729640476,8,False,1,0,0,18319,214,56,7.2,False,6,True,0,1,0,17741,211,60,7.2,True,29.175516666666667,578,2,1,270,271,-1
BR1_2726549930,3,False,1,0,0,15856,249,60,7.4,True,3,True,0,1,0,16313,249,48,7.8,False,29.504666666666665,-457,0,1,309,297,12
BR1_2724883965,6,True,0,0,0,14956,149,44,6.4,False,4,False,0,0,0,15594,213,60,7.0,True,26.771833333333333,-638,2,0,193,273,-80
BR1_2731799903,6,False,1,1,0,16067,181,48,7.0,False,14,True,0,0,0,20143,218,64,7.4,True,27.641783333333333,-4076,-8,1,229,282,-53
BR1_2703028818,5,False,1,0,0,15419,171,52,6.8,False,9,True,0,0,0,18083,220,64,7.0,True,25.555233333333334,-2664,-4,1,223,284,-61
BR1_2712196628,10,True,1,0,0,18817,196,52,7.0,True,3,False,0,1,0,17206,229,60,7.4,False,28.778316666666665,1611,7,1,248,289,-41
BR1_2723893168,6,False,0,1,0,16804,171,48,6.6,True,8,True,0,0,0,16425,170,56,6.8,False,26.279483333333335,379,-2,0,219,226,-7
BR1_2722526480,8,True,1,1,0,15746,149,54,7.0,True,5,False,0,0,0,14896,194,44,6.6,False,26.047033333333335,850,3,1,203,238,-35
BR1_2729082002,7,True,0,0,0,15878,209,42,6.8,False,3,False,1,0,0,14959,209,52,6.6,True,26.163866666666667,919,4,-1,251,261,-10
BR1_2729030670,8,True,1,0,0,18918,236,64,7.2,True,5,False,0,1,0,16535,214,62,7.4,False,28.060733333333335,2383,3,1,300,276,24
BR1_2730706656,6,False,1,0,0,15223,189,56,6.6,False,7,True,0,0,0,15658,190,52,7.0,True,25.118716666666668,-435,-1,1,245,242,3
BR1_2728558156,7,True,1,1,0,15921,185,48,6.6,False,5,False,0,0,0,14722,180,52,6.8,True,26.689433333333334,1199,2,1,233,232,1
BR1_2728092685,4,False,0,0,0,14404,171,44,6.4,False,15,True,0,0,0,20072,196,67,7.0,True,25.576983333333335,-5668,-11,0,215,263,-48
BR1_2728078640,10,True,1,0,0,19285,241,49,7.8,True,3,False,0,0,0,15822,232,59,7.2,False,29.10405,3463,7,1,290,291,-1
BR1_2728059283,13,False,0,0,0,18865,186,40,6.6,False,9,True,0,1,0,19432,206,63,7.4,True,29.604583333333334,-567,4,0,226,269,-43
BR1_2722421463,7,True,1,1,0,17487,203,64,7.0,False,8,False,0,0,0,18702,198,64,7.2,True,29.783566666666665,-1215,-1,1,267,262,5
BR1_2711880242,4,False,0,0,0,16382,214,67,7.2,False,8,True,1,1,0,18768,203,66,7.4,True,27.95455,-2386,-4,-1,281,269,12
BR1_2708719288,12,False,0,0,0,20207,210,52,7.4,False,13,True,0,0,0,20041,197,48,7.4,True,28.6204,166,-1,0,262,245,17
BR1_2682649537,9,False,0,0,0,17358,194,48,7.6,False,8,True,1,0,0,19555,264,56,7.6,True,29.483066666666666,-2197,1,-1,242,320,-78
BR1_2682520320,8,True,0,0,0,17930,217,60,7.0,False,9,False,1,0,0,19326,221,67,7.4,True,28.55185,-1396,-1,-1,277,288,-11
BR1_2717421105,11,True,0,0,0,18631,229,67,7.6,False,9,False,0,0,0,18652,217,64,7.6,True,28.33545,-21,2,0,296,281,15
BR1_2728332406,8,False,0,1,0,18593,192,64,7.4,False,15,True,1,0,0,19925,184,60,7.6,True,29.684683333333332,-1332,-7,-1,256,244,12
BR1_2706427531,6,False,0,0,0,15550,162,64,7.0,False,8,True,0,0,0,15637,179,52,6.8,True,25.3575,-87,-2,0,226,231,-5
BR1_2708520997,10,False,1,0,0,19871,224,60,7.6,False,6,True,0,0,0,18576,235,40,7.0,True,29.130433333333333,1295,4,1,284,275,9
BR1_2708007365,8,False,1,1,0,19611,241,79,7.4,True,6,True,0,0,0,16356,205,44,7.0,False,29.036933333333334,3255,2,1,320,249,71
BR1_2731497211,10,True,0,0,0,19197,208,62,6.8,True,3,False,0,0,0,13346,143,46,6.2,False,26.559683333333332,5851,7,0,270,189,81
BR1_2730286319,7,False,0,1,0,18051,198,53,7.2,True,16,True,0,0,0,21211,222,70,7.8,False,28.7496,-3160,-9,0,251,292,-41
BR1_2731000029,6,True,0,0,0,17976,238,60,7.2,True,5,False,1,1,0,16785,210,63,7.6,False,28.024916666666666,1191,1,-1,298,273,25
BR1_2730670386,10,True,0,1,0,17998,167,60,7.0,True,7,False,1,0,0,17180,200,48,6.8,False,29.715333333333334,818,3,-1,227,248,-21
BR1_2729603516,7,False,1,0,0,16061,203,40,7.0,False,4,True,0,0,0,15025,201,56,6.6,True,27.388916666666667,1036,3,1,243,257,-14
BR1_2726244506,3,False,0,0,0,14500,173,52,6.8,True,4,True,1,0,0,15814,214,44,7.0,False,26.44685,-1314,-1,-1,225,258,-33
BR1_2714937439,6,True,1,0,0,16766,227,50,7.2,True,2,False,0,1,0,16534,266,53,7.2,False,28.74288333333333,232,4,1,277,319,-42
BR1_2731901598,7,True,0,0,0,16333,193,44,6.8,False,8,False,1,0,0,16704,163,60,7.0,True,26.656116666666666,-371,-1,-1,237,223,14
BR1_2731740855,5,True,1,0,0,17278,241,48,7.2,True,5,False,0,0,0,16768,213,64,7.0,False,27.961233333333332,510,0,1,289,277,12
BR1_2730560660,7,False,0,1,0,18512,207,84,7.6,False,10,True,1,0,0,18793,209,44,7.0,True,28.43725,-281,-3,-1,291,253,38
BR1_2729886565,8,True,0,1,0,19008,216,60,7.4,False,5,False,1,0,0,17570,232,60,7.4,True,29.680033333333334,1438,3,-1,276,292,-16
BR1_2730875572,4,False,0,1,0,16810,218,71,7.2,False,6,True,1,0,0,17954,247,60,7.6,True,29.201133333333335,-1144,-2,-1,289,307,-18
BR1_2715236365,7,False,0,0,0,16221,181,64,7.0,False,5,True,1,0,0,15487,191,60,6.8,True,26.852966666666667,734,2,-1,245,251,-6
BR1_2731163641,2,False,0,0,0,14602,205,51,7.0,False,8,True,1,0,0,19142,240,59,7.6,True,28.138833333333334,-4540,-6,-1,256,299,-43
BR1_2731709411,6,False,1,0,0,16507,233,52,7.4,False,6,True,0,0,0,18682,256,59,7.4,True,28.846616666666666,-2175,0,1,285,315,-30
BR1_2697559976,5,False,0,1,0,17425,210,52,7.2,False,7,True,0,0,0,19120,249,68,7.6,True,29.936533333333333,-1695,-2,0,262,317,-55
BR1_2731911812,4,False,0,0,0,15605,191,42,7.0,False,8,True,0,1,0,19202,233,56,7.6,True,29.349183333333333,-3597,-4,0,233,289,-56
BR1_2730909289,11,False,0,0,0,17772,178,43,6.6,True,4,True,0,1,0,15983,223,56,6.4,False,26.828716666666665,1789,7,0,221,279,-58
BR1_2730904494,3,False,0,0,0,15184,220,44,7.0,False,3,True,0,0,0,15280,216,64,7.0,True,26.5218,-96,0,0,264,280,-16
BR1_2730552425,10,True,0,0,0,18711,215,56,7.2,False,9,False,1,1,0,20271,268,52,7.8,True,28.07455,-1560,1,-1,271,320,-49
BR1_2717877512,10,True,1,0,0,17546,195,56,7.0,False,12,False,0,1,0,20521,198,56,7.0,True,28.121716666666668,-2975,-2,1,251,254,-3
BR1_2717855039,13,True,1,0,0,18282,156,48,6.8,True,13,False,0,0,0,18276,170,51,6.8,False,26.0344,6,0,1,204,221,-17
BR1_2731663632,7,False,1,0,0,15764,195,48,6.8,True,6,True,0,0,0,16572,198,60,7.0,False,26.678216666666668,-808,1,1,243,258,-15
BR1_2726988256,7,False,0,1,0,17843,214,64,7.2,True,6,True,0,0,0,16399,172,20,6.8,False,27.968366666666668,1444,1,0,278,192,86
BR1_2726960524,12,False,0,0,0,18865,227,52,7.6,False,3,True,0,0,0,14665,171,44,6.4,True,26.7156,4200,9,0,279,215,64
BR1_2726509469,6,False,0,0,0,17223,214,54,7.4,False,9,True,1,1,0,20074,230,72,7.6,True,27.595416666666665,-2851,-3,-1,268,302,-34
BR1_2730085734,10,True,0,1,0,20651,244,76,8.0,True,5,False,0,0,0,16314,200,48,7.6,False,27.833633333333335,4337,5,0,320,248,72
BR1_2729991671,15,True,1,1,0,20505,205,48,7.4,False,8,False,0,0,0,18129,191,52,7.0,True,29.890816666666666,2376,7,1,253,243,10
BR1_2724514274,5,True,0,0,0,14684,183,46,6.6,False,6,False,0,0,0,16245,183,68,7.0,True,25.92175,-1561,-1,0,229,251,-22
BR1_2724131367,4,False,0,0,0,14431,197,43,6.6,True,6,True,0,0,0,15697,208,48,6.8,False,26.650666666666666,-1266,-2,0,240,256,-16
BR1_2731569525,5,False,1,1,0,16387,228,60,7.0,True,4,True,0,0,0,15697,213,44,6.8,False,25.0563,690,1,1,288,257,31
BR1_2731531908,7,False,0,0,0,16809,186,44,6.6,True,6,True,1,1,0,15197,179,68,6.4,False,26.198216666666667,1612,1,-1,230,247,-17
BR1_2712642108,6,True,0,0,0,17663,234,68,7.4,False,4,False,1,0,0,16486,240,64,7.2,True,29.40201666666667,1177,2,-1,302,304,-2
BR1_2712610593,8,False,0,0,0,17981,231,42,7.4,True,9,True,1,0,0,19546,209,72,7.2,False,28.679216666666665,-1565,-1,-1,273,281,-8
BR1_2729622385,9,False,1,1,0,18624,231,64,7.6,True,8,True,0,0,0,17637,181,60,7.2,False,27.9955,987,1,1,295,241,54
BR1_2730882109,4,False,0,0,0,15114,163,47,7.0,False,9,True,0,1,0,20781,255,79,7.6,True,29.002266666666667,-5667,-5,0,210,334,-124
BR1_2722519938,6,True,0,0,0,16026,202,56,6.6,True,5,False,0,0,0,15972,196,36,6.4,False,25.5626,54,1,0,258,232,26
BR1_2722495738,3,False,1,0,0,13791,165,47,6.4,True,7,True,0,0,0,16450,186,48,6.6,False,27.158916666666666,-2659,-4,1,212,234,-22
BR1_2722471748,3,False,1,1,0,14254,173,56,6.8,False,8,True,0,0,0,16639,196,56,7.2,True,25.610433333333333,-2385,-5,1,229,252,-23
BR1_2722346311,11,True,0,0,0,17098,172,40,6.8,True,7,False,0,0,0,15674,177,52,6.6,False,27.417116666666665,1424,4,0,212,229,-17
BR1_2717556798,7,False,1,1,0,18971,226,60,7.4,True,13,True,0,0,0,19592,188,68,7.4,False,28.090216666666667,-621,-6,1,286,256,30
BR1_2730740649,3,False,0,0,0,14700,196,48,6.8,True,7,True,1,0,0,16619,201,52,6.8,False,27.425883333333335,-1919,-4,-1,244,253,-9
BR1_2730679689,3,True,0,1,0,15943,210,72,7.0,False,4,False,1,0,0,15480,206,56,6.8,True,27.297733333333333,463,-1,-1,282,262,20
BR1_2731094466,4,False,0,1,0,13818,147,59,6.4,False,10,True,0,0,0,18528,185,67,7.0,True,26.550183333333333,-4710,-6,0,206,252,-46
BR1_2723397095,10,False,1,1,0,19144,186,58,7.4,True,10,True,0,0,0,19952,233,60,7.6,False,29.534866666666666,-808,0,1,244,293,-49
BR1_2731286304,9,False,0,1,0,20025,269,54,7.4,True,8,True,1,0,0,17828,198,52,7.2,False,27.575533333333333,2197,1,-1,323,250,73
BR1_2731262383,10,True,0,0,0,16988,153,37,6.4,False,11,False,1,1,0,18640,167,59,6.6,True,26.956233333333333,-1652,-1,-1,190,226,-36
BR1_2721933850,8,False,1,0,0,15821,181,56,7.0,True,7,True,0,0,0,17265,219,52,6.8,False,25.9085,-1444,1,1,237,271,-34
BR1_2731594917,8,False,1,0,0,16105,182,36,6.6,True,8,True,0,1,0,16134,161,36,6.4,False,26.878783333333335,-29,0,1,218,197,21
BR1_2731560150,1,False,0,0,0,14713,218,52,7.0,False,7,True,1,1,0,18345,233,52,7.4,True,29.749466666666667,-3632,-6,-1,270,285,-15
BR1_2724721680,7,False,0,0,0,15939,192,30,6.4,True,11,True,1,0,0,18154,171,60,6.6,False,27.151716666666665,-2215,-4,-1,222,231,-9
BR1_2724718359,4,False,0,0,0,13918,170,40,6.8,False,8,True,0,0,0,17841,203,56,6.8,True,25.59405,-3923,-4,0,210,259,-49
BR1_2712283077,6,True,1,0,0,17290,224,60,7.4,True,4,False,0,1,0,17172,244,56,7.2,False,28.427083333333332,118,2,1,284,300,-16
BR1_2712678338,10,False,0,0,0,19625,247,50,7.6,False,5,True,1,1,0,17779,236,72,7.4,True,29.094416666666667,1846,5,-1,297,308,-11
BR1_2712244152,7,True,0,0,0,15810,182,44,6.8,False,4,False,0,0,0,15160,197,44,6.8,True,25.3968,650,3,0,226,241,-15
BR1_2730810856,14,False,0,0,0,19645,161,48,6.8,False,11,True,1,0,0,21116,249,72,7.2,True,29.153666666666666,-1471,3,-1,209,321,-112
BR1_2730762528,2,False,0,1,0,14775,213,44,6.6,False,10,True,1,0,0,17236,208,48,7.0,True,27.39235,-2461,-8,-1,257,256,1
BR1_2725195028,9,True,1,0,0,18901,213,44,7.0,True,5,False,0,0,0,15739,189,61,6.8,False,29.63475,3162,4,1,257,250,7
BR1_2731513412,14,True,0,0,0,21111,226,54,7.6,True,7,False,0,0,0,17733,220,70,7.0,False,29.012183333333333,3378,7,0,280,290,-10
BR1_2731598952,8,True,0,0,0,15958,195,48,6.6,False,10,False,1,0,0,18219,165,64,6.6,True,27.2198,-2261,-2,-1,243,229,14
BR1_2730981800,12,True,1,0,0,19267,173,58,7.0,True,11,False,0,1,0,20245,244,50,7.4,False,29.074783333333333,-978,1,1,231,294,-63
BR1_2731480889,1,False,0,1,0,13733,198,60,7.0,False,6,True,1,0,0,15909,203,56,6.8,True,27.4167,-2176,-5,-1,258,259,-1
BR1_2731474078,6,False,0,1,1,16947,191,48,7.0,True,7,True,0,0,0,15831,188,44,7.0,False,25.0534,1116,-1,0,239,232,7
BR1_2730464253,6,True,0,0,0,16103,215,51,6.8,False,6,False,1,0,0,16100,204,56,6.6,True,25.576383333333332,3,0,-1,266,260,6
BR1_2730047941,4,False,0,1,0,18755,260,64,7.4,True,5,True,1,0,0,17147,250,56,7.2,False,29.870866666666668,1608,-1,-1,324,306,18
BR1_2719281213,7,True,1,0,0,18173,247,64,7.2,True,5,False,0,0,0,18210,242,63,7.4,False,29.04305,-37,2,1,311,305,6
BR1_2719254867,8,True,0,0,0,17261,181,48,6.8,False,13,False,1,1,0,20929,217,60,7.2,True,25.693133333333332,-3668,-5,-1,229,277,-48
BR1_2680526913,8,True,0,1,0,17942,210,60,7.0,True,8,False,1,0,0,16379,209,52,6.6,False,27.010116666666665,1563,0,-1,270,261,9
BR1_2689332298,9,False,0,0,0,19174,256,48,7.6,False,7,True,1,0,0,18170,207,63,6.6,True,28.6739,1004,2,-1,304,270,34
BR1_2723376380,13,True,0,1,0,20857,223,56,7.6,True,9,False,1,0,0,19756,237,60,7.2,False,28.371533333333332,1101,4,-1,279,297,-18
BR1_2727263828,5,True,1,0,0,16080,213,64,7.0,True,2,False,0,0,0,13955,193,60,7.0,False,25.463216666666668,2125,3,1,277,253,24
BR1_2726794995,3,False,0,0,0,15585,189,60,7.0,False,8,True,1,1,0,18902,232,62,7.6,True,29.2375,-3317,-5,-1,249,294,-45
BR1_2730375312,11,False,1,1,0,19734,232,68,7.4,True,5,True,0,0,0,16931,210,48,7.0,False,28.5984,2803,6,1,300,258,42
BR1_2730320223,9,True,0,1,0,19719,229,60,7.2,False,8,False,1,0,0,18959,245,52,7.4,True,29.98585,760,1,-1,289,297,-8
BR1_2731789462,1,False,0,0,0,15253,239,48,7.4,False,6,True,1,0,0,18779,272,60,7.2,True,27.626783333333332,-3526,-5,-1,287,332,-45
BR1_2731768064,8,False,0,1,0,16214,167,50,6.8,False,10,True,1,0,0,19213,232,53,7.0,True,25.23143333333333,-2999,-2,-1,217,285,-68
BR1_2731742424,4,False,1,1,1,19227,271,52,7.4,True,3,True,0,0,0,15632,218,52,6.8,False,29.475683333333333,3595,1,1,323,270,53
BR1_2703962833,4,False,0,0,0,14824,210,65,7.0,False,6,True,1,0,0,16795,227,58,7.0,True,26.995216666666668,-1971,-2,-1,275,285,-10
BR1_2729167033,11,False,0,0,0,19794,153,64,7.0,False,16,True,0,1,1,23004,218,32,7.2,True,28.3667,-3210,-5,0,217,250,-33
BR1_2729113460,10,False,0,0,0,18926,219,40,7.0,True,5,True,0,0,0,14542,173,16,6.8,False,28.049766666666667,4384,5,0,259,189,70
BR1_2729087718,10,False,0,0,0,18101,194,36,7.2,True,11,True,1,1,0,19384,231,60,7.2,False,29.935366666666667,-1283,-1,-1,230,291,-61
BR1_2725022859,3,False,1,1,0,14045,182,48,6.8,False,7,True,0,0,0,17034,199,64,7.2,True,27.232066666666668,-2989,-4,1,230,263,-33
BR1_2731419849,9,False,0,0,1,18178,231,52,7.4,True,13,True,1,1,0,23284,236,76,7.8,False,28.4276,-5106,-4,-1,283,312,-29
BR1_2731415397,4,True,0,0,0,16153,205,48,6.6,False,7,False,1,0,0,16865,212,52,7.0,True,25.925166666666666,-712,-3,-1,253,264,-11
BR1_2731358809,5,True,1,0,0,17202,238,68,7.2,False,7,False,0,1,0,18162,229,56,7.4,True,28.619066666666665,-960,-2,1,306,285,21
BR1_2730238784,12,False,1,0,0,19077,193,56,7.2,False,11,True,0,1,0,21030,255,59,7.4,True,28.682066666666667,-1953,1,1,249,314,-65
BR1_2728034771,6,False,1,0,0,16095,218,56,6.8,False,12,True,0,1,0,18533,236,64,7.2,True,25.366716666666665,-2438,-6,1,274,300,-26
BR1_2731727841,9,True,1,0,0,17593,214,43,6.8,True,7,False,0,0,0,15598,168,72,7.0,False,26.00875,1995,2,1,257,240,17
BR1_2731608231,5,False,1,0,0,17120,229,44,6.8,True,11,True,0,0,0,19979,222,48,7.2,False,27.7141,-2859,-6,1,273,270,3
BR1_2731573519,12,True,0,0,0,20232,233,60,7.6,True,5,False,1,0,0,17773,227,44,7.2,False,29.2816,2459,7,-1,293,271,22
BR1_2731734463,5,True,0,1,0,16408,214,56,6.8,True,6,False,0,0,0,16148,213,52,6.8,False,26.157366666666668,260,-1,0,270,265,5
BR1_2711397577,8,True,0,0,0,15213,191,48,6.6,True,3,False,0,0,0,14647,201,52,6.8,False,25.419433333333334,566,5,0,239,253,-14
BR1_2731319182,8,True,0,1,1,20171,259,48,7.6,False,10,False,0,0,0,20190,248,65,7.6,True,28.586116666666666,-19,-2,0,307,313,-6
BR1_2731220522,11,True,0,0,0,19893,228,40,6.6,True,6,False,0,0,0,18035,227,56,7.2,False,27.5426,1858,5,0,268,283,-15
BR1_2689454792,9,True,0,0,0,18661,200,64,7.0,False,8,False,0,0,0,18244,231,60,7.0,True,28.0817,417,1,0,264,291,-27
BR1_2689446029,14,True,1,0,0,21285,225,60,7.2,True,10,False,0,0,0,18166,173,44,6.6,False,27.8721,3119,4,1,285,217,68
BR1_2688380707,6,True,1,1,0,16956,233,60,7.0,True,2,False,0,0,0,14778,227,40,6.6,False,26.14375,2178,4,1,293,267,26
BR1_2731313086,10,True,1,1,0,20302,295,72,8.0,True,2,False,0,0,0,16224,247,72,7.4,False,29.07245,4078,8,1,367,319,48
BR1_2729062389,13,True,1,0,0,19438,209,44,6.8,False,6,False,0,0,0,17107,205,60,6.6,True,25.895666666666667,2331,7,1,253,265,-12
BR1_2725167651,11,True,1,1,0,18413,210,60,7.0,True,3,False,0,0,0,14530,232,47,6.6,False,25.2198,3883,8,1,270,279,-9
BR1_2704748550,12,True,1,1,1,20455,215,76,7.4,True,6,False,0,0,0,16718,222,56,6.6,False,25.111883333333335,3737,6,1,291,278,13
BR1_2704717586,4,True,0,0,0,15404,194,48,6.6,False,9,False,0,0,0,18240,217,44,7.0,True,26.717133333333333,-2836,-5,0,242,261,-19
BR1_2727855002,3,False,0,0,0,16378,230,56,7.0,False,11,True,1,0,0,19735,218,66,7.8,True,27.74575,-3357,-8,-1,286,284,2
BR1_2728265849,10,True,1,1,0,17546,184,48,7.0,False,7,False,0,0,0,15943,202,45,6.4,True,25.3923,1603,3,1,232,247,-15
BR1_2731916707,8,False,0,0,0,17481,219,52,7.2,True,5,True,0,0,0,16043,216,44,7.2,False,27.635233333333332,1438,3,0,271,260,11
BR1_2729206851,9,True,0,0,0,18790,265,36,7.2,False,8,False,1,1,0,18705,226,60,7.4,True,29.174366666666668,85,1,-1,301,286,15
BR1_2729200769,13,True,0,0,0,19738,249,56,7.6,True,8,False,0,0,0,17627,223,52,7.2,False,29.147633333333335,2111,5,0,305,275,30
BR1_2729195483,7,False,0,0,0,15861,162,72,6.8,False,6,True,1,0,0,17795,248,60,7.0,True,25.183316666666666,-1934,1,-1,234,308,-74
BR1_2731291566,11,True,1,0,0,19789,236,67,7.0,True,5,False,0,0,0,14969,189,44,6.4,False,26.29325,4820,6,1,303,233,70
BR1_2731269064,12,True,1,0,0,19984,232,56,7.2,True,8,False,0,0,0,18354,212,60,7.2,False,28.646533333333334,1630,4,1,288,272,16
BR1_2731729809,5,True,0,0,0,16162,209,68,7.0,False,5,False,0,0,0,16707,245,64,7.2,True,26.063666666666666,-545,0,0,277,309,-32
BR1_2731121598,5,True,0,0,0,15498,187,41,6.6,True,6,False,0,0,0,14861,169,34,6.2,False,26.9662,637,-1,0,228,203,25
BR1_2730715837,4,True,0,0,0,17774,246,52,7.2,False,5,False,0,0,0,16808,198,60,7.0,True,27.9268,966,-1,0,298,258,40
BR1_2716541926,6,True,1,1,0,19953,269,64,7.6,True,2,False,0,0,0,16252,255,60,7.4,False,29.722133333333332,3701,4,1,333,315,18
BR1_2703349389,7,False,0,1,0,18156,203,60,7.0,False,11,True,1,0,0,19380,213,52,6.8,True,29.116316666666666,-1224,-4,-1,263,265,-2
BR1_2731920805,8,False,1,0,0,19288,233,56,7.4,False,7,True,0,1,0,18857,209,67,7.2,True,28.520983333333334,431,1,1,289,276,13
BR1_2731448104,10,False,0,0,0,19599,205,68,7.6,False,8,True,1,0,0,18536,250,52,7.6,True,29.42895,1063,2,-1,273,302,-29
BR1_2731633328,8,False,0,1,1,17902,198,36,6.6,True,9,True,1,0,0,18409,208,72,7.2,False,25.2863,-507,-1,-1,234,280,-46
BR1_2726243000,8,False,1,1,0,18310,221,60,7.0,True,4,True,0,0,0,15353,221,64,7.0,False,27.3004,2957,4,1,281,285,-4
BR1_2726225337,6,False,0,0,0,16157,204,40,6.8,True,9,True,0,0,0,17333,213,36,6.6,False,25.732616666666665,-1176,-3,0,244,249,-5
BR1_2726200155,5,False,0,1,0,17774,235,60,7.2,False,9,True,0,0,0,18623,272,48,7.6,True,28.7348,-849,-4,0,295,320,-25
BR1_2722620638,17,True,1,0,0,22393,238,60,7.8,True,9,False,0,1,0,17617,179,52,6.6,False,29.509816666666666,4776,8,1,298,231,67
BR1_2722538993,7,True,1,0,0,16447,197,51,7.2,False,11,False,0,1,1,21037,213,52,7.4,True,28.108333333333334,-4590,-4,1,248,265,-17
BR1_2722340263,10,False,0,0,0,18728,202,64,7.0,False,17,True,0,1,0,22626,227,48,7.4,True,28.00895,-3898,-7,0,266,275,-9
BR1_2729299647,8,True,1,0,0,19202,236,68,7.6,False,12,False,0,1,0,20769,212,76,7.6,True,29.89705,-1567,-4,1,304,288,16
BR1_2731544801,10,True,1,1,0,18258,210,55,7.2,True,5,False,0,0,0,15317,188,56,6.8,False,26.617233333333335,2941,5,1,265,244,21
BR1_2694628178,10,False,1,0,0,19834,231,73,7.8,True,8,True,0,1,0,19607,216,73,7.4,False,29.465816666666665,227,2,1,304,289,15
BR1_2705027676,5,False,1,1,1,19042,247,67,7.4,False,9,True,0,0,0,19488,262,71,7.6,True,28.965583333333335,-446,-4,1,314,333,-19
BR1_2705013391,6,True,0,0,0,15870,212,48,6.6,True,4,False,1,0,0,15524,203,56,7.0,False,27.0422,346,2,-1,260,259,1
BR1_2719002829,11,True,0,0,0,18442,205,52,6.6,True,6,False,0,0,0,15551,207,44,6.4,False,26.260066666666667,2891,5,0,257,251,6
BR1_2693827297,8,True,0,0,0,18441,238,40,7.2,False,9,False,1,0,0,19612,243,61,7.4,True,27.90651666666667,-1171,-1,-1,278,304,-26
BR1_2693432819,9,False,0,0,0,19445,247,62,7.6,False,6,True,1,1,0,18594,227,55,7.2,True,28.551383333333334,851,3,-1,309,282,27
BR1_2729843383,10,True,1,0,0,19247,240,65,7.0,True,5,False,0,0,0,16736,220,58,7.0,False,25.416716666666666,2511,5,1,305,278,27
BR1_2729509628,12,True,0,0,0,20070,257,42,7.4,False,9,False,1,0,0,18462,190,52,7.0,True,28.55735,1608,3,-1,299,242,57
BR1_2693606701,5,False,0,1,0,16246,214,52,6.8,True,13,True,1,0,0,19867,205,60,6.8,False,26.651733333333333,-3621,-8,-1,266,265,1
BR1_2731150532,11,False,0,0,0,19830,205,56,7.2,True,16,True,0,0,0,20302,178,52,7.0,False,28.834266666666668,-472,-5,0,261,230,31
BR1_2701973887,6,True,0,0,0,16425,205,44,6.4,True,7,False,1,0,0,16070,206,32,6.8,False,25.179133333333333,355,-1,-1,249,238,11
BR1_2701950874,5,False,1,0,0,17322,221,64,7.2,False,7,True,0,1,0,18244,260,60,7.4,True,29.134716666666666,-922,-2,1,285,320,-35
BR1_2731631441,7,False,1,1,0,18490,237,55,7.2,False,4,True,0,0,0,17761,245,83,7.6,True,28.0907,729,3,1,292,328,-36
BR1_2661844222,4,True,0,1,0,16205,214,68,6.8,True,5,False,0,0,0,16085,212,72,7.2,False,26.517716666666665,120,-1,0,282,284,-2
BR1_2718899825,4,False,1,0,0,17251,242,66,7.4,True,6,True,0,1,0,17426,245,40,7.2,False,28.226766666666666,-175,-2,1,308,285,23
BR1_2718875061,9,False,1,1,0,18460,225,68,7.6,True,4,True,0,0,0,16838,236,47,6.8,False,29.9899,1622,5,1,293,283,10
BR1_2727126252,2,False,0,1,0,14421,214,63,7.0,False,3,True,1,0,0,16089,243,62,6.8,True,25.276133333333334,-1668,-1,-1,277,305,-28
BR1_2727118619,5,True,1,0,0,17082,228,52,7.0,False,8,False,0,0,0,18318,214,68,7.4,True,27.937783333333332,-1236,-3,1,280,282,-2
BR1_2727115183,4,False,0,0,0,15692,228,55,7.0,True,1,True,0,0,0,14533,220,56,6.8,False,27.13025,1159,3,0,283,276,7
BR1_2710042964,11,False,0,0,0,20737,264,52,7.2,True,14,True,1,0,0,21627,207,60,7.6,False,27.68115,-890,-3,-1,316,267,49
BR1_2698297892,11,True,0,0,0,20321,185,56,7.0,True,10,False,1,1,0,19037,221,72,7.2,False,28.342016666666666,1284,1,-1,241,293,-52
BR1_2725678638,11,True,0,0,0,19105,233,50,7.2,True,2,False,0,0,0,13966,215,36,6.4,False,25.650316666666665,5139,9,0,283,251,32
BR1_2696600099,3,True,0,0,0,14336,184,52,6.6,False,4,False,1,0,0,15558,211,84,7.2,True,26.58715,-1222,-1,-1,236,295,-59
BR1_2720902098,3,False,0,0,0,14399,183,52,7.0,False,7,True,1,0,0,17163,208,44,6.8,True,26.4608,-2764,-4,-1,235,252,-17
BR1_2720880407,10,False,0,0,0,19463,229,52,7.4,True,3,True,0,0,0,15675,200,53,6.8,False,27.64655,3788,7,0,281,253,28
BR1_2727852667,3,True,1,0,0,14620,187,52,6.8,True,7,False,0,0,0,16816,192,68,6.8,False,25.738616666666665,-2196,-4,1,239,260,-21
BR1_2727840075,11,True,1,1,0,20085,196,60,7.0,False,13,False,0,0,1,20847,198,64,7.2,True,27.88625,-762,-2,1,256,262,-6
BR1_2723914878,5,False,0,0,0,16734,212,56,7.2,False,7,True,1,1,0,19570,262,68,7.4,True,29.188633333333332,-2836,-2,-1,268,330,-62
BR1_2727331857,6,False,0,0,0,16912,222,64,7.2,False,8,True,0,0,0,18226,225,52,7.4,True,29.435083333333335,-1314,-2,0,286,277,9
BR1_2727320259,10,False,1,0,0,16898,171,51,6.4,True,12,True,0,1,0,18693,193,44,6.4,False,26.442633333333333,-1795,-2,1,222,237,-15
BR1_2723979120,5,False,0,0,0,17417,202,60,7.2,True,7,True,1,1,0,17904,218,64,7.2,False,29.061416666666666,-487,-2,-1,262,282,-20
BR1_2714748153,4,False,0,0,0,15179,214,50,6.8,True,3,True,0,0,0,14148,204,44,7.0,False,27.06075,1031,1,0,264,248,16
BR1_2717106231,4,False,1,0,0,15239,221,52,6.6,True,7,True,0,0,0,17740,245,68,6.8,False,25.172533333333334,-2501,-3,1,273,313,-40
BR1_2717081084,12,True,1,0,0,21886,266,59,8.0,True,3,False,0,0,0,16011,216,64,7.0,False,28.733116666666668,5875,9,1,325,280,45
BR1_2731192583,6,False,0,0,0,17314,225,59,7.2,True,7,True,1,0,0,16632,209,68,7.0,False,26.190733333333334,682,-1,-1,284,277,7
BR1_2711789429,8,True,0,1,0,19746,240,56,7.4,False,17,False,1,0,0,21405,209,52,7.4,True,28.30538333333333,-1659,-9,-1,296,261,35
BR1_2705400784,16,True,0,0,0,22740,223,74,8.0,True,7,False,1,1,0,17981,227,54,7.2,False,28.198133333333335,4759,9,-1,297,281,16
BR1_2731923450,8,False,0,0,0,18569,198,84,7.8,True,4,True,1,1,0,16726,216,72,7.2,False,29.1993,1843,4,-1,282,288,-6
BR1_2731918380,11,True,0,1,0,19686,225,76,7.4,False,3,False,1,0,0,16724,247,64,7.2,True,29.54915,2962,8,-1,301,311,-10
BR1_2731195778,10,True,0,0,0,17903,210,52,7.6,False,6,False,1,0,0,18325,200,68,7.4,True,28.66495,-422,4,-1,262,268,-6
BR1_2709814520,11,True,1,1,0,19881,257,48,7.4,True,4,False,0,0,0,16774,206,68,7.0,False,27.534566666666667,3107,7,1,305,274,31
BR1_2709788135,18,False,1,0,0,21771,184,64,7.2,False,10,True,0,0,0,20324,213,56,7.4,True,29.657183333333332,1447,8,1,248,269,-21
BR1_2729706032,8,False,0,0,0,19240,243,64,7.6,True,10,True,1,0,0,18544,193,50,7.0,False,29.9498,696,-2,-1,307,243,64
BR1_2691254167,11,True,0,1,1,20518,241,63,7.0,True,6,False,1,0,0,15708,200,40,7.0,False,26.5145,4810,5,-1,304,240,64
BR1_2679544809,8,False,1,0,0,18159,215,48,7.4,True,9,True,0,0,0,20651,238,60,7.6,False,29.10785,-2492,-1,1,263,298,-35
BR1_2702161621,5,False,1,0,0,15298,206,56,6.6,True,8,True,0,0,0,17864,243,64,7.0,False,27.4188,-2566,-3,1,262,307,-45
BR1_2702111559,10,True,0,1,0,19941,214,59,6.8,False,7,False,0,0,0,15855,155,36,6.2,True,27.129566666666665,4086,3,0,273,191,82
BR1_2725926521,6,True,0,0,0,17551,214,52,6.8,True,14,False,0,0,0,20573,203,56,7.4,False,29.719383333333333,-3022,-8,0,266,259,7
BR1_2725910483,11,True,0,0,0,18740,186,56,7.0,False,8,False,1,0,0,18853,226,51,6.8,True,29.29755,-113,3,-1,242,277,-35
BR1_2713980930,3,False,0,0,0,14616,208,48,6.6,False,5,True,1,0,0,15944,197,43,6.8,True,25.134233333333334,-1328,-2,-1,256,240,16
BR1_2705806819,3,True,0,0,0,16643,251,46,7.0,False,8,False,0,1,0,20198,265,64,7.8,True,28.489616666666667,-3555,-5,0,297,329,-32
BR1_2705483558,10,False,0,0,0,17902,219,52,6.8,False,11,True,1,1,0,19606,188,64,6.8,True,25.643816666666666,-1704,-1,-1,271,252,19
BR1_2730790017,5,False,1,0,0,17007,218,56,7.6,False,4,True,0,0,0,16314,230,52,7.6,True,29.603266666666666,693,1,1,274,282,-8
BR1_2723142736,12,False,0,0,0,17913,145,40,6.4,False,11,True,1,0,0,18317,205,51,6.6,True,27.020533333333333,-404,1,-1,185,256,-71
BR1_2693572006,9,True,1,0,0,17824,195,56,7.0,True,7,False,0,0,0,16735,216,48,7.0,False,25.669083333333333,1089,2,1,251,264,-13
BR1_2729625262,11,True,0,0,0,17655,208,40,7.0,True,7,False,0,0,0,17383,222,47,7.2,False,26.53311666666667,272,4,0,248,269,-21
BR1_2731913563,8,True,0,0,0,18317,251,40,7.2,False,10,False,0,1,0,20093,241,72,7.6,True,28.665333333333333,-1776,-2,0,291,313,-22
BR1_2731907655,4,False,0,0,0,18091,239,64,7.4,False,5,True,0,0,0,18259,279,58,7.6,True,29.19925,-168,-1,0,303,337,-34
BR1_2722980133,3,False,0,0,0,15288,218,76,7.2,False,10,True,1,0,0,19014,225,52,7.4,True,28.210583333333332,-3726,-7,-1,294,277,17
BR1_2725244824,3,False,0,1,0,15580,196,64,7.0,False,9,True,1,0,0,19025,264,48,7.8,True,28.394016666666666,-3445,-6,-1,260,312,-52
BR1_2695281961,12,True,0,1,0,20108,224,59,7.2,True,8,False,0,0,0,17153,188,36,7.2,False,28.996166666666667,2955,4,0,283,224,59
BR1_2731368134,11,True,1,0,0,19597,218,68,7.6,True,5,False,0,1,0,17335,208,64,7.4,False,29.19546666666667,2262,6,1,286,272,14
BR1_2729124814,3,False,1,0,0,15885,214,60,6.8,True,6,True,0,0,0,16417,224,65,7.2,False,27.492466666666665,-532,-3,1,274,289,-15
BR1_2730720696,2,False,0,0,0,16053,237,60,7.2,True,5,True,1,0,0,16718,201,56,7.4,False,27.5773,-665,-3,-1,297,257,40
BR1_2705935348,9,False,0,0,0,17311,221,60,7.0,True,4,True,0,0,0,14128,201,48,6.4,False,27.4532,3183,5,0,281,249,32
BR1_2689292115,6,True,0,0,0,15866,217,54,6.8,True,17,False,1,1,0,22034,239,48,7.4,False,26.822416666666665,-6168,-11,-1,271,287,-16
BR1_2689283876,5,False,1,1,0,18177,263,51,7.4,True,8,True,0,0,0,18274,234,52,7.2,False,29.5859,-97,-3,1,314,286,28
BR1_2720659151,8,True,1,0,0,16993,223,48,6.6,True,7,False,0,0,0,16433,181,76,6.6,False,26.651316666666666,560,1,1,271,257,14
BR1_2728693386,7,False,0,0,0,16663,182,40,6.4,False,8,True,0,0,0,17194,211,38,6.8,True,25.317166666666665,-531,-1,0,222,249,-27
BR1_2731741701,14,True,1,1,0,20299,236,44,7.2,True,5,False,0,0,0,18627,239,56,7.2,False,29.332133333333335,1672,9,1,280,295,-15
BR1_2731652807,8,True,0,0,0,17877,205,36,7.2,False,11,False,1,1,0,19156,233,56,7.6,True,28.108716666666666,-1279,-3,-1,241,289,-48
BR1_2731695435,3,True,0,0,0,14612,203,60,6.8,False,6,False,0,0,0,16028,186,48,6.2,True,26.019116666666665,-1416,-3,0,263,234,29
BR1_2731715671,11,True,0,0,0,19395,189,48,7.0,False,13,False,1,0,0,20524,226,64,7.2,True,29.977366666666665,-1129,-2,-1,237,290,-53
BR1_2714723723,4,True,0,0,0,15720,216,60,7.0,False,3,False,1,0,0,15307,207,60,6.6,True,25.828283333333335,413,1,-1,276,267,9
BR1_2728912038,11,True,0,0,0,19229,219,55,7.0,True,3,False,0,0,0,14479,215,48,6.8,False,26.720716666666668,4750,8,0,274,263,11
BR1_2730850040,5,False,1,0,0,16791,235,56,7.4,True,8,True,0,1,0,19367,236,68,7.4,False,27.79195,-2576,-3,1,291,304,-13
BR1_2729983137,5,True,1,0,0,17733,233,76,7.4,True,8,False,0,1,0,18255,209,52,7.0,False,26.827183333333334,-522,-3,1,309,261,48
BR1_2729959871,4,False,1,0,0,15373,192,64,6.8,True,5,True,0,1,0,15519,204,40,6.6,False,26.570916666666665,-146,-1,1,256,244,12
BR1_2730051194,2,False,1,0,0,14189,191,55,7.0,False,11,True,0,0,0,19652,263,56,7.2,True,26.352866666666667,-5463,-9,1,246,319,-73
BR1_2730009412,11,False,0,0,0,19611,213,67,7.2,False,8,True,1,1,0,19305,233,72,7.8,True,29.738783333333334,306,3,-1,280,305,-25
BR1_2683046914,11,True,0,1,0,18557,199,51,7.2,True,7,False,0,0,0,18656,213,68,7.2,False,29.353016666666665,-99,4,0,250,281,-31
BR1_2731772222,19,True,1,1,0,24354,249,76,7.4,True,12,False,0,0,0,21231,211,40,7.4,False,29.78311666666667,3123,7,1,325,251,74
BR1_2707967809,8,True,0,0,0,18560,214,63,7.2,False,9,False,1,0,0,19165,235,76,7.8,True,28.66785,-605,-1,-1,277,311,-34
BR1_2707952632,2,True,0,0,0,14356,193,60,6.8,False,6,False,1,0,0,17842,246,48,7.4,True,27.441283333333335,-3486,-4,-1,253,294,-41
BR1_2707932953,10,False,0,0,0,18625,245,44,7.4,True,6,True,1,1,0,18083,257,56,7.2,False,29.618716666666668,542,4,-1,289,313,-24
BR1_2728986128,11,True,0,0,0,19320,211,44,7.2,True,11,False,0,0,0,20230,252,55,7.2,False,29.028316666666665,-910,0,0,255,307,-52
BR1_2730435403,8,False,1,1,0,19464,233,53,7.6,False,9,True,0,0,0,18551,215,54,7.2,True,28.643433333333334,913,-1,1,286,269,17
BR1_2729446757,11,False,1,0,0,20105,236,64,7.4,False,9,True,0,0,0,19445,261,60,7.6,True,28.537066666666668,660,2,1,300,321,-21
BR1_2730681942,12,True,0,0,0,20596,214,60,7.2,True,8,False,0,1,0,19512,218,56,7.2,False,29.024866666666668,1084,4,0,274,274,0
BR1_2731830569,7,False,0,0,0,17405,208,56,7.2,False,6,True,0,0,0,19759,300,56,7.6,True,27.827216666666665,-2354,1,0,264,356,-92
BR1_2727531886,5,False,1,0,0,16102,219,52,6.6,True,7,True,0,0,0,15211,170,56,6.6,False,26.594066666666667,891,-2,1,271,226,45
BR1_2708357247,4,True,0,1,0,16755,219,56,7.2,False,9,False,1,0,0,18995,243,51,7.4,True,29.735633333333332,-2240,-5,-1,275,294,-19
BR1_2708204292,8,True,1,0,0,16532,193,48,6.8,True,3,False,0,0,0,15196,219,44,6.6,False,27.45681666666667,1336,5,1,241,263,-22
BR1_2708169820,13,True,0,0,0,20763,234,64,7.6,True,7,False,0,0,0,19005,227,60,7.6,False,29.916133333333335,1758,6,0,298,287,11
BR1_2721401200,7,False,0,0,1,17614,181,60,6.4,True,11,True,0,1,1,18862,158,40,6.2,False,25.028833333333335,-1248,-4,0,241,198,43
BR1_2720352747,12,True,1,0,0,20987,255,68,7.4,False,8,False,0,1,0,19190,255,60,7.2,True,29.36915,1797,4,1,323,315,8
BR1_2698435131,10,True,0,1,0,21219,259,56,7.4,False,6,False,1,0,0,18824,255,67,7.2,True,28.072316666666666,2395,4,-1,315,322,-7
BR1_2731788771,5,True,0,1,0,16186,216,51,6.4,True,2,False,1,0,0,14073,181,56,6.6,False,27.15475,2113,3,-1,267,237,30
BR1_2731748759,9,False,0,1,0,17849,205,52,6.8,True,7,True,1,0,0,15602,174,40,6.4,False,25.144933333333334,2247,2,-1,257,214,43
BR1_2731688499,4,True,0,0,1,16710,231,38,6.8,False,6,False,0,0,0,16485,216,57,6.8,True,25.801183333333334,225,-2,0,269,273,-4
BR1_2731331838,7,False,1,0,0,17467,238,68,7.0,False,9,True,0,0,0,18008,230,52,7.2,True,26.967416666666665,-541,-2,1,306,282,24
BR1_2729318188,9,True,1,1,0,18191,220,60,7.0,True,7,False,0,0,0,16795,197,52,6.8,False,27.17435,1396,2,1,280,249,31
BR1_2717988860,5,True,1,0,0,15961,195,53,6.8,True,3,False,0,1,0,14843,195,47,6.8,False,25.3477,1118,2,1,248,242,6
BR1_2731748378,2,False,1,1,0,15205,245,60,7.0,False,5,True,0,0,0,16966,223,68,7.2,True,27.12945,-1761,-3,1,305,291,14
BR1_2731151051,9,True,1,1,2,21023,238,72,7.4,True,3,False,0,0,0,15853,222,58,7.0,False,27.595216666666666,5170,6,1,310,280,30
BR1_2731119548,13,False,1,0,1,21565,208,44,7.4,True,7,True,0,1,0,17967,223,60,7.4,False,29.55838333333333,3598,6,1,252,283,-31
BR1_2723657325,15,True,1,0,0,22303,235,58,7.4,True,7,False,0,0,0,17139,205,70,7.0,False,27.812083333333334,5164,8,1,293,275,18
BR1_2723637158,1,False,0,0,0,14493,203,72,6.6,False,10,True,1,1,0,18849,211,44,7.0,True,25.50415,-4356,-9,-1,275,255,20
BR1_2731791967,8,False,0,0,0,17061,207,40,6.6,False,12,True,1,0,0,19933,232,60,7.2,True,26.2345,-2872,-4,-1,247,292,-45
BR1_2700914301,5,False,0,1,0,17884,238,76,7.4,False,6,True,1,0,0,17629,231,52,7.4,True,28.708833333333335,255,-1,-1,314,283,31
BR1_2727527748,9,False,1,0,0,18897,224,68,7.2,False,11,True,0,1,1,21882,225,52,7.4,True,29.417916666666667,-2985,-2,1,292,277,15
BR1_2720162980,8,True,0,0,0,17722,227,64,7.2,False,8,False,0,0,0,17791,212,44,7.0,True,28.931083333333333,-69,0,0,291,256,35
BR1_2710358615,4,False,1,1,0,15112,163,68,6.8,True,8,True,0,0,0,16143,198,36,7.0,False,27.18185,-1031,-4,1,231,234,-3
BR1_2697211552,10,True,0,0,0,18991,237,67,7.0,True,10,False,0,1,0,18061,173,39,6.4,False,27.245783333333332,930,0,0,304,212,92
BR1_2731814038,11,True,0,0,0,18794,234,48,7.0,True,10,False,1,0,0,17502,147,64,6.8,False,25.617516666666667,1292,1,-1,282,211,71
BR1_2731782558,6,True,1,1,1,20437,287,56,7.4,True,7,False,0,0,0,17423,182,72,7.2,False,29.639083333333332,3014,-1,1,343,254,89
BR1_2729769890,11,False,0,0,0,19305,229,48,7.2,False,12,True,1,0,0,19584,197,48,7.0,True,29.896116666666668,-279,-1,-1,277,245,32
BR1_2728767445,11,False,1,1,1,21218,230,56,7.6,True,4,True,0,0,0,16220,212,68,6.8,False,29.98095,4998,7,1,286,280,6
BR1_2731315218,2,False,1,0,0,15254,217,62,7.4,False,7,True,0,0,0,19754,263,69,7.8,True,29.126766666666665,-4500,-5,1,279,332,-53
BR1_2731293424,8,False,0,0,0,17835,242,40,7.6,False,6,True,0,0,0,17406,235,52,7.4,True,29.2994,429,2,0,282,287,-5
BR1_2730854819,10,False,0,0,0,17410,235,40,6.8,False,5,True,1,1,0,15324,183,64,6.6,True,26.7645,2086,5,-1,275,247,28
BR1_2711596314,9,True,1,0,0,16751,208,28,6.2,True,7,False,0,1,0,16052,171,48,6.4,False,26.171316666666666,699,2,1,236,219,17
BR1_2711572612,11,True,1,1,0,20867,237,64,7.6,True,2,False,0,0,0,15897,242,64,7.2,False,27.734333333333332,4970,9,1,301,306,-5
BR1_2731804205,5,False,0,0,0,16280,226,56,7.4,False,8,True,0,0,0,18960,244,56,7.4,True,29.273183333333332,-2680,-3,0,282,300,-18
BR1_2731722201,6,True,0,0,0,16662,205,56,6.8,False,3,False,0,0,0,15633,218,57,7.0,True,26.345466666666667,1029,3,0,261,275,-14
BR1_2731732225,3,False,0,0,0,15293,196,52,7.4,False,8,True,1,0,0,19498,227,76,7.4,True,28.045333333333332,-4205,-5,-1,248,303,-55
BR1_2731427093,14,False,1,1,0,21816,223,56,7.4,True,10,True,0,0,0,21018,257,59,7.2,False,28.712,798,4,1,279,316,-37
BR1_2713011761,8,False,1,0,0,17872,193,56,7.0,True,10,True,0,1,0,19540,229,40,7.6,False,29.607733333333332,-1668,-2,1,249,269,-20
BR1_2708580481,5,True,0,1,0,19598,281,76,7.8,False,2,False,1,0,0,16190,255,64,7.6,True,28.419116666666667,3408,3,-1,357,319,38
BR1_2730534894,3,False,0,0,1,16894,244,60,7.4,False,3,True,1,1,0,18563,250,68,7.4,True,27.800733333333334,-1669,0,-1,304,318,-14
BR1_2730523358,10,True,0,1,0,19776,248,60,7.6,True,6,False,0,0,0,18382,256,56,7.0,False,28.71925,1394,4,0,308,312,-4
BR1_2730511326,6,False,0,0,0,16496,188,52,6.4,False,16,True,1,1,0,21036,241,48,7.0,True,27.361366666666665,-4540,-10,-1,240,289,-49
BR1_2722613021,9,False,0,0,0,19669,253,52,7.4,False,11,True,1,1,0,20164,203,60,7.6,True,27.565483333333333,-495,-2,-1,305,263,42
BR1_2729377915,14,True,0,0,0,19225,233,34,6.8,False,11,False,0,0,0,18422,171,52,6.4,True,27.467583333333334,803,3,0,267,223,44
BR1_2729361080,12,False,0,0,0,19939,221,58,7.4,True,10,True,0,0,0,19154,244,48,7.2,False,28.809266666666666,785,2,0,279,292,-13
BR1_2729327341,4,False,0,0,0,16451,188,52,7.4,False,14,True,0,1,0,21763,237,88,8.0,True,29.562066666666666,-5312,-10,0,240,325,-85
BR1_2731063746,5,False,0,1,0,16082,195,44,6.4,False,13,True,0,0,0,19506,196,40,6.6,True,27.367716666666666,-3424,-8,0,239,236,3
BR1_2730720397,9,True,1,1,0,18874,232,76,7.4,True,2,False,0,0,0,13856,204,48,6.6,False,25.992166666666666,5018,7,1,308,252,56
BR1_2729425594,18,True,1,0,0,22570,205,52,7.4,True,7,False,0,0,0,17413,172,48,7.0,False,27.934866666666668,5157,11,1,257,220,37
BR1_2728962128,12,True,0,1,0,17747,205,44,6.8,True,7,False,0,0,0,16178,189,56,6.6,False,25.40355,1569,5,0,249,245,4
BR1_2728937020,7,False,0,0,0,16106,211,51,7.0,True,6,True,0,0,0,15360,195,52,6.6,False,26.167333333333332,746,1,0,262,247,15
BR1_2730645815,12,True,1,0,0,21237,232,60,7.2,True,9,False,0,0,0,19892,204,64,7.2,False,29.401816666666665,1345,3,1,292,268,24
BR1_2700558241,10,True,1,1,0,19390,246,58,7.6,True,9,False,0,0,0,18822,234,57,7.4,False,28.739566666666665,568,1,1,304,291,13
BR1_2705789614,4,False,0,0,0,15193,172,60,6.4,False,11,True,0,1,1,20500,203,44,7.0,True,27.030833333333334,-5307,-7,0,232,247,-15
BR1_2705216252,4,True,0,1,0,16742,222,56,6.8,True,8,False,1,0,0,17096,225,64,6.8,False,25.86465,-354,-4,-1,278,289,-11
BR1_2731867511,4,True,1,1,0,17155,215,76,7.4,False,5,False,0,0,0,17604,252,64,7.4,True,29.284966666666666,-449,-1,1,291,316,-25
BR1_2731784446,5,True,0,0,0,15922,206,54,6.8,True,6,False,1,0,0,16617,207,61,6.8,False,27.006133333333334,-695,-1,-1,260,268,-8
BR1_2731030535,9,True,1,0,0,16367,172,52,6.6,True,2,False,0,0,0,13878,189,48,6.6,False,26.374083333333335,2489,7,1,224,237,-13
BR1_2731006668,6,False,0,0,0,16547,221,48,7.0,True,7,True,0,1,0,16856,192,44,7.0,False,25.08035,-309,-1,0,269,236,33
BR1_2731688442,9,False,0,0,0,19014,250,52,7.4,True,6,True,0,0,0,18378,237,64,7.4,False,27.611766666666668,636,3,0,302,301,1
BR1_2731608135,3,True,1,0,0,15062,211,60,7.0,True,4,False,0,0,0,15495,226,56,6.8,False,27.206683333333334,-433,-1,1,271,282,-11
BR1_2731550575,9,True,0,1,0,20212,241,64,7.8,False,7,False,0,0,0,17988,215,60,7.4,True,28.664983333333332,2224,2,0,305,275,30
BR1_2731256409,8,True,1,0,0,17688,216,60,6.8,True,7,False,0,0,0,15756,197,52,6.6,False,25.471816666666665,1932,1,1,276,249,27
BR1_2706005175,10,False,0,0,0,19381,220,54,7.4,True,20,True,1,0,0,22436,236,65,7.4,False,28.143233333333335,-3055,-10,-1,274,301,-27
BR1_2699258606,6,True,0,0,0,16963,259,59,7.2,False,2,False,1,0,0,14113,219,40,6.6,True,26.846916666666665,2850,4,-1,318,259,59
BR1_2701883852,3,False,1,0,0,15060,228,44,7.0,False,5,True,0,1,0,17146,260,60,7.2,True,25.273366666666668,-2086,-2,1,272,320,-48
BR1_2731554483,4,False,1,0,0,15789,208,66,7.2,False,5,True,0,0,0,15886,198,56,6.8,True,25.143216666666667,-97,-1,1,274,254,20
BR1_2731538687,6,True,0,0,0,17499,237,60,7.4,True,6,False,0,0,0,16509,214,44,7.4,False,28.525866666666666,990,0,0,297,258,39
BR1_2731526690,14,False,1,1,1,21251,216,48,7.4,True,4,True,0,0,0,15641,204,44,6.6,False,27.525233333333333,5610,10,1,264,248,16
BR1_2731507962,7,False,1,0,0,16943,200,72,7.0,True,8,True,0,0,0,17398,221,44,7.2,False,26.499683333333333,-455,-1,1,272,265,7
BR1_2731056305,10,True,1,0,0,20811,272,60,7.8,True,3,False,0,1,0,15839,208,52,7.0,False,28.917166666666667,4972,7,1,332,260,72
BR1_2718973237,7,True,0,0,0,17671,224,46,7.0,False,4,False,1,0,0,17074,202,66,7.2,True,29.497083333333332,597,3,-1,270,268,2
BR1_2707327246,7,True,1,0,0,15729,210,52,7.2,True,5,False,0,0,0,16601,238,44,7.0,False,26.738616666666665,-872,2,1,262,282,-20
BR1_2729340956,10,True,0,0,0,17159,196,44,6.8,False,12,False,1,0,0,18960,189,55,7.0,True,25.469333333333335,-1801,-2,-1,240,244,-4
BR1_2719734761,7,True,0,0,0,17480,205,56,6.6,True,8,False,1,1,0,18014,196,60,7.0,False,25.43665,-534,-1,-1,261,256,5
BR1_2719718768,7,False,0,0,0,15802,173,46,6.4,False,9,True,0,0,0,18426,214,53,6.8,True,25.466833333333334,-2624,-2,0,219,267,-48
BR1_2731834721,6,True,0,0,0,18312,256,76,8.0,True,2,False,1,0,0,16095,246,48,7.2,False,27.78311666666667,2217,4,-1,332,294,38
BR1_2731319973,11,True,0,1,0,19300,228,40,7.6,True,5,False,0,0,0,17283,250,60,7.2,False,28.95928333333333,2017,6,0,268,310,-42
BR1_2731817424,6,True,1,0,0,18438,216,67,7.4,True,8,False,0,0,0,17098,244,17,7.0,False,29.039016666666665,1340,-2,1,283,261,22
BR1_2731795589,5,True,0,0,0,17569,190,78,7.0,False,9,False,0,0,0,18650,223,10,6.4,True,29.207633333333334,-1081,-4,0,268,233,35
BR1_2731772735,7,False,0,0,0,19261,243,59,7.4,False,9,True,1,1,0,19125,223,60,7.2,True,27.946416666666668,136,-2,-1,302,283,19
BR1_2717414621,6,True,0,1,0,18239,225,53,7.8,True,4,False,0,0,0,16569,184,63,7.2,False,28.56373333333333,1670,2,0,278,247,31
BR1_2722946267,9,False,1,0,0,18914,226,60,7.2,True,8,True,0,0,0,19496,248,64,7.6,False,27.685133333333333,-582,1,1,286,312,-26
BR1_2722920471,6,True,0,1,0,18851,248,64,7.8,True,7,False,1,0,0,17273,238,64,7.6,False,28.546833333333332,1578,-1,-1,312,302,10
BR1_2722899209,5,True,1,0,0,16324,238,75,7.0,True,6,False,0,0,0,15715,209,48,7.2,False,25.403083333333335,609,-1,1,313,257,56
BR1_2729975634,3,False,1,0,0,16428,223,64,7.2,True,10,True,0,0,0,18328,216,52,7.4,False,28.539033333333332,-1900,-7,1,287,268,19
BR1_2729953614,11,True,1,0,0,19371,233,68,7.6,True,5,False,0,1,0,17207,225,68,7.0,False,29.228383333333333,2164,6,1,301,293,8
BR1_2730847157,7,True,0,1,0,19030,227,51,7.4,True,8,False,1,0,0,19064,203,60,7.4,False,29.599416666666666,-34,-1,-1,278,263,15
BR1_2729581650,6,True,1,0,0,17084,253,60,7.0,True,6,False,0,0,0,15344,181,40,6.6,False,25.058966666666667,1740,0,1,313,221,92
BR1_2726957495,8,True,0,0,0,19651,245,60,7.4,False,12,False,1,1,0,20243,237,64,7.4,True,29.3878,-592,-4,-1,305,301,4
BR1_2730264526,13,True,0,1,0,20445,219,55,7.4,True,3,False,0,0,0,15673,193,64,7.0,False,27.661516666666667,4772,10,0,274,257,17
BR1_2710064301,10,False,0,1,0,19310,214,61,7.6,False,6,True,1,0,0,18248,236,46,7.0,True,29.710683333333332,1062,4,-1,275,282,-7
BR1_2731231391,7,False,1,0,0,16165,175,52,6.8,True,6,True,0,0,0,16893,200,60,6.8,False,25.940683333333332,-728,1,1,227,260,-33
BR1_2731202800,10,True,0,1,0,20418,249,60,7.6,False,4,False,0,0,0,17226,250,60,7.6,True,28.994516666666666,3192,6,0,309,310,-1
BR1_2731684328,11,True,0,1,0,17884,216,52,7.2,True,4,False,1,0,0,15551,187,61,7.0,False,27.177183333333332,2333,7,-1,268,248,20
BR1_2731662264,11,True,0,1,1,21773,231,60,7.6,True,6,False,1,0,0,17117,238,60,7.4,False,28.56095,4656,5,-1,291,298,-7
BR1_2730989973,2,False,0,1,0,15096,212,60,7.2,False,5,True,1,0,0,16564,248,64,7.6,True,25.084083333333332,-1468,-3,-1,272,312,-40
BR1_2725792654,5,False,1,0,0,17885,232,68,7.4,True,7,True,0,1,0,18783,221,72,7.8,False,28.655083333333334,-898,-2,1,300,293,7
BR1_2725693591,7,True,0,0,0,15803,160,48,6.2,False,11,False,0,0,0,18020,194,60,7.0,True,27.15725,-2217,-4,0,208,254,-46
BR1_2731872345,5,False,0,0,0,16491,218,40,7.0,False,10,True,0,0,0,19921,234,52,7.6,True,29.454266666666665,-3430,-5,0,258,286,-28
BR1_2731863371,8,False,1,1,0,17777,225,60,7.2,True,4,True,0,0,0,15728,197,68,6.8,False,27.1928,2049,4,1,285,265,20
BR1_2713244463,6,False,1,0,0,14264,133,44,6.2,False,15,True,0,0,0,19715,190,54,7.0,True,25.3424,-5451,-9,1,177,244,-67
BR1_2713192188,7,False,0,0,0,16445,193,52,6.4,True,9,True,1,0,0,16581,147,56,6.8,False,25.161616666666667,-136,-2,-1,245,203,42
BR1_2704006975,3,False,0,0,0,14710,208,37,6.4,False,8,True,1,1,0,17447,218,58,6.8,True,25.874066666666668,-2737,-5,-1,245,276,-31
BR1_2731909498,15,True,1,0,0,21706,217,56,7.2,False,9,False,0,1,0,19689,209,52,6.8,True,27.72595,2017,6,1,273,261,12
BR1_2731901095,12,True,0,0,0,19740,244,28,7.4,False,6,False,1,0,0,17682,197,76,7.2,True,28.90805,2058,6,-1,272,273,-1
BR1_2731520656,9,False,0,1,0,17540,190,52,7.0,True,12,True,1,0,0,17948,180,48,6.6,False,27.100583333333333,-408,-3,-1,242,228,14
BR1_2731313518,7,False,0,0,0,17133,222,44,7.2,False,11,True,1,1,0,20754,273,68,7.6,True,29.5974,-3621,-4,-1,266,341,-75
BR1_2730294468,5,False,0,1,0,16850,232,67,7.0,True,6,True,0,0,0,16889,222,52,7.0,False,27.036366666666666,-39,-1,0,299,274,25
BR1_2695335023,3,False,0,0,0,15286,236,56,6.8,True,1,True,0,0,0,14393,223,55,6.8,False,26.1044,893,2,0,292,278,14
BR1_2690203190,11,True,1,1,0,18943,181,60,7.0,True,6,False,0,0,0,15203,179,54,6.4,False,26.61625,3740,5,1,241,233,8
BR1_2702985921,8,True,0,1,0,17390,252,48,7.0,True,2,False,0,0,0,14387,221,48,6.8,False,27.14475,3003,6,0,300,269,31
BR1_2674508737,7,True,1,0,0,16640,210,40,6.8,True,6,False,0,0,0,15620,195,38,6.8,False,27.006766666666667,1020,1,1,250,233,17
BR1_2731539296,5,True,1,0,0,17333,241,64,7.2,True,4,False,0,0,0,16993,251,60,7.8,False,28.6958,340,1,1,305,311,-6
BR1_2731520504,9,True,0,0,0,18855,239,63,7.6,True,3,False,0,0,0,16470,241,56,7.4,False,27.599166666666665,2385,6,0,302,297,5
BR1_2731487075,9,False,0,1,0,19816,254,48,7.2,True,3,True,1,0,0,16332,188,56,7.2,False,27.925233333333335,3484,6,-1,302,244,58
BR1_2712239234,7,False,0,1,0,19621,263,60,7.6,True,12,True,1,0,0,19487,238,56,7.4,False,29.5339,134,-5,-1,323,294,29
BR1_2712195486,11,False,0,0,0,18176,197,60,7.0,True,5,True,1,0,0,15198,175,64,6.8,False,25.3477,2978,6,-1,257,239,18
BR1_2731838550,4,True,0,1,0,15197,203,50,6.8,False,7,False,1,0,0,16297,205,48,7.0,True,25.4839,-1100,-3,-1,253,253,0
BR1_2730058521,7,True,1,0,0,17114,207,52,7.2,False,9,False,0,1,0,20135,229,72,7.4,True,29.99915,-3021,-2,1,259,301,-42
BR1_2730029982,10,True,1,0,0,17872,150,52,7.0,False,6,False,0,0,0,17065,217,44,7.4,True,28.97645,807,4,1,202,261,-59
BR1_2731839711,4,False,1,0,0,16936,230,68,7.4,True,5,True,0,0,0,16937,237,56,7.4,False,28.4083,-1,-1,1,298,293,5
BR1_2730248507,10,True,0,0,0,18593,204,56,7.4,False,6,False,1,1,0,17713,205,64,7.2,True,28.901633333333333,880,4,-1,260,269,-9
BR1_2730217380,7,False,1,0,0,15838,200,62,6.4,True,3,True,0,0,0,14276,155,46,6.6,False,27.044333333333334,1562,4,1,262,201,61
BR1_2730081477,11,True,1,0,0,18170,204,55,7.2,True,5,False,0,1,0,16150,204,56,6.8,False,25.631433333333334,2020,6,1,259,260,-1
BR1_2723660590,10,True,1,1,0,19816,225,68,7.2,True,0,False,0,0,0,14397,211,52,7.0,False,29.154,5419,10,1,293,263,30
BR1_2723325708,8,False,1,0,0,19038,214,60,7.2,True,9,True,0,1,0,19496,199,78,7.0,False,27.600816666666667,-458,-1,1,274,277,-3
BR1_2696605138,12,True,1,0,0,21563,238,68,7.8,False,8,False,0,1,0,19663,251,76,7.8,True,27.929866666666666,1900,4,1,306,327,-21
BR1_2682441594,7,True,1,0,0,17411,229,52,6.8,True,3,False,0,0,0,14077,206,40,6.6,False,25.066883333333333,3334,4,1,281,246,35
BR1_2729611483,5,False,0,0,0,15736,198,52,6.8,True,8,True,0,0,0,17159,187,54,7.0,False,26.635716666666667,-1423,-3,0,250,241,9
BR1_2728516909,9,False,0,1,0,20293,270,60,7.6,False,9,True,1,0,0,20551,256,56,7.8,True,29.885583333333333,-258,0,-1,330,312,18
BR1_2727217485,7,False,0,0,0,18459,207,64,7.6,False,9,True,1,1,0,19693,219,64,7.2,True,29.871016666666666,-1234,-2,-1,271,283,-12
BR1_2726017337,10,False,1,0,0,17811,224,45,6.8,True,7,True,0,0,0,16822,228,46,6.6,False,25.43115,989,3,1,269,274,-5
BR1_2725767231,13,True,1,0,0,19508,218,56,7.0,True,5,False,0,1,0,16638,206,60,6.8,False,27.028583333333334,2870,8,1,274,266,8
BR1_2731156732,9,True,1,1,0,18558,218,64,7.4,True,13,False,0,0,0,20160,214,66,7.8,False,27.972783333333332,-1602,-4,1,282,280,2
BR1_2730445430,3,False,0,0,0,15454,223,52,6.8,False,6,True,1,1,0,16706,203,52,6.6,True,26.56375,-1252,-3,-1,275,255,20
BR1_2728402439,6,True,1,0,0,17199,217,68,7.2,False,3,False,0,0,0,16516,255,63,7.4,True,28.62986666666667,683,3,1,285,318,-33
BR1_2727468217,6,False,1,0,0,15787,193,48,6.4,True,11,True,0,0,0,19156,228,60,7.0,False,27.239933333333333,-3369,-5,1,241,288,-47
BR1_2731838825,9,False,0,0,0,17245,206,42,6.6,True,8,True,0,0,0,16640,193,41,6.6,False,27.0529,605,1,0,248,234,14
BR1_2722282819,7,False,0,0,0,16288,180,52,6.8,True,3,True,1,1,0,15879,231,56,6.8,False,26.98965,409,4,-1,232,287,-55
BR1_2715689878,6,False,0,0,0,18697,272,60,7.6,True,7,True,1,1,0,17343,239,52,7.6,False,27.951966666666667,1354,-1,-1,332,291,41
BR1_2729842840,9,False,1,0,0,20037,274,52,7.2,False,11,True,0,0,0,20537,247,48,7.2,True,27.953733333333332,-500,-2,1,326,295,31
BR1_2730713529,16,True,0,0,0,23038,258,48,7.2,False,9,False,1,1,0,19498,224,92,7.4,True,27.73345,3540,7,-1,306,316,-10
BR1_2730685436,7,False,0,1,0,18139,220,52,7.4,False,9,True,1,0,1,20994,242,80,8.0,True,29.34805,-2855,-2,-1,272,322,-50
BR1_2724194562,10,False,0,0,1,19038,211,62,7.0,True,14,True,0,1,0,20969,175,42,6.6,False,27.988783333333334,-1931,-4,0,273,217,56
BR1_2709767820,7,True,0,1,0,18475,266,52,7.4,False,10,False,0,0,0,20096,267,72,7.8,True,29.684316666666668,-1621,-3,0,318,339,-21
BR1_2708969726,12,False,1,0,0,18920,180,53,7.6,True,7,True,0,0,0,17868,222,51,7.0,False,28.645883333333334,1052,5,1,233,273,-40
BR1_2696184530,17,True,0,0,0,21982,237,64,7.4,False,10,False,0,0,0,20530,233,48,7.2,True,28.135,1452,7,0,301,281,20
BR1_2696070985,9,False,0,0,0,18924,212,64,7.4,False,10,True,1,1,0,19678,215,56,7.4,True,28.125216666666667,-754,-1,-1,276,271,5
BR1_2731482052,7,True,1,0,0,16847,183,48,6.6,False,9,False,0,0,0,17694,211,64,6.8,True,25.71915,-847,-2,1,231,275,-44
BR1_2731379380,11,True,0,0,0,19255,167,48,6.4,False,16,False,0,0,0,20691,212,40,7.0,True,25.76755,-1436,-5,0,215,252,-37
BR1_2707790221,10,False,0,1,0,18167,208,56,6.8,True,3,True,1,0,0,15637,237,44,6.4,False,27.031116666666666,2530,7,-1,264,281,-17
BR1_2705431905,6,False,0,0,0,19363,270,72,7.6,True,6,True,1,1,0,17244,221,60,7.0,False,29.137183333333333,2119,0,-1,342,281,61
BR1_2705426370,7,True,1,0,0,16512,213,58,6.8,True,1,False,0,0,0,13898,188,56,6.6,False,26.786066666666667,2614,6,1,271,244,27
BR1_2730740103,6,False,0,1,0,17563,234,52,7.0,False,9,True,0,0,0,20579,288,84,7.8,True,28.0911,-3016,-3,0,286,372,-86
BR1_2713748881,14,False,1,0,0,20584,244,63,7.4,True,11,True,0,1,0,20582,221,56,7.6,False,29.931166666666666,2,3,1,307,277,30
BR1_2698627465,12,True,0,0,0,19185,226,60,7.4,True,4,False,0,0,0,17543,222,72,7.2,False,28.204883333333335,1642,8,0,286,294,-8
BR1_2730045252,10,True,0,0,0,18544,200,46,7.2,True,6,False,1,0,0,16417,183,60,7.0,False,25.03635,2127,4,-1,246,243,3
BR1_2730022163,6,True,1,0,0,17402,257,60,7.2,False,6,False,0,1,0,16203,202,63,6.8,True,27.266616666666668,1199,0,1,317,265,52
BR1_2728113122,7,False,0,1,0,18961,252,56,7.4,True,9,True,0,0,0,18265,220,43,7.2,False,28.1085,696,-2,0,308,263,45
BR1_2731804101,6,True,1,1,0,15726,211,44,6.4,True,9,False,0,0,0,17259,200,52,6.8,False,27.342283333333334,-1533,-3,1,255,252,3
BR1_2731781069,6,True,0,0,0,16699,192,64,7.4,False,9,False,1,0,0,19131,239,60,7.4,True,29.31736666666667,-2432,-3,-1,256,299,-43
BR1_2731345995,4,False,0,0,0,14724,170,48,6.4,False,11,True,0,0,0,18086,220,51,7.2,True,26.44943333333333,-3362,-7,0,218,271,-53
BR1_2728206818,12,True,0,1,0,20663,239,54,7.4,False,9,False,1,0,0,21034,251,62,7.2,True,27.950233333333333,-371,3,-1,293,313,-20
BR1_2724492537,5,False,1,0,0,15418,216,52,7.2,True,7,True,0,1,0,18825,243,56,7.6,False,28.67035,-3407,-2,1,268,299,-31
BR1_2729149617,7,True,0,0,0,16951,187,59,6.8,False,6,False,1,0,0,15588,193,53,7.0,True,25.400616666666668,1363,1,-1,246,246,0
BR1_2695094038,7,False,0,0,0,17749,239,56,7.2,True,9,True,0,0,0,18835,225,60,7.2,False,28.982766666666667,-1086,-2,0,295,285,10
BR1_2691636003,13,False,0,0,0,18647,182,35,6.4,False,14,True,1,0,0,18244,153,44,6.2,True,27.2542,403,-1,-1,217,197,20
BR1_2691047526,10,False,0,0,0,19388,235,72,7.6,True,5,True,0,0,0,16519,222,64,7.2,False,27.612133333333333,2869,5,0,307,286,21
BR1_2721059744,7,False,0,0,0,17299,263,38,6.8,True,8,True,0,0,0,15963,202,44,6.4,False,27.001216666666668,1336,-1,0,301,246,55
BR1_2718193212,7,False,0,0,1,21077,237,64,7.2,False,10,True,0,1,0,19522,212,56,7.0,True,29.924516666666666,1555,-3,0,301,268,33
BR1_2731802901,11,True,1,0,0,18958,197,56,7.0,True,7,False,0,1,0,18268,205,48,7.0,False,28.7056,690,4,1,253,253,0
BR1_2689955973,5,False,0,1,0,15526,165,68,6.6,True,9,True,0,0,0,16619,191,24,6.2,False,26.113833333333332,-1093,-4,0,233,215,18
BR1_2689188735,14,True,0,1,1,22225,247,52,7.2,True,8,False,1,0,0,17365,209,51,7.0,False,28.202583333333333,4860,6,-1,299,260,39
BR1_2689165718,4,False,0,0,0,14547,220,44,6.8,False,8,True,1,0,0,16229,209,56,7.0,True,27.0125,-1682,-4,-1,264,265,-1
BR1_2731192749,9,True,1,1,0,19234,274,55,7.8,True,8,False,0,0,0,17849,211,64,7.6,False,29.599966666666667,1385,1,1,329,275,54
BR1_2729850672,11,False,0,1,0,18719,198,70,7.0,True,8,True,1,0,0,16249,168,46,6.8,False,25.646066666666666,2470,3,-1,268,214,54
BR1_2729005688,10,True,0,0,0,20091,204,56,7.2,False,15,False,1,0,0,21645,242,64,7.6,True,29.028916666666667,-1554,-5,-1,260,306,-46
BR1_2728969740,10,True,0,1,0,20940,241,68,7.6,True,4,False,0,0,0,17654,270,72,7.2,False,28.5501,3286,6,0,309,342,-33
BR1_2721610898,5,True,0,0,0,15420,184,60,6.6,False,5,False,1,0,0,17255,240,52,6.8,True,25.803083333333333,-1835,0,-1,244,292,-48
BR1_2731124808,7,False,1,0,0,17129,196,75,7.4,True,4,True,0,0,0,16974,228,52,7.0,False,28.644166666666667,155,3,1,271,280,-9
BR1_2731253112,6,True,0,0,0,17607,236,66,7.0,False,7,False,1,1,0,18559,245,74,7.2,True,29.0659,-952,-1,-1,302,319,-17
BR1_2730236074,9,False,1,0,0,17445,205,52,6.6,False,3,True,0,0,0,14793,215,52,6.4,True,26.5928,2652,6,1,257,267,-10
BR1_2694255704,8,False,0,0,0,18968,263,40,7.2,False,5,True,0,0,0,16848,212,56,7.2,True,27.95165,2120,3,0,303,268,35
BR1_2692431619,8,True,0,0,0,17415,225,56,7.2,False,4,False,1,1,1,18300,256,76,7.4,True,29.616983333333334,-885,4,-1,281,332,-51
BR1_2700144360,12,True,0,1,0,21082,234,71,7.6,True,9,False,1,0,0,19340,243,56,7.2,False,28.1113,1742,3,-1,305,299,6
BR1_2699759482,7,False,1,0,0,17911,230,52,6.6,False,13,True,0,1,0,22839,257,72,7.8,True,29.585966666666668,-4928,-6,1,282,329,-47
BR1_2688323026,7,False,1,0,0,17076,200,60,7.0,False,9,True,0,1,0,19082,251,48,7.4,True,25.9188,-2006,-2,1,260,299,-39
BR1_2728820862,5,False,0,1,0,18807,269,60,7.2,False,5,True,1,0,0,17921,264,68,7.6,True,28.301,886,0,-1,329,332,-3
BR1_2730945645,10,False,0,0,0,19246,221,62,7.0,False,9,True,1,1,1,20847,222,52,7.2,True,28.18345,-1601,1,-1,283,274,9
BR1_2723443826,8,False,1,0,0,18711,216,66,7.2,False,8,True,0,0,0,19104,253,66,7.4,True,29.089833333333335,-393,0,1,282,319,-37
BR1_2725948113,6,False,0,0,0,17825,208,64,7.2,True,5,True,1,0,0,17537,220,60,7.0,False,29.116566666666667,288,1,-1,272,280,-8
BR1_2725814403,9,True,0,0,0,20103,215,77,7.4,False,14,False,1,0,0,19996,222,50,7.6,True,29.11485,107,-5,-1,292,272,20
BR1_2718096339,9,False,1,1,0,19301,220,60,7.2,True,8,True,0,0,0,19130,234,62,7.4,False,29.925983333333335,171,1,1,280,296,-16
BR1_2731541632,7,True,0,0,0,19132,265,76,7.6,True,6,False,1,0,0,17575,237,64,7.4,False,28.429,1557,1,-1,341,301,40
BR1_2731069078,6,True,0,0,0,17386,229,59,7.0,False,6,False,0,0,0,15960,201,64,6.8,True,26.795366666666666,1426,0,0,288,265,23
BR1_2730276664,15,True,1,0,0,20350,196,60,7.2,False,11,False,0,1,0,20961,215,52,7.2,True,29.93565,-611,4,1,256,267,-11
BR1_2729645429,8,False,0,0,0,17186,197,44,6.8,True,4,True,0,0,0,14985,193,48,6.8,False,27.141233333333332,2201,4,0,241,241,0
BR1_2706555780,6,False,1,1,0,17091,246,72,7.2,False,3,True,0,0,0,14827,186,64,7.2,True,26.385566666666666,2264,3,1,318,250,68
BR1_2723916833,11,False,0,1,2,21736,206,55,7.4,True,11,True,0,0,0,21122,236,68,7.2,False,28.409266666666667,614,0,0,261,304,-43
BR1_2723904126,9,True,0,1,0,19422,232,72,7.4,True,8,False,1,0,0,17675,231,60,7.0,False,25.690366666666666,1747,1,-1,304,291,13
BR1_2723871890,3,False,0,1,0,17855,267,64,7.6,False,6,True,0,0,0,17636,244,56,7.6,True,28.16005,219,-3,0,331,300,31
BR1_2710041830,6,True,1,0,0,16068,171,48,6.6,False,8,False,0,1,0,18226,204,60,6.8,True,25.168266666666668,-2158,-2,1,219,264,-45
BR1_2730568663,6,False,0,0,0,15766,185,40,6.6,True,11,True,0,0,0,18056,185,51,6.8,False,26.700233333333333,-2290,-5,0,225,236,-11
BR1_2694468754,4,False,0,0,0,15175,168,56,6.6,False,12,True,0,0,0,19623,205,56,6.8,True,25.48903333333333,-4448,-8,0,224,261,-37
BR1_2729623119,6,True,1,0,1,17037,233,40,7.2,True,5,False,0,1,0,19728,264,76,7.8,False,29.094933333333334,-2691,1,1,273,340,-67
BR1_2731869608,4,True,0,1,0,16366,235,56,6.8,True,4,False,1,0,0,15867,223,50,6.6,False,26.087616666666666,499,0,-1,291,273,18
BR1_2731834462,6,True,1,0,0,15829,171,40,6.4,False,6,False,0,0,0,15886,193,40,6.6,True,27.301433333333332,-57,0,1,211,233,-22
BR1_2731821180,7,False,0,0,0,17429,215,40,7.4,False,7,True,1,0,0,17331,236,48,7.0,True,29.612366666666667,98,0,-1,255,284,-29
BR1_2731791755,7,True,0,1,1,20618,273,58,7.4,True,5,False,1,0,0,16681,223,70,7.4,False,28.48285,3937,2,-1,331,293,38
BR1_2731129958,4,False,0,1,0,15600,193,63,6.6,False,6,True,1,0,0,15862,200,60,7.0,True,27.123216666666668,-262,-2,-1,256,260,-4
BR1_2729151537,2,False,0,1,0,15203,230,56,6.6,False,6,True,1,0,0,16392,203,64,7.0,True,26.9254,-1189,-4,-1,286,267,19
BR1_2693903486,7,False,1,0,0,17564,181,51,6.6,False,14,True,0,1,1,22809,227,59,7.2,True,29.209866666666667,-5245,-7,1,232,286,-54
BR1_2693489506,4,False,0,1,0,17366,245,58,7.4,False,8,True,1,0,0,19254,219,56,7.2,True,28.697433333333333,-1888,-4,-1,303,275,28
BR1_2693462996,11,False,0,1,0,20883,295,56,7.6,False,8,True,1,0,0,18188,220,52,7.4,True,29.4312,2695,3,-1,351,272,79
BR1_2731262200,12,False,1,0,0,19545,230,44,7.6,True,6,True,0,0,0,18176,235,60,7.2,False,27.5519,1369,6,1,274,295,-21
BR1_2730238090,5,False,1,0,0,15892,202,64,6.8,False,5,True,0,0,0,16152,201,59,6.8,True,26.591183333333333,-260,0,1,266,260,6
BR1_2726965733,11,False,0,0,0,19340,194,56,7.2,True,7,True,0,0,0,17226,217,56,7.0,False,28.35715,2114,4,0,250,273,-23
BR1_2726866415,3,False,0,0,0,17081,251,76,7.4,True,4,True,1,1,0,15620,195,68,7.0,False,28.092583333333334,1461,-1,-1,327,263,64
BR1_2709315552,4,True,0,0,0,16018,245,48,7.0,False,11,False,0,0,0,19715,231,59,7.4,True,28.0973,-3697,-7,0,293,290,3
BR1_2709231535,12,True,0,0,0,21277,236,68,7.4,True,7,False,0,0,0,17119,217,44,6.6,False,29.4549,4158,5,0,304,261,43
BR1_2729543091,6,False,0,0,0,16132,195,56,6.4,False,8,True,0,0,0,16631,186,44,6.4,True,26.38,-499,-2,0,251,230,21
BR1_2729427709,12,False,1,0,1,20702,232,58,7.0,True,9,True,0,1,0,19291,229,74,7.6,False,27.592116666666666,1411,3,1,290,303,-13
BR1_2724724128,6,False,0,0,0,18010,229,64,7.4,True,8,True,1,0,0,17335,208,48,7.0,False,27.55735,675,-2,-1,293,256,37
BR1_2724713372,6,False,1,0,0,15849,200,44,6.6,False,11,True,0,0,0,18535,191,52,6.6,True,26.270133333333334,-2686,-5,1,244,243,1
BR1_2724704312,8,False,1,1,0,17996,196,64,7.4,True,8,True,0,0,0,17929,208,53,7.2,False,29.53525,67,0,1,260,261,-1
BR1_2729422611,2,True,1,1,0,15813,233,64,7.2,True,4,False,0,0,0,16901,226,72,7.2,False,29.613483333333335,-1088,-2,1,297,298,-1
BR1_2724153646,6,False,0,1,0,17234,224,48,6.6,False,10,True,0,0,0,18156,195,49,7.0,True,26.987016666666666,-922,-4,0,272,244,28
BR1_2724135580,6,True,0,0,0,16097,165,59,6.8,False,7,False,1,0,0,17391,218,40,6.8,True,26.86115,-1294,-1,-1,224,258,-34
BR1_2705720302,12,True,1,1,0,19598,154,63,6.6,True,5,False,0,0,0,15130,179,40,6.4,False,27.083766666666666,4468,7,1,217,219,-2
BR1_2702839675,2,False,0,0,0,16249,281,44,7.4,True,5,True,1,0,0,18573,277,68,7.8,False,29.621166666666667,-2324,-3,-1,325,345,-20
BR1_2730754475,10,True,0,0,0,17678,159,57,6.8,False,13,False,0,0,0,19534,214,50,7.0,True,29.527816666666666,-1856,-3,0,216,264,-48
BR1_2731518646,12,True,1,0,0,19626,216,50,7.2,True,14,False,0,0,0,20337,230,58,7.0,False,29.608116666666668,-711,-2,1,266,288,-22
BR1_2731504237,8,False,0,1,0,17287,229,48,6.6,False,12,True,1,0,0,18154,197,43,6.6,True,25.466616666666667,-867,-4,-1,277,240,37
BR1_2730966449,6,True,1,1,0,16169,195,56,6.8,False,6,False,0,0,0,17089,208,52,7.0,True,25.12076666666667,-920,0,1,251,260,-9
BR1_2728876681,8,False,0,0,0,18546,232,51,7.2,True,13,True,0,0,0,19436,225,56,7.4,False,28.861966666666667,-890,-5,0,283,281,2
BR1_2728362528,4,False,1,0,0,16731,250,64,7.6,False,7,True,0,0,0,18690,252,56,7.4,True,28.523333333333333,-1959,-3,1,314,308,6
BR1_2731873319,9,True,0,0,1,19874,203,52,7.0,False,9,False,1,0,0,19372,220,40,6.8,True,28.70375,502,0,-1,255,260,-5
BR1_2731646584,9,True,0,0,0,18557,219,44,6.8,True,10,False,0,1,0,18693,208,52,6.8,False,26.160983333333334,-136,-1,0,263,260,3
BR1_2731846939,5,True,0,0,0,17453,238,60,7.6,False,5,False,0,1,0,18420,263,80,7.6,True,27.584466666666668,-967,0,0,298,343,-45
BR1_2731504261,9,True,1,0,0,19001,235,52,7.6,False,6,False,0,0,0,18419,224,47,7.2,True,29.9384,582,3,1,287,271,16
BR1_2731473124,3,False,1,0,0,14416,201,57,6.0,False,9,True,0,1,2,20187,237,50,6.8,True,25.82165,-5771,-6,1,258,287,-29
BR1_2669037741,5,True,0,0,0,16574,205,60,7.4,False,6,False,1,1,0,17693,228,50,7.0,True,28.54855,-1119,-1,-1,265,278,-13
BR1_2730679234,9,True,0,0,0,16990,212,44,7.0,False,5,False,0,0,0,16571,229,58,6.6,True,26.786783333333332,419,4,0,256,287,-31
BR1_2730652763,4,False,0,1,0,15977,203,51,6.8,False,8,True,1,0,0,17330,216,60,7.0,True,27.161,-1353,-4,-1,254,276,-22
BR1_2730468406,9,True,1,1,0,17795,218,64,7.2,True,1,False,0,0,0,13329,199,44,6.4,False,25.841216666666668,4466,8,1,282,243,39
BR1_2730277102,5,True,0,1,0,18421,229,56,7.2,True,8,False,1,0,0,18014,224,52,7.2,False,28.243383333333334,407,-3,-1,285,276,9
BR1_2712924113,6,True,1,1,0,15794,179,56,6.8,True,5,False,0,0,0,15273,203,60,7.0,False,26.00186666666667,521,1,1,235,263,-28
BR1_2712905873,10,True,0,1,0,17991,191,64,7.0,True,3,False,1,0,0,14636,190,48,6.6,False,25.471683333333335,3355,7,-1,255,238,17
BR1_2731443745,6,False,0,0,0,15523,202,48,6.4,False,10,True,1,0,0,19388,223,60,7.2,True,26.04655,-3865,-4,-1,250,283,-33
BR1_2729009293,11,False,1,0,0,20893,246,80,7.6,True,8,True,0,1,0,18994,211,64,7.4,False,27.730583333333332,1899,3,1,326,275,51
BR1_2728979538,6,False,1,0,0,18855,278,64,7.8,True,6,True,0,1,0,18754,281,76,7.8,False,28.517583333333334,101,0,1,342,357,-15
BR1_2713567619,16,True,0,1,1,22719,223,60,7.8,True,7,False,0,0,0,18283,216,72,7.4,False,29.663516666666666,4436,9,0,283,288,-5
BR1_2713536047,6,False,0,0,0,15126,202,52,6.6,False,7,True,1,0,0,16523,213,52,6.8,True,26.77095,-1397,-1,-1,254,265,-11
BR1_2713509509,13,False,0,0,0,21839,233,85,7.6,True,10,True,0,0,0,19440,216,44,7.2,False,29.612116666666665,2399,3,0,318,260,58
BR1_2696469056,3,True,0,1,0,16561,220,52,7.0,False,9,False,1,0,0,19587,208,71,7.6,True,28.103783333333332,-3026,-6,-1,272,279,-7
BR1_2693194657,4,False,0,0,0,16217,231,56,6.6,False,13,True,0,0,0,19946,239,59,7.2,True,26.0775,-3729,-9,0,287,298,-11
BR1_2731836497,3,True,0,0,0,15258,199,52,6.4,False,8,False,1,0,0,17155,224,52,7.0,True,25.210683333333332,-1897,-5,-1,251,276,-25
BR1_2731463106,13,True,1,0,0,19109,227,48,6.8,False,7,False,0,0,0,16338,161,64,6.8,True,26.68948333333333,2771,6,1,275,225,50
BR1_2731847387,7,True,0,0,0,15702,187,44,6.8,True,8,False,0,0,0,15486,151,48,6.6,False,25.50475,216,-1,0,231,199,32
BR1_2716610808,6,False,0,1,0,17226,258,66,7.8,True,7,True,0,0,0,18897,251,44,7.0,False,27.948333333333334,-1671,-1,0,324,295,29
BR1_2716585920,7,True,0,1,2,20416,254,64,7.2,True,10,False,1,0,0,19631,233,64,7.2,False,27.5338,785,-3,-1,318,297,21
BR1_2716570769,9,True,0,0,0,18993,220,68,7.4,True,6,False,0,1,0,17575,204,44,7.0,False,28.19025,1418,3,0,288,248,40
BR1_2731651785,4,False,2,1,0,17185,231,63,7.2,True,7,True,0,0,0,18238,209,60,7.2,False,29.896533333333334,-1053,-3,2,294,269,25
BR1_2719951369,5,True,1,0,0,15873,212,55,6.8,True,3,False,0,0,0,15223,199,60,6.6,False,27.130416666666665,650,2,1,267,259,8
BR1_2719004812,11,True,0,0,0,19718,215,80,7.4,True,8,False,0,0,0,17856,245,44,7.0,False,27.739866666666668,1862,3,0,295,289,6
BR1_2718998308,5,False,0,0,0,15223,175,60,6.8,False,8,True,1,1,0,17342,208,72,7.0,True,27.0121,-2119,-3,-1,235,280,-45
BR1_2690593326,7,False,0,0,0,15190,180,44,6.8,False,8,True,1,0,0,15687,135,68,6.2,True,27.163016666666667,-497,-1,-1,224,203,21
BR1_2685652066,6,False,0,0,0,18536,236,60,7.6,False,12,True,1,1,0,20539,229,60,8.0,True,29.679983333333332,-2003,-6,-1,296,289,7
BR1_2688811866,11,True,1,0,0,19779,212,68,7.0,True,5,False,0,0,0,16452,225,44,6.8,False,28.126066666666667,3327,6,1,280,269,11
BR1_2688733969,11,True,0,0,0,17477,170,55,6.6,False,9,False,1,0,0,17099,180,60,7.0,True,27.305766666666667,378,2,-1,225,240,-15
BR1_2725882985,14,True,0,0,0,20880,190,52,7.4,True,12,False,1,1,0,20040,205,71,7.6,False,28.52235,840,2,-1,242,276,-34
BR1_2727735674,7,True,0,1,0,17150,197,71,7.0,True,5,False,0,0,0,15251,204,48,6.6,False,26.354616666666665,1899,2,0,268,252,16
BR1_2697743504,8,True,0,1,0,17616,208,48,6.8,True,4,False,1,0,0,14600,214,52,6.6,False,27.48828333333333,3016,4,-1,256,266,-10
BR1_2697698582,6,True,0,0,0,17380,210,68,7.0,False,11,False,1,0,0,19565,223,76,7.4,True,29.07385,-2185,-5,-1,278,299,-21
BR1_2697687399,8,True,0,0,0,16411,179,58,6.8,True,9,False,1,0,0,17208,217,56,7.0,False,25.59348333333333,-797,-1,-1,237,273,-36
BR1_2697675766,19,True,0,0,0,21165,198,47,7.2,True,11,False,0,0,0,17394,181,44,6.8,False,25.90213333333333,3771,8,0,245,225,20
BR1_2715105616,12,True,1,1,1,22472,254,56,7.8,True,6,False,0,0,0,17306,219,44,7.2,False,28.043383333333335,5166,6,1,310,263,47
BR1_2714548022,5,True,0,0,0,15677,217,48,6.8,False,10,False,0,0,0,18292,218,60,7.2,True,25.268816666666666,-2615,-5,0,265,278,-13
BR1_2714487330,7,False,1,0,0,17671,218,52,7.2,False,11,True,0,1,1,22745,245,56,7.6,True,29.265166666666666,-5074,-4,1,270,301,-31
BR1_2691883113,10,False,1,0,0,20349,233,56,7.0,False,10,True,0,0,0,19322,235,56,7.2,True,28.000566666666668,1027,0,1,289,291,-2
BR1_2731381454,4,False,1,0,0,15265,195,56,6.6,False,7,True,0,1,0,17967,207,64,7.0,True,25.168383333333335,-2702,-3,1,251,271,-20
BR1_2731737792,4,False,0,0,0,16523,196,48,6.6,False,9,True,1,0,0,18137,220,60,7.4,True,29.601783333333334,-1614,-5,-1,244,280,-36
BR1_2730921956,8,True,0,1,0,17257,207,48,6.6,True,7,False,1,0,0,17013,208,40,6.8,False,26.123816666666666,244,1,-1,255,248,7
BR1_2730779814,7,False,0,1,0,16429,166,48,6.4,False,11,True,1,0,0,18019,187,43,6.4,True,26.412416666666665,-1590,-4,-1,214,230,-16
BR1_2731841645,7,False,1,0,0,15595,161,47,6.4,False,11,True,0,1,0,19151,198,44,6.8,True,25.9425,-3556,-4,1,208,242,-34
BR1_2711605584,8,False,1,1,0,17585,218,72,7.0,True,5,True,0,0,0,16276,206,51,7.0,False,25.467033333333333,1309,3,1,290,257,33
BR1_2709379119,4,True,0,0,0,16299,243,68,7.2,True,4,False,1,0,0,14604,209,48,7.2,False,26.18875,1695,0,-1,311,257,54
BR1_2730531926,7,True,0,0,0,17145,212,52,6.6,False,7,False,1,0,0,16603,220,47,7.0,True,26.6472,542,0,-1,264,267,-3
BR1_2727844197,6,False,0,0,0,18392,261,68,7.6,False,4,True,1,1,0,16943,235,72,7.6,True,29.821866666666665,1449,2,-1,329,307,22
BR1_2707415320,3,False,0,0,0,14914,189,51,6.6,False,11,True,1,0,0,18859,203,44,6.8,True,27.456333333333333,-3945,-8,-1,240,247,-7
BR1_2731354709,12,False,0,1,0,21008,225,51,7.4,False,10,True,1,0,0,19011,228,44,7.2,True,29.472483333333333,1997,2,-1,276,272,4
BR1_2731642560,10,True,1,0,0,17159,192,56,6.8,True,5,False,0,0,0,15521,190,48,6.4,False,26.233133333333335,1638,5,1,248,238,10
BR1_2730115975,9,False,1,0,1,16358,169,44,6.6,False,10,True,0,1,0,19846,221,47,7.0,True,26.394116666666665,-3488,-1,1,213,268,-55
BR1_2723913662,5,True,0,0,0,14422,171,40,6.8,False,5,False,0,0,0,16803,208,76,7.0,True,25.427133333333334,-2381,0,0,211,284,-73
BR1_2723897771,3,False,1,1,0,18239,255,60,7.6,True,5,True,0,0,0,17796,240,76,7.4,False,28.596916666666665,443,-2,1,315,316,-1
BR1_2731665476,10,True,0,0,0,17439,202,44,6.8,False,7,False,0,0,0,17000,201,67,6.8,True,27.1187,439,3,0,246,268,-22
BR1_2712873063,8,False,1,0,0,16526,188,56,6.8,False,6,True,0,1,0,17227,214,56,7.2,True,26.348733333333332,-701,2,1,244,270,-26
BR1_2692484338,8,True,0,0,0,17078,203,48,6.8,True,7,False,1,0,0,17298,228,48,7.0,False,26.919233333333334,-220,1,-1,251,276,-25
BR1_2690377949,5,True,0,0,0,17079,222,48,7.4,True,6,False,0,1,0,18287,263,52,7.4,False,29.5438,-1208,-1,0,270,315,-45
BR1_2730776934,6,False,1,0,0,16993,231,55,7.2,True,4,True,0,0,0,16040,200,64,7.0,False,25.583583333333333,953,2,1,286,264,22
BR1_2677210371,12,True,0,1,0,20725,223,47,7.8,False,7,False,1,0,0,17592,228,64,7.6,True,28.611466666666665,3133,5,-1,270,292,-22
BR1_2677139014,4,True,1,1,0,15233,185,36,6.6,True,8,False,0,0,0,16935,183,51,6.8,False,25.383333333333333,-1702,-4,1,221,234,-13
BR1_2715743748,10,True,0,0,0,18236,197,51,7.0,False,5,False,1,1,0,16611,210,71,6.6,True,27.43355,1625,5,-1,248,281,-33
BR1_2731247823,2,False,0,1,0,14193,184,49,6.8,False,9,True,0,0,0,17799,207,50,7.0,True,26.874066666666668,-3606,-7,0,233,257,-24
BR1_2729940526,7,False,1,1,0,16700,202,68,6.8,False,7,True,0,0,0,18546,241,52,7.8,True,29.95915,-1846,0,1,270,293,-23
BR1_2725501651,8,False,0,1,0,17623,195,48,7.0,False,7,True,1,0,0,16136,204,48,6.8,True,27.324383333333333,1487,1,-1,243,252,-9
BR1_2702657565,11,False,1,1,1,22012,231,76,7.8,False,8,True,0,0,1,20328,236,56,7.4,True,27.6436,1684,3,1,307,292,15
BR1_2730496789,5,False,0,0,0,16860,213,42,7.0,False,5,True,1,0,0,17212,219,77,7.2,True,28.665633333333332,-352,0,-1,255,296,-41
BR1_2702003276,7,False,0,0,0,18234,232,52,7.0,False,8,True,1,1,0,18806,198,64,7.2,True,28.31485,-572,-1,-1,284,262,22
BR1_2714447865,3,True,0,0,0,17192,244,55,7.4,False,4,False,1,1,0,17245,248,72,7.8,True,29.602783333333335,-53,-1,-1,299,320,-21
BR1_2714126491,9,False,1,1,0,20067,271,64,7.6,True,3,True,0,0,0,16263,243,48,7.2,False,29.129933333333334,3804,6,1,335,291,44
BR1_2714100564,1,False,0,0,0,15552,255,56,7.4,False,4,True,0,1,0,18910,303,80,8.0,True,28.032583333333335,-3358,-3,0,311,383,-72
BR1_2731543025,9,True,0,0,0,17260,200,60,7.0,True,2,False,0,0,0,14038,200,44,6.6,False,25.017216666666666,3222,7,0,260,244,16
BR1_2680758943,7,True,0,0,0,17866,228,64,7.4,True,2,False,1,0,0,16347,246,60,7.0,False,27.77535,1519,5,-1,292,306,-14
BR1_2680569992,13,True,0,0,0,20301,231,40,7.8,False,4,False,0,0,0,15349,178,40,6.6,True,28.995383333333333,4952,9,0,271,218,53
BR1_2730265035,9,False,1,1,0,18782,239,48,7.2,True,3,True,0,0,0,15999,233,44,7.2,False,28.104,2783,6,1,287,277,10
BR1_2718278236,3,False,1,0,0,13677,183,44,6.6,False,10,True,0,0,0,18760,226,68,7.0,True,26.046833333333332,-5083,-7,1,227,294,-67
BR1_2710699245,5,True,1,1,0,17111,218,75,7.6,False,4,False,0,0,0,17828,268,68,7.6,True,27.722533333333335,-717,1,1,293,336,-43
BR1_2710676627,8,False,0,0,0,17627,235,50,7.0,True,9,True,1,0,0,17228,218,56,7.0,False,26.99805,399,-1,-1,285,274,11
BR1_2710195116,7,True,0,1,0,16822,203,68,6.8,True,5,False,0,0,0,15275,192,56,7.0,False,25.199583333333333,1547,2,0,271,248,23
BR1_2705575894,13,True,1,0,0,20397,246,64,7.6,True,4,False,0,0,0,15963,224,52,7.0,False,28.357383333333335,4434,9,1,310,276,34
BR1_2726511360,8,False,1,0,0,18437,233,61,7.4,True,7,True,0,0,0,17942,241,52,7.2,False,28.061883333333334,495,1,1,294,293,1
BR1_2730377496,11,True,0,0,0,19690,247,63,7.2,False,14,False,0,0,0,22092,246,54,7.6,True,29.204483333333332,-2402,-3,0,310,300,10
BR1_2730367692,5,True,0,0,0,17444,223,56,7.2,False,11,False,1,0,0,19259,214,59,7.4,True,28.051216666666665,-1815,-6,-1,279,273,6
BR1_2730374450,8,True,0,0,0,19000,219,64,7.2,True,7,False,1,0,0,18434,248,56,7.2,False,28.6904,566,1,-1,283,304,-21
BR1_2730613982,9,True,0,0,0,18037,199,52,7.0,False,8,False,0,1,0,17412,218,60,6.8,True,25.58715,625,1,0,251,278,-27
BR1_2724957196,7,True,1,0,0,16516,186,48,6.8,False,5,False,0,0,0,15810,204,56,7.0,True,26.165533333333332,706,2,1,234,260,-26
BR1_2731007837,6,False,1,0,0,16749,208,49,6.8,True,8,True,0,0,0,16348,193,44,6.6,False,26.2525,401,-2,1,257,237,20
BR1_2730508667,13,True,1,0,0,19275,165,60,6.8,True,14,False,0,0,0,20706,226,48,6.8,False,25.888516666666668,-1431,-1,1,225,274,-49
BR1_2731715802,9,False,0,0,0,17860,208,48,7.4,False,14,True,1,1,0,22869,263,56,7.6,True,28.924633333333333,-5009,-5,-1,256,319,-63
BR1_2728562541,8,False,0,0,1,18945,237,56,7.2,True,7,True,0,0,0,16818,193,55,6.6,False,25.896083333333333,2127,1,0,293,248,45
BR1_2723084096,6,False,0,0,0,15244,177,52,6.6,False,6,True,0,0,0,16932,218,52,6.8,True,26.4517,-1688,0,0,229,270,-41
BR1_2730313429,3,True,0,0,0,16112,225,64,7.4,False,6,False,1,0,0,18983,263,59,7.8,True,28.512366666666665,-2871,-3,-1,289,322,-33
BR1_2692399290,6,True,0,0,0,17774,230,52,7.0,False,8,False,0,0,0,19089,254,68,7.8,True,29.945416666666667,-1315,-2,0,282,322,-40
BR1_2731403235,5,True,0,1,0,19153,259,60,7.4,False,8,False,1,0,0,18010,199,64,7.2,True,27.884016666666668,1143,-3,-1,319,263,56
BR1_2714886824,6,True,0,0,0,17997,232,56,7.2,False,9,False,1,0,0,19033,238,68,7.6,True,29.670383333333334,-1036,-3,-1,288,306,-18
BR1_2731585567,8,True,1,0,0,18616,255,44,7.4,False,9,False,0,1,0,18904,220,47,7.2,True,29.687366666666666,-288,-1,1,299,267,32
BR1_2703620157,4,True,1,1,0,17547,223,56,7.0,True,4,False,0,0,0,16294,218,63,7.4,False,27.533666666666665,1253,0,1,279,281,-2
BR1_2731465587,8,False,1,0,0,16851,198,60,6.8,True,5,True,0,0,0,16722,235,40,6.6,False,26.077483333333333,129,3,1,258,275,-17
BR1_2730918769,12,False,1,1,1,21242,228,40,7.6,True,7,True,0,0,0,17714,210,60,7.2,False,28.077,3528,5,1,268,270,-2
BR1_2730776566,4,False,0,1,0,17390,260,72,7.8,True,5,True,1,0,0,17708,230,76,7.4,False,28.40961666666667,-318,-1,-1,332,306,26
BR1_2730132442,6,False,0,1,1,17172,211,48,6.6,False,8,True,0,0,0,16932,219,48,6.8,True,27.435283333333334,240,-2,0,259,267,-8
BR1_2715770259,5,False,0,0,0,15391,187,60,6.8,False,7,True,1,0,0,16536,191,64,7.0,True,26.37145,-1145,-2,-1,247,255,-8
BR1_2715734295,1,False,0,0,0,13818,191,44,6.4,False,9,True,1,0,0,17854,203,84,7.6,True,25.0896,-4036,-8,-1,235,287,-52
BR1_2715317436,9,True,1,0,0,17434,221,56,7.0,True,5,False,0,0,0,15582,216,52,6.4,False,26.167,1852,4,1,277,268,9
BR1_2712422963,13,True,0,1,0,20542,221,48,7.0,True,4,False,1,0,0,15619,194,39,6.6,False,27.847066666666667,4923,9,-1,269,233,36
BR1_2731638626,9,False,0,0,0,16550,200,41,7.0,False,5,True,0,1,0,15510,190,50,6.6,True,26.20093333333333,1040,4,0,241,240,1
BR1_2731621096,7,False,0,0,0,17234,200,60,7.0,False,12,True,1,0,0,19284,193,60,7.2,True,26.67866666666667,-2050,-5,-1,260,253,7
BR1_2729159393,9,True,0,1,0,18917,237,56,7.4,False,3,False,1,0,0,17574,243,64,7.2,True,29.8449,1343,6,-1,293,307,-14
BR1_2729150136,2,True,0,0,0,15658,226,60,6.8,False,2,False,1,0,0,15468,228,56,6.8,True,26.44995,190,0,-1,286,284,2
BR1_2697068979,7,False,0,0,0,18213,227,64,7.4,True,7,True,1,0,0,18663,247,72,7.4,False,29.7507,-450,0,-1,291,319,-28
BR1_2690565373,11,True,0,1,0,18814,228,42,6.8,True,8,False,1,0,0,17281,191,48,6.6,False,26.568883333333332,1533,3,-1,270,239,31
BR1_2731557755,8,True,0,1,0,20399,267,80,7.8,True,4,False,0,0,0,16724,224,52,7.0,False,29.008216666666666,3675,4,0,347,276,71
BR1_2729896791,9,True,0,1,0,19684,236,80,7.6,False,7,False,1,0,0,18628,226,64,7.4,True,28.731416666666668,1056,2,-1,316,290,26
BR1_2725070996,12,False,0,0,0,20686,208,70,7.6,True,10,True,0,0,0,19238,207,37,6.8,False,29.6404,1448,2,0,278,244,34
BR1_2731819979,8,True,0,0,0,19713,244,72,7.6,False,7,False,1,1,0,17944,209,68,7.0,True,28.631766666666667,1769,1,-1,316,277,39
BR1_2698989288,7,False,1,0,0,16686,209,48,6.6,False,8,True,0,0,0,17512,218,60,6.8,True,27.10825,-826,-1,1,257,278,-21
BR1_2698964720,12,True,1,1,0,19142,200,48,6.6,True,7,False,0,0,0,16302,180,40,6.2,False,25.08895,2840,5,1,248,220,28
BR1_2698579905,6,True,0,0,0,17974,238,64,7.4,True,3,False,1,0,0,15621,215,55,7.0,False,29.080083333333334,2353,3,-1,302,270,32
BR1_2686838863,11,False,0,0,0,19119,244,16,6.8,True,11,True,1,0,0,20075,222,66,7.2,False,27.888983333333332,-956,0,-1,260,288,-28
BR1_2686778744,9,False,0,1,0,18062,193,64,7.0,False,12,True,1,0,0,20324,228,56,7.2,True,25.673233333333332,-2262,-3,-1,257,284,-27
BR1_2703750012,5,True,0,0,0,16485,249,68,7.4,True,1,False,1,0,0,13701,235,44,6.4,False,26.125033333333334,2784,4,-1,317,279,38
BR1_2712715290,9,True,1,1,1,21313,252,68,7.6,True,4,False,0,0,0,16960,215,52,7.0,False,29.506766666666667,4353,5,1,320,267,53
BR1_2712686976,9,False,0,0,0,16640,208,40,6.4,False,9,True,1,0,0,17462,190,48,6.4,True,26.407966666666667,-822,0,-1,248,238,10
BR1_2712631934,11,False,1,0,0,18542,202,60,7.2,True,5,True,0,0,0,15495,223,48,6.4,False,26.932316666666665,3047,6,1,262,271,-9
BR1_2720815884,8,True,1,1,0,19181,253,64,7.6,True,8,False,0,0,0,18406,214,60,7.0,False,28.0544,775,0,1,317,274,43
BR1_2730371010,7,False,0,0,0,18310,213,60,7.6,False,8,True,0,0,0,18571,228,80,7.8,True,29.02253333333333,-261,-1,0,273,308,-35
BR1_2712313610,8,True,1,1,0,17899,224,57,7.4,True,1,False,0,0,0,15846,239,66,7.2,False,29.394716666666667,2053,7,1,281,305,-24
BR1_2706614303,12,True,1,1,0,21655,254,60,7.4,False,15,False,0,0,0,21106,219,44,7.2,True,29.932866666666666,549,-3,1,314,263,51
BR1_2702938811,8,True,1,0,0,18877,256,66,7.2,False,8,False,0,1,0,18052,252,62,7.6,True,27.516016666666665,825,0,1,322,314,8
BR1_2731281396,9,True,1,1,0,17723,191,55,6.8,True,6,False,0,0,0,15637,186,56,6.8,False,27.0398,2086,3,1,246,242,4
BR1_2730811296,8,True,1,0,0,18345,243,48,7.2,True,8,False,0,1,0,18619,195,83,7.4,False,28.067733333333333,-274,0,1,291,278,13
BR1_2730749701,7,False,1,0,0,16659,231,60,7.0,True,4,True,0,0,0,15379,207,52,6.8,False,26.61565,1280,3,1,291,259,32
BR1_2723957750,9,False,1,0,0,18059,233,39,7.0,True,8,True,0,0,0,18126,228,44,6.8,False,29.5739,-67,1,1,272,272,0
BR1_2718189755,11,True,0,1,0,18844,197,63,7.0,True,3,False,0,0,0,13048,132,40,6.2,False,27.02685,5796,8,0,260,172,88
BR1_2712414300,8,True,0,0,0,16328,215,38,6.4,True,6,False,0,1,0,16004,172,54,6.6,False,26.1853,324,2,0,253,226,27
BR1_2712393026,5,False,1,0,0,16627,216,64,7.0,True,2,True,0,0,0,15331,245,64,6.6,False,26.154166666666665,1296,3,1,280,309,-29
BR1_2709535510,5,True,1,0,0,17721,253,54,7.6,False,1,False,0,0,0,15335,231,45,7.0,True,29.95095,2386,4,1,307,276,31
BR1_2731913844,5,False,0,1,0,17953,245,54,7.0,False,7,True,1,0,0,17008,207,63,6.8,True,27.001783333333332,945,-2,-1,299,270,29
BR1_2731640931,7,True,0,1,0,17060,201,56,7.0,False,10,False,1,0,0,18114,236,48,7.0,True,27.07845,-1054,-3,-1,257,284,-27
BR1_2669022323,10,True,1,0,0,20272,207,59,7.4,False,12,False,0,0,0,20566,227,48,7.8,True,29.535983333333334,-294,-2,1,266,275,-9
BR1_2718588401,15,True,1,0,0,22729,251,56,7.2,True,10,False,0,0,0,17135,178,44,7.0,False,29.033266666666666,5594,5,1,307,222,85
BR1_2718561814,4,False,0,0,0,16306,214,64,7.2,False,6,True,0,0,0,17176,242,52,6.6,True,26.073283333333332,-870,-2,0,278,294,-16
BR1_2705304868,8,False,0,0,0,16509,186,36,6.2,False,15,True,0,0,0,19459,191,48,6.4,True,25.52638333333333,-2950,-7,0,222,239,-17
BR1_2730873728,5,True,0,0,0,14106,160,47,6.4,False,7,False,1,0,0,17380,236,77,7.0,True,27.466366666666666,-3274,-2,-1,207,313,-106
BR1_2729188010,8,False,0,1,0,18503,216,68,7.0,True,10,True,1,0,0,19225,204,46,7.2,False,28.19875,-722,-2,-1,284,250,34
BR1_2729980859,6,False,1,0,0,16797,195,56,7.4,True,10,True,0,0,0,19806,233,52,7.4,False,28.611733333333333,-3009,-4,1,251,285,-34
BR1_2731603549,10,True,1,0,0,19196,245,52,7.0,True,4,False,0,1,0,16027,219,60,6.6,False,25.47485,3169,6,1,297,279,18
BR1_2731586356,7,False,0,0,0,16009,192,52,7.0,False,10,True,1,0,0,18412,237,59,7.2,True,25.3737,-2403,-3,-1,244,296,-52
BR1_2728105325,6,True,0,0,0,17516,249,56,6.8,True,4,False,1,0,0,15385,206,68,6.8,False,25.321733333333334,2131,2,-1,305,274,31
BR1_2728670413,6,False,1,0,0,17968,230,56,7.4,True,11,True,0,1,0,20081,229,48,7.4,False,27.64025,-2113,-5,1,286,277,9
BR1_2728234141,8,False,0,1,0,17594,202,56,6.8,True,5,True,0,0,0,15193,171,48,6.0,False,26.135383333333333,2401,3,0,258,219,39
BR1_2728221061,7,True,0,1,0,17396,250,60,7.2,True,2,False,0,0,0,13792,195,44,6.6,False,26.587433333333333,3604,5,0,310,239,71
BR1_2728209071,11,True,1,1,0,20114,209,37,7.2,False,15,False,0,0,0,21364,226,62,7.2,True,28.708316666666665,-1250,-4,1,246,288,-42
BR1_2729176053,12,True,0,0,0,21195,240,65,7.4,True,12,False,0,1,0,21328,224,64,7.6,False,27.549983333333333,-133,0,0,305,288,17
BR1_2728567200,9,False,0,0,0,17903,191,52,6.8,False,10,True,1,0,0,19243,240,48,6.8,True,25.65995,-1340,-1,-1,243,288,-45
BR1_2731626792,6,False,0,0,0,16042,215,60,7.0,False,9,True,0,0,0,18224,244,44,7.2,True,25.3828,-2182,-3,0,275,288,-13
BR1_2730178891,9,False,0,0,0,18771,215,56,7.4,False,13,True,0,0,0,21325,237,64,7.6,True,28.058216666666667,-2554,-4,0,271,301,-30
BR1_2722940764,4,False,1,0,0,14990,204,64,7.0,True,7,True,0,0,0,17390,213,60,7.2,False,26.57208333333333,-2400,-3,1,268,273,-5
BR1_2722904306,7,True,0,0,0,17130,216,56,6.6,True,5,False,0,0,0,15510,175,48,7.0,False,27.48735,1620,2,0,272,223,49
BR1_2731180934,12,True,1,1,0,19023,223,56,7.2,True,4,False,0,0,0,15030,167,40,6.4,False,26.46078333333333,3993,8,1,279,207,72
BR1_2724632428,9,False,0,1,0,18538,244,53,7.8,True,4,True,0,0,0,16678,237,55,7.2,False,29.126616666666667,1860,5,0,297,292,5
BR1_2715696174,4,True,1,0,0,15071,193,48,6.6,False,9,False,0,1,0,17532,191,52,7.0,True,25.816033333333333,-2461,-5,1,241,243,-2
BR1_2731299697,10,True,0,0,0,19414,214,68,7.2,True,8,False,1,1,0,18372,198,60,7.0,False,28.01885,1042,2,-1,282,258,24
BR1_2731271011,10,True,0,0,0,18683,188,50,7.0,True,16,False,0,1,0,21428,209,54,7.4,False,28.101933333333335,-2745,-6,0,238,263,-25
BR1_2728352588,12,False,1,0,0,21609,260,59,7.6,True,5,True,0,0,0,17188,222,60,7.0,False,29.231233333333332,4421,7,1,319,282,37
BR1_2728299086,6,True,1,1,0,17572,230,56,7.2,True,4,False,0,0,0,17045,253,48,7.0,False,28.281716666666668,527,2,1,286,301,-15
BR1_2696634946,7,True,1,1,0,17744,247,68,7.0,True,1,False,0,0,0,13730,202,64,6.6,False,27.471433333333334,4014,6,1,315,266,49
BR1_2695975394,5,True,0,0,0,16856,233,60,7.0,True,1,False,1,0,0,13408,201,43,6.6,False,26.86985,3448,4,-1,293,244,49
BR1_2695962220,3,True,0,0,0,15432,231,48,6.8,False,7,False,0,1,0,16461,209,56,7.0,True,25.535616666666666,-1029,-4,0,279,265,14
BR1_2726209727,8,True,0,0,0,19126,245,56,7.4,True,11,False,1,0,0,19811,226,70,7.2,False,29.152616666666667,-685,-3,-1,301,296,5
BR1_2710975315,3,False,0,1,0,15598,193,48,7.0,True,12,True,1,0,0,19611,234,52,7.6,False,29.792366666666666,-4013,-9,-1,241,286,-45
BR1_2710711582,10,False,0,0,0,17304,182,38,6.8,True,15,True,1,0,0,20074,217,30,6.8,False,25.925216666666667,-2770,-5,-1,220,247,-27
BR1_2701983495,3,False,1,0,0,17111,232,64,7.2,False,10,True,0,1,0,20948,233,72,7.6,True,29.26875,-3837,-7,1,296,305,-9
BR1_2701972460,13,True,1,0,0,19170,206,44,7.4,False,4,False,0,0,0,17042,227,68,7.0,True,29.098133333333333,2128,9,1,250,295,-45
BR1_2697094784,2,False,1,0,0,14929,212,52,7.4,False,8,True,0,1,0,18912,234,62,7.6,True,29.984083333333334,-3983,-6,1,264,296,-32
BR1_2697071420,10,False,0,1,0,18005,192,52,6.8,True,11,True,1,0,0,18318,225,40,6.8,False,27.13445,-313,-1,-1,244,265,-21
BR1_2725398543,6,False,0,1,0,15270,188,39,6.4,False,11,True,1,0,0,18832,217,64,7.2,True,25.7742,-3562,-5,-1,227,281,-54
BR1_2730188369,7,False,0,1,0,18318,233,56,7.4,True,5,True,1,0,0,17245,240,63,7.0,False,28.937533333333334,1073,2,-1,289,303,-14
BR1_2730137382,12,True,0,1,0,21815,265,64,7.6,True,5,False,1,0,0,17119,226,60,7.0,False,27.513916666666667,4696,7,-1,329,286,43
BR1_2718953141,3,True,1,0,0,17294,287,64,7.6,True,2,False,0,0,0,16717,244,64,7.6,False,28.2117,577,1,1,351,308,43
BR1_2718902588,6,False,0,1,0,17618,203,60,7.0,True,6,True,0,0,0,15926,212,48,6.6,False,25.133016666666666,1692,0,0,263,260,3
BR1_2726205033,5,False,0,1,0,15608,169,52,6.4,False,10,True,1,0,1,19505,225,64,7.4,True,27.237083333333334,-3897,-5,-1,221,289,-68
BR1_2731771411,12,True,0,1,0,20612,226,62,7.4,False,13,False,0,0,0,20752,243,52,7.4,True,29.9854,-140,-1,0,288,295,-7
BR1_2724207354,12,True,1,0,0,18356,205,60,7.0,True,8,False,0,0,0,16627,179,44,6.4,False,26.21645,1729,4,1,265,223,42
BR1_2705726676,5,False,0,1,0,15946,163,68,6.8,False,12,True,1,0,0,20154,218,48,6.8,True,26.72635,-4208,-7,-1,231,266,-35
BR1_2705684252,4,True,0,0,0,16230,210,64,7.0,False,8,False,1,0,0,19294,254,56,7.6,True,29.837466666666668,-3064,-4,-1,274,310,-36
BR1_2723148423,0,False,0,0,0,15658,258,56,7.2,False,9,True,1,1,0,19932,262,68,8.0,True,28.40055,-4274,-9,-1,314,330,-16
BR1_2723021801,6,True,1,0,0,16474,207,55,7.0,True,6,False,0,1,0,16935,223,40,6.8,False,25.915583333333334,-461,0,1,262,263,-1
BR1_2703151347,4,False,0,0,0,15367,208,64,7.0,False,5,True,1,0,0,16811,232,48,6.8,True,27.49985,-1444,-1,-1,272,280,-8
BR1_2731199464,4,False,0,0,1,15311,178,55,6.8,False,11,True,0,1,0,19320,174,52,7.0,True,28.612583333333333,-4009,-7,0,233,226,7
BR1_2706458104,5,False,0,0,0,17387,232,46,7.2,False,15,True,1,1,0,20515,217,55,7.8,True,29.8897,-3128,-10,-1,278,272,6
BR1_2706301507,2,False,1,0,0,16270,256,68,7.6,False,6,True,0,1,0,18786,220,68,7.0,True,29.960183333333333,-2516,-4,1,324,288,36
BR1_2705866262,7,True,1,1,0,17806,231,68,7.0,True,6,False,0,0,0,16023,211,43,7.0,False,26.412216666666666,1783,1,1,299,254,45
BR1_2731204082,7,True,1,0,0,18173,229,64,7.4,False,3,False,0,0,0,15397,186,76,6.6,True,27.6023,2776,4,1,293,262,31
BR1_2726238145,12,True,1,0,0,21675,259,72,8.0,True,6,False,0,0,0,18613,287,60,7.4,False,29.448233333333334,3062,6,1,331,347,-16
BR1_2731844459,3,False,0,1,0,14836,214,52,6.8,False,6,True,1,0,0,16473,224,56,7.0,True,26.186333333333334,-1637,-3,-1,266,280,-14
BR1_2731829296,9,True,0,0,0,19231,229,56,7.4,False,5,False,1,1,0,18703,244,92,7.8,True,28.936033333333334,528,4,-1,285,336,-51
BR1_2731014412,8,False,0,1,0,18640,258,48,7.2,False,9,True,1,0,0,19281,263,52,7.2,True,28.392933333333332,-641,-1,-1,306,315,-9
BR1_2726278994,3,False,1,0,0,15125,200,68,7.2,False,7,True,0,0,0,21694,287,68,7.8,True,28.191433333333332,-6569,-4,1,268,355,-87
BR1_2731092900,10,True,1,0,0,19687,232,47,7.4,True,2,False,0,1,0,15431,207,68,7.2,False,27.543466666666667,4256,8,1,279,275,4
BR1_2731848463,14,True,1,0,0,19636,206,48,6.6,False,6,False,0,1,0,17349,199,56,7.0,True,27.459316666666666,2287,8,1,254,255,-1
BR1_2731765268,9,False,1,0,0,18072,207,51,6.8,True,8,True,0,0,0,17123,214,48,6.8,False,25.7531,949,1,1,258,262,-4
BR1_2722906861,11,True,0,1,0,20363,242,59,7.2,True,15,False,1,0,0,20231,182,48,7.2,False,28.0422,132,-4,-1,301,230,71
BR1_2722884863,11,True,0,0,0,21136,257,55,7.4,True,10,False,0,0,0,19633,230,52,7.6,False,27.678683333333332,1503,1,0,312,282,30
BR1_2728962804,6,True,0,0,0,17280,230,40,6.8,False,9,False,1,0,0,17568,181,64,6.8,True,26.057783333333333,-288,-3,-1,270,245,25
BR1_2730207237,5,False,0,1,0,16618,228,52,7.2,False,8,True,0,0,0,19578,280,61,7.6,True,27.665983333333333,-2960,-3,0,280,341,-61
BR1_2730175018,7,False,0,0,0,17433,203,52,7.2,False,11,True,1,0,0,19893,249,60,7.6,True,28.52955,-2460,-4,-1,255,309,-54
BR1_2731027450,5,False,0,0,0,14576,178,44,6.8,False,7,True,1,0,0,16316,205,68,7.2,True,26.929383333333334,-1740,-2,-1,222,273,-51
BR1_2731010904,6,True,0,0,0,15635,174,51,6.6,True,3,False,0,1,0,13954,167,40,6.8,False,25.068166666666666,1681,3,0,225,207,18
BR1_2731001708,11,False,0,0,0,17516,170,40,6.6,False,10,True,1,0,0,16863,156,44,6.6,True,26.1526,653,1,-1,210,200,10
BR1_2729614299,9,False,0,1,0,20087,222,65,7.4,True,13,True,1,0,1,22659,250,59,7.6,False,28.4695,-2572,-4,-1,287,309,-22
BR1_2730107476,7,False,0,1,0,19027,231,78,7.8,True,8,True,1,0,0,17000,203,48,7.0,False,28.464116666666666,2027,-1,-1,309,251,58
BR1_2730035783,5,True,0,0,0,16628,233,64,7.2,False,4,False,1,0,0,15148,217,59,7.2,True,26.3022,1480,1,-1,297,276,21
BR1_2702994892,3,False,0,0,0,15171,196,56,6.4,True,9,True,1,0,0,17844,197,64,7.2,False,25.6352,-2673,-6,-1,252,261,-9
BR1_2718943429,6,False,0,0,0,17458,226,56,7.2,False,8,True,1,0,0,17762,220,52,7.2,True,28.244116666666667,-304,-2,-1,282,272,10
BR1_2731091157,6,False,0,1,0,18674,260,68,7.4,True,5,True,0,0,0,16194,193,44,6.6,False,28.967533333333332,2480,1,0,328,237,91
BR1_2726055379,2,True,0,0,0,16312,253,50,7.6,False,2,False,0,1,0,17140,263,70,7.6,True,28.726033333333334,-828,0,0,303,333,-30
BR1_2703940771,3,False,0,0,0,14803,205,55,6.8,False,5,True,1,1,0,16296,212,40,7.0,True,25.173883333333333,-1493,-2,-1,260,252,8
BR1_2729722038,8,False,0,0,0,18277,228,56,7.6,False,10,True,1,1,0,20622,224,52,7.4,True,29.625933333333332,-2345,-2,-1,284,276,8
BR1_2729688394,8,False,0,0,0,18420,279,52,7.8,False,5,True,1,0,0,17252,230,48,7.2,True,28.394216666666665,1168,3,-1,331,278,53
BR1_2723452721,9,True,1,1,0,19913,235,60,7.2,True,3,False,0,0,0,15627,186,44,6.4,False,28.703416666666666,4286,6,1,295,230,65
BR1_2731515331,9,True,1,1,0,19516,237,48,7.4,True,11,False,0,0,0,19213,196,76,7.0,False,28.680483333333335,303,-2,1,285,272,13
BR1_2731179391,6,False,1,0,0,19415,273,72,8.0,False,5,True,0,1,0,18362,270,64,7.8,True,28.643,1053,1,1,345,334,11
BR1_2731876270,9,True,0,0,0,15982,195,36,6.6,False,11,False,1,0,0,17528,192,64,7.0,True,25.668,-1546,-2,-1,231,256,-25
BR1_2731774555,1,False,0,0,0,15154,239,48,6.8,False,5,True,1,1,0,17273,227,68,7.4,True,28.931816666666666,-2119,-4,-1,287,295,-8
BR1_2731716147,5,True,0,0,0,15151,181,60,7.0,False,2,False,1,0,0,13844,204,36,6.4,True,25.414183333333334,1307,3,-1,241,240,1
BR1_2697116593,3,True,1,1,0,15776,224,48,7.0,False,3,False,0,0,0,16131,216,68,7.2,True,25.095966666666666,-355,0,1,272,284,-12
BR1_2729027260,1,True,0,0,0,13706,192,56,6.4,False,5,False,1,1,0,16162,231,60,7.0,True,25.0219,-2456,-4,-1,248,291,-43
BR1_2731852168,10,True,1,0,0,19264,213,39,6.8,True,6,False,0,1,0,17617,187,64,7.0,False,29.467466666666667,1647,4,1,252,251,1
BR1_2731826179,8,True,1,0,0,18262,229,48,7.0,True,7,False,0,1,1,19024,200,55,7.4,False,28.478183333333334,-762,1,1,277,255,22
BR1_2725085614,6,False,0,0,0,17242,210,68,7.0,False,11,True,1,0,0,20556,219,60,7.6,True,28.6757,-3314,-5,-1,278,279,-1
BR1_2730702108,5,True,0,1,0,18717,250,63,7.4,False,7,False,1,0,0,17972,236,64,7.2,True,28.50755,745,-2,-1,313,300,13
BR1_2730201542,9,True,1,1,0,17466,191,76,7.2,True,7,False,0,0,0,16545,182,64,7.0,False,27.243133333333333,921,2,1,267,246,21
BR1_2731808102,8,False,0,0,0,16786,194,64,7.0,False,11,True,0,1,0,18624,210,43,7.0,True,25.647183333333334,-1838,-3,0,258,253,5
BR1_2731704491,10,True,1,0,0,19171,205,72,7.6,True,8,False,0,0,0,19489,273,52,7.6,False,28.5663,-318,2,1,277,325,-48
BR1_2731327749,4,True,1,1,0,17015,243,44,7.2,False,9,False,0,0,0,19114,260,52,7.4,True,29.728733333333334,-2099,-5,1,287,312,-25
BR1_2716121569,5,True,0,1,0,17065,212,63,6.8,True,8,False,0,0,0,16921,210,40,6.8,False,26.873066666666666,144,-3,0,275,250,25
BR1_2713073994,9,True,1,0,0,18686,223,52,7.4,False,6,False,0,0,0,18751,232,60,7.4,True,29.587633333333333,-65,3,1,275,292,-17
BR1_2718968264,9,True,0,1,0,19106,225,47,6.8,True,6,False,1,0,0,15135,161,56,6.6,False,26.739866666666668,3971,3,-1,272,217,55
BR1_2722657495,9,False,0,0,0,18506,195,60,7.4,False,12,True,1,0,0,20728,223,60,7.4,True,27.7978,-2222,-3,-1,255,283,-28
BR1_2722675922,10,False,0,1,0,17570,172,52,6.8,False,9,True,0,0,0,17894,198,55,7.0,True,27.373533333333334,-324,1,0,224,253,-29
BR1_2722666595,8,False,0,0,0,17884,231,53,7.2,True,7,True,0,0,0,17893,221,46,7.6,False,29.028766666666666,-9,1,0,284,267,17
BR1_2722636112,3,False,1,1,0,16242,234,58,7.4,True,4,True,0,0,0,17460,260,54,7.4,False,28.233733333333333,-1218,-1,1,292,314,-22
BR1_2729396758,5,True,0,0,0,16692,223,54,7.4,False,4,False,0,1,0,17662,259,76,7.6,True,27.812816666666667,-970,1,0,277,335,-58
BR1_2714422298,7,True,0,1,0,17466,197,40,6.6,False,13,False,1,0,0,20835,227,80,7.4,True,27.995833333333334,-3369,-6,-1,237,307,-70
BR1_2714413888,7,True,0,0,0,17426,202,48,6.8,True,15,False,0,0,0,21436,217,67,7.6,False,27.732583333333334,-4010,-8,0,250,284,-34
BR1_2722741591,8,False,0,0,0,17531,225,48,7.2,False,9,True,1,0,0,18578,227,44,7.2,True,28.773633333333333,-1047,-1,-1,273,271,2
BR1_2728568604,14,True,0,1,1,21888,238,48,7.8,True,3,False,0,0,0,15413,231,46,7.2,False,28.501716666666667,6475,11,0,286,277,9
BR1_2731801522,13,True,1,0,0,20177,244,59,7.0,True,5,False,0,0,0,15479,189,56,6.6,False,26.060883333333333,4698,8,1,303,245,58
BR1_2729417636,11,False,0,0,0,20010,221,60,7.6,False,11,True,1,0,0,20875,249,60,7.4,True,29.758516666666665,-865,0,-1,281,309,-28
BR1_2717271453,12,False,1,0,1,22259,286,56,7.6,True,7,True,0,1,0,19379,227,76,7.6,False,27.53535,2880,5,1,342,303,39
BR1_2715340208,4,False,1,1,0,17444,248,71,7.6,False,9,True,0,0,0,19254,254,47,7.8,True,28.616416666666666,-1810,-5,1,319,301,18
BR1_2694821942,7,True,0,1,0,17906,214,68,7.4,True,9,False,1,0,0,19143,232,59,7.2,False,27.698266666666665,-1237,-2,-1,282,291,-9
BR1_2692290287,8,False,0,0,0,17304,195,48,6.8,False,9,True,1,1,0,18885,234,63,7.4,True,29.920633333333335,-1581,-1,-1,243,297,-54
BR1_2731619930,6,True,0,0,0,16343,200,48,6.8,False,8,False,1,0,0,17197,222,62,7.2,True,25.739433333333334,-854,-2,-1,248,284,-36
BR1_2731606317,6,True,0,0,0,15562,179,52,6.6,True,3,False,0,0,0,15037,235,40,6.8,False,25.270666666666667,525,3,0,231,275,-44
BR1_2725924945,16,False,1,0,0,22464,231,59,7.4,False,14,True,0,1,0,20180,172,48,7.4,True,28.4999,2284,2,1,290,220,70
BR1_2731669699,4,False,0,0,0,14690,189,44,6.8,True,8,True,1,0,0,17988,209,60,7.4,False,25.6883,-3298,-4,-1,233,269,-36
BR1_2694391110,3,False,0,1,0,15979,203,57,7.2,False,8,True,1,0,0,18348,208,80,7.6,True,28.676166666666667,-2369,-5,-1,260,288,-28
BR1_2731284990,3,True,1,0,0,15012,207,64,6.8,False,5,False,0,1,0,16652,230,59,7.4,True,26.988483333333335,-1640,-2,1,271,289,-18
BR1_2731187348,7,True,1,1,0,16525,201,52,7.0,True,2,False,0,0,0,14570,193,64,7.0,False,25.66595,1955,5,1,253,257,-4
BR1_2727375790,7,False,1,0,0,16607,199,48,6.4,False,14,True,0,0,0,20058,220,52,7.0,True,25.718916666666665,-3451,-7,1,247,272,-25
BR1_2727358301,6,True,0,0,0,16173,200,57,7.2,True,4,False,0,0,0,15251,203,58,7.0,False,26.824266666666666,922,2,0,257,261,-4
BR1_2731655884,1,False,0,1,0,13571,183,44,6.4,False,6,True,1,0,0,17164,235,56,7.0,True,26.738533333333333,-3593,-5,-1,227,291,-64
BR1_2709940754,7,False,1,0,0,16876,204,60,7.0,False,11,True,0,1,0,20212,214,72,7.6,True,27.513233333333332,-3336,-4,1,264,286,-22
BR1_2709631138,3,False,0,0,0,14000,157,52,6.4,False,12,True,1,1,0,18928,219,56,7.4,True,25.203733333333332,-4928,-9,-1,209,275,-66
BR1_2729474394,6,True,1,0,0,16422,222,56,6.8,False,9,False,0,0,0,17662,198,36,7.2,True,26.710316666666667,-1240,-3,1,278,234,44
BR1_2729385994,9,False,1,0,0,19053,259,72,7.6,False,6,True,0,0,0,18377,255,60,7.6,True,27.936816666666665,676,3,1,331,315,16
BR1_2729371156,7,False,0,0,0,17891,210,64,7.0,True,7,True,0,1,0,17124,213,48,6.8,False,25.858116666666668,767,0,0,274,261,13
BR1_2729349291,6,True,0,1,0,18603,201,46,7.2,False,8,False,1,0,0,18168,241,48,7.0,True,28.49315,435,-2,-1,247,289,-42
BR1_2726323464,6,False,1,0,0,16390,196,52,6.6,False,8,True,0,0,0,18061,236,52,7.2,True,26.265733333333333,-1671,-2,1,248,288,-40
BR1_2726002827,13,False,1,0,0,18690,183,52,6.8,True,8,True,0,0,0,16805,191,52,6.6,False,25.17655,1885,5,1,235,243,-8
BR1_2725806218,6,True,1,0,0,18148,244,56,7.4,True,8,False,0,0,0,18876,249,52,7.4,False,29.67435,-728,-2,1,300,301,-1
BR1_2727795796,3,False,0,0,0,14425,194,51,6.4,True,10,True,1,1,0,18611,244,69,7.2,False,26.6895,-4186,-7,-1,245,313,-68
BR1_2731790302,4,False,0,1,0,15736,210,68,7.2,False,1,True,1,0,0,15567,230,72,7.0,True,26.30976666666667,169,3,-1,278,302,-24
BR1_2731759147,8,False,0,0,0,18439,217,60,7.0,False,11,True,0,0,0,19554,229,48,7.6,True,29.37935,-1115,-3,0,277,277,0
BR1_2696975102,5,True,1,1,0,16197,215,65,7.0,True,6,False,0,0,0,15335,198,46,6.6,False,27.269283333333334,862,-1,1,280,244,36
BR1_2731591089,11,True,1,1,0,20604,258,56,7.8,True,4,False,0,0,0,15658,188,72,7.0,False,28.19445,4946,7,1,314,260,54
BR1_2698556972,7,True,0,0,0,17450,204,50,6.8,False,14,False,0,1,0,20480,211,46,7.0,True,26.696466666666666,-3030,-7,0,254,257,-3
BR1_2698178428,5,False,1,1,0,17309,243,63,7.6,True,6,True,0,0,0,19347,235,67,7.6,False,29.180883333333334,-2038,-1,1,306,302,4
BR1_2698170347,10,True,1,0,0,17011,182,49,6.8,True,5,False,0,0,0,16040,213,38,7.0,False,26.14966666666667,971,5,1,231,251,-20
BR1_2728613274,9,False,0,0,0,17788,222,56,7.0,False,7,True,1,1,0,17628,208,64,7.0,True,26.9487,160,2,-1,278,272,6
BR1_2725619963,2,False,0,0,0,14183,209,40,6.8,True,8,True,1,0,0,18030,248,40,7.4,False,25.898416666666666,-3847,-6,-1,249,288,-39
BR1_2705668955,9,True,0,0,0,18707,227,44,6.8,True,12,False,1,1,0,19104,210,68,7.2,False,25.057816666666668,-397,-3,-1,271,278,-7
BR1_2697884107,4,True,0,1,0,16530,199,64,7.0,False,4,False,1,0,0,16599,212,56,6.8,True,28.184266666666666,-69,0,-1,263,268,-5
BR1_2688540167,17,False,1,0,0,20188,207,48,7.0,True,5,True,0,1,0,15061,182,60,6.4,False,27.351783333333334,5127,12,1,255,242,13
BR1_2724996641,9,False,0,0,0,17916,207,48,7.0,True,7,True,1,0,0,16030,189,52,6.8,False,26.85705,1886,2,-1,255,241,14
BR1_2730360375,5,False,0,0,0,16271,242,72,7.2,True,6,True,0,0,0,16301,188,64,6.8,False,26.566783333333333,-30,-1,0,314,252,62
BR1_2705045742,3,False,1,0,0,14581,206,40,6.8,True,4,True,0,0,0,15655,248,44,7.0,False,25.714733333333335,-1074,-1,1,246,292,-46
BR1_2728504733,7,True,0,0,0,17595,210,44,6.6,True,7,False,0,0,0,16078,194,52,6.6,False,25.243983333333333,1517,0,0,254,246,8
BR1_2728194085,12,True,1,1,0,21084,256,68,7.8,True,6,False,0,0,0,17452,225,48,7.0,False,28.8116,3632,6,1,324,273,51
BR1_2731311342,12,False,0,0,0,19559,211,40,7.0,False,11,True,0,1,0,19579,213,58,7.0,True,28.798233333333332,-20,1,0,251,271,-20
BR1_2710943043,1,False,0,0,0,14441,247,52,6.8,False,5,True,1,0,0,16250,228,60,7.2,True,26.14505,-1809,-4,-1,299,288,11
BR1_2710920375,6,True,0,0,0,16699,215,72,6.8,True,6,False,1,1,0,16152,200,44,6.6,False,25.620633333333334,547,0,-1,287,244,43
BR1_2731770425,3,False,1,0,0,16085,215,56,7.2,False,4,True,0,1,0,17278,235,72,7.6,True,29.006033333333335,-1193,-1,1,271,307,-36
BR1_2731570771,5,True,1,0,0,18116,283,56,7.4,True,5,False,0,0,0,17978,237,42,7.0,False,27.5482,138,0,1,339,279,60
BR1_2731556579,3,True,1,1,0,16206,228,67,6.8,True,7,False,0,0,0,16892,209,36,6.8,False,27.068516666666667,-686,-4,1,295,245,50
BR1_2718993088,7,False,0,0,0,18176,262,48,7.2,False,9,True,0,0,0,19302,224,68,7.2,True,29.812066666666666,-1126,-2,0,310,292,18
BR1_2686463095,11,True,1,0,0,20680,250,48,7.2,True,10,False,0,1,0,20449,231,52,7.0,False,29.484066666666667,231,1,1,298,283,15
BR1_2686429742,13,True,1,0,0,19845,226,52,7.4,True,5,False,0,1,0,17547,216,63,7.4,False,27.738166666666668,2298,8,1,278,279,-1
BR1_2686384666,9,False,0,0,0,18976,228,68,7.8,False,7,True,1,0,0,17779,248,48,7.6,True,27.611633333333334,1197,2,-1,296,296,0
BR1_2729730793,6,False,0,1,0,17427,223,48,7.4,False,5,True,1,0,0,19542,267,67,7.6,True,29.42845,-2115,1,-1,271,334,-63
BR1_2686475213,6,False,1,0,0,17264,221,68,7.0,False,5,True,0,1,0,16259,228,68,7.2,True,25.230766666666668,1005,1,1,289,296,-7
BR1_2686347567,3,True,1,0,0,15573,260,64,7.2,True,4,False,0,1,0,15997,257,56,7.2,False,25.637016666666668,-424,-1,1,324,313,11
BR1_2731766277,8,True,0,0,0,18003,214,56,7.2,False,14,False,0,0,0,20503,215,60,7.6,True,27.596666666666668,-2500,-6,0,270,275,-5
BR1_2731199368,9,True,0,0,0,16081,179,44,6.6,False,8,False,0,0,0,17074,222,48,6.6,True,27.188866666666666,-993,1,0,223,270,-47
BR1_2730643620,9,True,0,1,0,19465,204,64,7.0,True,5,False,0,0,0,15360,203,46,6.8,False,26.558216666666667,4105,4,0,268,249,19
BR1_2730617406,7,False,1,1,0,16077,181,60,6.8,False,6,True,0,0,0,15755,213,44,6.8,True,26.546516666666665,322,1,1,241,257,-16
BR1_2730255923,7,True,1,0,0,16058,203,52,6.8,True,8,False,0,0,0,16258,155,56,6.8,False,25.07545,-200,-1,1,255,211,44
BR1_2730086464,9,True,0,0,0,17971,201,48,7.2,True,7,False,1,1,0,16889,225,56,7.0,False,27.1609,1082,2,-1,249,281,-32
BR1_2725577053,7,False,1,0,0,18435,227,56,7.2,True,9,True,0,1,0,19366,223,60,7.2,False,29.4516,-931,-2,1,283,283,0
BR1_2725549740,7,True,0,0,0,17666,237,66,7.2,True,3,False,1,0,0,14272,205,49,6.6,False,25.540916666666668,3394,4,-1,303,254,49
BR1_2726459813,8,True,1,1,0,17722,204,68,6.6,True,7,False,0,0,0,15737,202,44,6.6,False,27.4847,1985,1,1,272,246,26
BR1_2722288028,8,False,0,0,0,17725,239,40,7.0,True,4,True,1,0,0,16113,220,48,7.0,False,25.838116666666668,1612,4,-1,279,268,11
BR1_2682956726,5,False,0,0,0,17556,231,72,7.6,False,6,True,1,1,0,18233,246,59,7.4,True,28.995833333333334,-677,-1,-1,303,305,-2
BR1_2695107717,6,False,0,0,0,16327,204,52,6.8,True,4,True,0,1,0,15498,193,52,6.8,False,26.24855,829,2,0,256,245,11
BR1_2695083542,6,True,0,0,0,16451,222,40,6.8,False,7,False,0,0,0,18292,261,55,7.2,True,25.573216666666667,-1841,-1,0,262,316,-54
BR1_2695060271,12,True,1,0,0,18719,168,44,6.6,True,9,False,0,0,0,16807,192,44,6.8,False,26.5998,1912,3,1,212,236,-24
BR1_2694906848,3,False,0,0,0,16413,229,68,6.8,False,10,True,1,0,0,19777,242,62,7.2,True,28.577483333333333,-3364,-7,-1,297,304,-7
BR1_2731483744,9,False,0,0,0,17641,206,48,7.0,True,6,True,0,0,0,17413,237,60,7.2,False,26.571533333333335,228,3,0,254,297,-43
BR1_2731471250,9,True,0,0,0,16863,203,48,6.8,False,9,False,0,0,0,17772,238,52,7.2,True,25.985266666666668,-909,0,0,251,290,-39
BR1_2730192254,7,False,1,0,0,19436,267,74,7.6,True,9,True,0,0,0,19502,220,56,7.4,False,28.0939,-66,-2,1,341,276,65
BR1_2728106356,8,False,0,1,0,17827,212,68,7.2,True,4,True,1,0,0,17175,206,64,7.2,False,28.670766666666665,652,4,-1,280,270,10
BR1_2728093321,4,False,0,0,0,16438,212,57,7.2,True,9,True,0,0,0,19405,225,60,7.6,False,29.65748333333333,-2967,-5,0,269,285,-16
BR1_2722462197,8,False,0,0,0,18096,216,64,7.4,False,6,True,0,0,0,17550,221,52,7.4,True,29.110333333333333,546,2,0,280,273,7
BR1_2731913275,10,True,0,0,0,20414,232,68,7.6,False,11,False,0,1,1,21681,259,68,7.4,True,29.950483333333334,-1267,-1,0,300,327,-27
BR1_2731593152,7,True,1,0,0,17204,198,40,7.2,False,8,False,0,1,0,18341,210,92,7.8,True,28.449333333333332,-1137,-1,1,238,302,-64
BR1_2731517848,12,False,1,0,0,20100,212,52,7.2,True,5,True,0,1,0,16571,220,40,7.0,False,29.98335,3529,7,1,264,260,4
BR1_2701794559,5,True,0,0,0,15254,193,48,6.6,False,8,False,1,0,0,15961,189,52,6.6,True,27.451583333333332,-707,-3,-1,241,241,0
BR1_2699006754,3,False,0,1,0,18044,271,64,7.4,True,3,True,2,0,0,17478,259,72,7.6,False,29.326366666666665,566,0,-2,335,331,4
BR1_2698983922,5,True,0,0,0,16989,237,77,7.6,False,1,False,1,1,0,15669,270,58,7.0,True,26.584483333333335,1320,4,-1,314,328,-14
BR1_2667824694,7,False,0,0,0,16675,186,64,6.8,False,12,True,1,0,0,20356,212,67,7.4,True,26.193716666666667,-3681,-5,-1,250,279,-29
BR1_2731729525,5,False,0,0,0,17818,233,67,7.2,True,5,True,0,0,0,18271,272,64,7.6,False,28.971733333333333,-453,0,0,300,336,-36
BR1_2730157923,10,False,0,0,0,18794,189,48,7.0,False,14,True,1,1,0,22394,224,68,7.2,True,29.5677,-3600,-4,-1,237,292,-55
BR1_2729925040,7,True,0,0,0,16949,222,47,6.6,False,7,False,1,0,0,15144,188,48,6.8,True,26.356283333333334,1805,0,-1,269,236,33
BR1_2731231928,12,True,1,0,0,21048,223,68,7.4,True,7,False,0,0,0,18743,227,68,7.4,False,28.10085,2305,5,1,291,295,-4
BR1_2730688075,5,False,0,0,1,14591,165,40,6.4,False,10,True,1,0,0,21389,240,59,7.2,True,26.34375,-6798,-5,-1,205,299,-94
BR1_2726318966,6,False,1,0,0,16962,225,48,6.8,True,8,True,0,0,0,16227,169,56,6.6,False,26.178266666666666,735,-2,1,273,225,48
BR1_2728574154,7,False,0,1,0,16503,216,48,6.4,True,7,True,1,0,0,17496,240,48,6.8,False,26.814416666666666,-993,0,-1,264,288,-24
BR1_2724908982,16,True,1,1,1,22620,225,63,7.6,True,10,False,0,0,0,19431,192,52,7.0,False,29.13035,3189,6,1,288,244,44
BR1_2731874461,6,True,1,0,0,16518,226,60,7.2,True,2,False,0,0,0,14551,231,60,7.0,False,26.206016666666667,1967,4,1,286,291,-5
BR1_2717885045,8,True,1,0,0,18617,218,71,7.4,True,6,False,0,1,0,17519,209,68,7.0,False,29.021416666666667,1098,2,1,289,277,12
BR1_2731383581,6,True,1,1,0,18171,247,64,7.2,True,2,False,0,0,0,14126,199,55,7.2,False,25.581583333333334,4045,4,1,311,254,57
BR1_2731375771,8,True,1,0,0,19477,244,44,7.2,False,11,False,0,0,0,19400,212,68,7.2,True,29.610416666666666,77,-3,1,288,280,8
BR1_2731371757,4,True,1,0,0,16442,216,52,6.8,True,7,False,0,0,0,17003,174,56,6.8,False,25.155733333333334,-561,-3,1,268,230,38
BR1_2731294424,8,False,0,0,0,16328,174,48,6.6,False,10,True,1,1,0,18053,205,56,6.8,True,26.8462,-1725,-2,-1,222,261,-39
BR1_2731267829,9,True,0,1,0,18472,197,52,6.8,True,8,False,0,0,0,17741,209,60,6.8,False,26.079133333333335,731,1,0,249,269,-20
BR1_2705391654,8,True,1,0,0,19730,264,58,7.2,False,4,False,0,0,0,17168,225,52,7.4,True,28.578683333333334,2562,4,1,322,277,45
BR1_2728789492,11,True,1,0,0,18373,194,63,6.4,True,10,False,0,0,0,16997,185,37,6.2,False,26.642566666666667,1376,1,1,257,222,35
BR1_2729610093,5,False,1,0,0,16783,246,44,7.2,False,10,True,0,1,0,20088,259,64,7.2,True,27.8595,-3305,-5,1,290,323,-33
BR1_2729583739,6,False,0,0,0,16696,194,55,6.8,False,10,True,1,0,0,17995,208,48,6.8,True,25.425883333333335,-1299,-4,-1,249,256,-7
BR1_2730214840,8,True,0,0,0,17878,197,48,6.8,False,6,False,1,1,1,20265,261,60,7.6,True,29.481866666666665,-2387,2,-1,245,321,-76
BR1_2730191071,6,True,1,1,0,18972,254,64,7.8,True,3,False,0,0,0,15527,230,56,7.4,False,28.826983333333335,3445,3,1,318,286,32
BR1_2730779250,7,False,1,0,0,18166,219,60,7.2,False,12,True,0,1,1,21359,247,56,7.4,True,29.637316666666667,-3193,-5,1,279,303,-24
BR1_2691155393,6,False,0,1,0,16764,210,52,6.6,False,6,True,1,0,0,16843,232,68,7.0,True,26.66015,-79,0,-1,262,300,-38
BR1_2691142914,3,False,0,1,0,16196,261,55,7.2,True,4,True,1,0,0,17193,233,56,7.0,False,28.94708333333333,-997,-1,-1,316,289,27
BR1_2731568624,7,True,1,1,0,17643,193,49,7.2,False,5,False,0,0,0,17411,235,48,7.4,True,29.657416666666666,232,2,1,242,283,-41
BR1_2683156035,5,False,1,0,0,15109,185,44,6.8,False,7,True,0,1,0,17861,228,64,6.8,True,26.47385,-2752,-2,1,229,292,-63
BR1_2682951182,9,False,0,1,0,18471,197,64,7.4,True,9,True,0,0,0,17152,211,40,7.0,False,26.13325,1319,0,0,261,251,10
BR1_2680927903,1,False,1,0,0,16656,282,64,7.4,False,5,True,0,0,0,18109,247,64,7.8,True,29.821016666666665,-1453,-4,1,346,311,35
BR1_2677236864,6,True,0,1,0,18641,266,67,7.8,False,6,False,1,0,0,18046,266,68,7.4,True,28.8218,595,0,-1,333,334,-1
BR1_2729992945,10,True,0,0,0,19482,249,63,7.4,False,8,False,1,0,0,20295,264,72,7.6,True,29.184683333333332,-813,2,-1,312,336,-24
BR1_2730953822,1,False,0,0,0,14354,206,64,7.0,False,6,True,1,0,0,16750,236,64,7.0,True,26.67735,-2396,-5,-1,270,300,-30
BR1_2728903431,6,False,0,0,0,16735,186,52,6.6,False,11,True,0,0,0,19569,219,44,6.8,True,25.885233333333332,-2834,-5,0,238,263,-25
BR1_2728875752,4,True,1,1,0,16093,228,60,6.8,False,7,False,0,0,0,16434,210,44,6.8,True,25.189166666666665,-341,-3,1,288,254,34
BR1_2720739905,6,True,0,1,0,17408,212,52,7.2,False,10,False,1,0,0,20337,252,64,7.6,True,27.677,-2929,-4,-1,264,316,-52
BR1_2731813600,8,True,1,1,0,17608,227,62,7.0,True,5,False,0,0,0,16442,189,56,6.8,False,26.52745,1166,3,1,289,245,44
BR1_2731793481,1,False,0,0,0,14287,213,56,6.8,False,5,True,1,1,0,16961,254,48,7.4,True,25.348916666666668,-2674,-4,-1,269,302,-33
BR1_2683328270,8,False,0,0,0,17394,223,44,7.0,False,5,True,1,1,0,16751,215,56,7.0,True,25.607716666666665,643,3,-1,267,271,-4
BR1_2727018382,4,False,0,0,0,16548,236,54,7.2,False,7,True,0,0,0,16824,172,48,7.0,True,29.843183333333332,-276,-3,0,290,220,70
BR1_2705477123,7,True,0,1,0,17045,200,56,6.8,True,7,False,1,0,0,17049,193,60,6.8,False,27.453866666666666,-4,0,-1,256,253,3
BR1_2731498018,8,False,0,0,0,16902,232,44,7.0,False,6,True,1,0,0,16567,187,52,6.4,True,26.194283333333335,335,2,-1,276,239,37
BR1_2721457409,9,True,1,0,0,19955,228,42,7.2,True,5,False,0,1,0,16688,198,64,7.4,False,27.8069,3267,4,1,270,262,8
BR1_2721444880,2,True,1,1,0,14364,182,48,6.4,False,10,False,0,0,0,17775,224,63,6.8,True,25.8997,-3411,-8,1,230,287,-57
BR1_2703593332,9,False,0,0,0,18725,239,51,7.4,True,6,True,1,0,0,17618,246,59,7.6,False,27.7453,1107,3,-1,290,305,-15
BR1_2702317610,11,True,1,1,0,17968,159,48,6.8,True,8,False,0,0,0,17276,194,63,7.0,False,26.269916666666667,692,3,1,207,257,-50
BR1_2729893510,10,True,0,1,0,20745,227,56,7.2,False,6,False,1,0,0,17567,222,59,7.0,True,28.93605,3178,4,-1,283,281,2
BR1_2729843003,4,False,0,1,0,17529,269,56,7.6,True,4,True,1,0,0,16929,266,64,7.4,False,27.778,600,0,-1,325,330,-5
BR1_2706911688,12,True,0,0,0,19889,219,48,7.0,False,3,False,0,0,0,14571,194,48,6.8,True,25.985283333333335,5318,9,0,267,242,25
BR1_2706635319,6,False,0,0,0,18115,239,64,7.4,False,6,True,1,1,0,19243,253,68,7.6,True,29.207583333333332,-1128,0,-1,303,321,-18
BR1_2706622545,6,True,0,0,0,16415,220,49,7.0,True,3,False,0,0,0,15479,245,60,6.8,False,26.182283333333334,936,3,0,269,305,-36
BR1_2723514214,7,False,0,0,0,17290,222,56,7.2,True,5,True,1,1,0,16759,197,48,7.0,False,28.12325,531,2,-1,278,245,33
BR1_2723477976,10,False,0,0,0,18286,218,43,6.8,False,8,True,1,1,0,17253,179,59,6.6,True,26.385083333333334,1033,2,-1,261,238,23
BR1_2730498475,8,True,1,0,0,17701,210,56,7.0,True,5,False,0,0,0,16268,216,68,6.8,False,27.161683333333333,1433,3,1,266,284,-18
BR1_2730124030,5,False,0,0,0,15498,177,40,6.2,False,11,True,0,0,0,18734,217,56,7.0,True,26.8269,-3236,-6,0,217,273,-56
BR1_2731590183,12,False,0,0,0,20340,223,51,7.6,False,13,True,1,0,0,21398,223,63,7.4,True,29.581583333333334,-1058,-1,-1,274,286,-12
BR1_2663756401,7,False,1,1,0,17744,212,60,7.4,True,3,True,0,0,0,16846,257,48,7.4,False,29.4078,898,4,1,272,305,-33
BR1_2699466156,11,True,0,0,0,19898,218,73,7.2,True,16,False,1,1,0,21691,214,44,7.8,False,28.9233,-1793,-5,-1,291,258,33
BR1_2725951417,11,True,0,0,0,18642,218,52,7.0,True,8,False,0,0,0,16617,170,44,6.4,False,26.406883333333333,2025,3,0,270,214,56
BR1_2731520287,2,True,0,1,0,15218,217,52,6.8,False,2,False,1,0,0,14723,207,68,7.0,True,26.590483333333335,495,0,-1,269,275,-6
BR1_2731486627,4,False,0,0,0,14935,230,36,6.8,False,6,True,0,1,0,15508,163,48,6.8,True,25.08445,-573,-2,0,266,211,55
BR1_2709166427,7,False,0,0,0,17656,195,77,7.0,True,14,True,1,1,0,20129,218,54,7.0,False,25.374816666666668,-2473,-7,-1,272,272,0
BR1_2708687280,6,False,0,0,0,15832,196,52,7.0,False,6,True,0,0,0,17113,251,64,7.2,True,27.319983333333333,-1281,0,0,248,315,-67
BR1_2708660404,6,False,1,0,0,17434,201,57,7.0,True,7,True,0,0,0,16055,163,61,6.8,False,25.0043,1379,-1,1,258,224,34
BR1_2731849877,4,True,1,1,0,16909,257,52,7.4,True,6,False,0,0,0,16813,201,56,7.2,False,28.200283333333335,96,-2,1,309,257,52
BR1_2731584103,5,True,0,0,0,17726,252,51,7.6,True,8,False,1,1,0,19947,213,72,7.4,False,29.4343,-2221,-3,-1,303,285,18
BR1_2731784331,10,False,1,0,0,18306,188,48,7.0,True,15,True,0,0,0,21834,258,40,7.6,False,27.866183333333332,-3528,-5,1,236,298,-62
BR1_2731760480,7,True,0,0,0,16578,201,56,7.0,False,8,False,1,0,0,17819,242,60,6.8,True,27.148983333333334,-1241,-1,-1,257,302,-45
BR1_2731306746,8,False,0,1,0,18148,179,72,6.6,True,7,True,0,0,0,17091,204,56,6.6,False,25.449733333333334,1057,1,0,251,260,-9
BR1_2730681328,5,True,1,1,0,16254,193,52,7.0,True,2,False,0,0,0,15103,234,55,7.0,False,26.3759,1151,3,1,245,289,-44
BR1_2730756998,1,True,0,0,0,14004,209,56,6.6,False,3,False,1,0,0,15990,244,68,7.2,True,26.391933333333334,-1986,-2,-1,265,312,-47
BR1_2731242792,7,False,1,0,0,18290,244,52,7.6,True,6,True,0,0,0,18514,243,68,7.8,False,27.798333333333332,-224,1,1,296,311,-15
BR1_2731201087,3,True,0,0,0,15023,210,68,7.0,False,6,False,1,1,0,16597,230,48,7.0,True,27.483516666666667,-1574,-3,-1,278,278,0
BR1_2731172144,6,False,0,0,0,15406,211,44,6.6,True,9,True,1,0,0,17790,201,48,6.8,False,25.148466666666668,-2384,-3,-1,255,249,6
BR1_2710339482,4,False,1,0,0,16958,252,58,7.4,True,5,True,0,0,0,18326,270,56,7.4,False,28.985683333333334,-1368,-1,1,310,326,-16
BR1_2709485077,1,False,1,0,0,15021,214,52,7.0,False,7,True,0,0,0,17969,240,60,7.6,True,29.667,-2948,-6,1,266,300,-34
BR1_2706585585,8,False,0,0,0,17793,219,60,7.2,True,6,True,1,0,0,17320,208,64,6.8,False,26.545983333333332,473,2,-1,279,272,7
BR1_2693432899,10,False,1,0,0,18638,202,69,7.6,True,4,True,0,0,0,15868,187,54,7.0,False,28.686283333333332,2770,6,1,271,241,30
BR1_2721480986,3,True,0,0,0,14908,192,57,6.6,False,6,False,1,0,0,16759,219,51,6.8,True,25.191,-1851,-3,-1,249,270,-21
BR1_2690388290,9,True,1,1,1,20474,272,56,7.2,False,6,False,0,0,0,17718,226,68,7.4,True,27.550716666666666,2756,3,1,328,294,34
BR1_2729481355,25,True,0,0,0,25655,216,32,7.2,True,16,False,0,0,0,20805,175,32,6.8,False,28.0209,4850,9,0,248,207,41
BR1_2731858456,8,False,1,0,0,17881,198,44,7.0,True,11,True,0,0,0,20322,226,57,7.2,False,29.851216666666666,-2441,-3,1,242,283,-41
BR1_2731073494,6,False,0,0,0,17322,209,64,7.4,False,10,True,1,1,0,18640,225,51,7.4,True,28.69635,-1318,-4,-1,273,276,-3
BR1_2710946972,10,False,0,0,0,19208,221,60,7.4,False,8,True,1,1,0,19588,226,80,7.6,True,27.68785,-380,2,-1,281,306,-25
BR1_2703382792,12,False,1,0,0,19687,223,48,7.0,True,11,True,0,0,0,19081,219,48,7.0,False,25.16925,606,1,1,271,267,4
BR1_2717550163,5,False,0,0,0,17226,184,54,7.2,False,11,True,1,0,0,18841,221,56,7.2,True,27.643716666666666,-1615,-6,-1,238,277,-39
BR1_2717519058,5,True,1,0,0,15436,185,58,6.6,False,5,False,0,0,0,15814,209,44,6.6,True,26.93685,-378,0,1,243,253,-10
BR1_2714755037,0,False,0,0,0,13339,211,60,6.6,True,4,True,1,0,0,15458,198,56,6.8,False,26.6848,-2119,-4,-1,271,254,17
BR1_2731086514,8,True,0,0,0,17017,201,48,6.8,False,5,False,1,1,0,15327,185,60,6.6,True,25.555633333333333,1690,3,-1,249,245,4
BR1_2731033295,6,True,0,0,0,17464,226,48,7.0,True,1,False,1,0,0,15170,242,64,7.4,False,29.366816666666665,2294,5,-1,274,306,-32
BR1_2706474715,16,True,0,1,0,20864,185,48,7.0,True,8,False,1,0,0,17087,197,40,6.6,False,25.91735,3777,8,-1,233,237,-4
BR1_2706450307,7,False,0,1,0,15938,171,63,6.8,False,9,True,0,0,0,19180,217,48,6.8,True,25.6535,-3242,-2,0,234,265,-31
BR1_2730004491,15,False,0,0,0,22197,209,40,7.2,True,13,True,0,1,1,22382,217,51,7.2,False,29.826433333333334,-185,2,0,249,268,-19
BR1_2729910053,8,False,1,1,0,19255,239,60,7.4,True,7,True,0,0,0,17785,231,64,7.0,False,28.15748333333333,1470,1,1,299,295,4
BR1_2691724833,5,False,0,0,0,16289,232,52,7.0,True,8,True,0,0,0,17308,222,64,7.0,False,27.01695,-1019,-3,0,284,286,-2
BR1_2691718016,4,True,0,0,0,17027,243,64,7.6,False,5,False,1,1,0,17988,251,63,7.4,True,29.566116666666666,-961,-1,-1,307,314,-7
BR1_2724446516,7,True,0,0,0,17501,213,44,7.0,True,7,False,1,0,0,16951,218,60,7.2,False,26.1584,550,0,-1,257,278,-21
BR1_2711778252,4,False,0,0,0,14998,225,36,6.6,False,15,True,1,0,0,19776,215,64,7.2,True,25.34175,-4778,-11,-1,261,279,-18
BR1_2724347213,7,False,0,0,0,17098,207,51,7.2,False,7,True,0,0,0,19251,260,77,7.4,True,29.73218333333333,-2153,0,0,258,337,-79
BR1_2724327856,7,False,1,0,0,16729,212,76,7.0,False,8,True,0,1,0,17112,199,52,6.8,True,26.82465,-383,-1,1,288,251,37
BR1_2724314475,9,False,0,0,0,17406,185,48,6.8,True,9,True,0,0,0,17504,219,60,7.0,False,25.37395,-98,0,0,233,279,-46
BR1_2724302660,9,False,1,1,1,21563,241,68,8.0,False,7,True,0,0,0,17532,189,60,7.0,True,29.161933333333334,4031,2,1,309,249,60
BR1_2730817195,4,False,0,0,0,16214,214,68,7.2,False,9,True,1,0,0,19502,268,72,7.8,True,28.485866666666666,-3288,-5,-1,282,340,-58
BR1_2730794004,7,True,0,0,0,18355,228,67,7.2,True,8,False,0,0,0,17650,227,48,7.2,False,29.693083333333334,705,-1,0,295,275,20
BR1_2731717890,9,False,0,0,0,17350,210,52,6.6,True,8,True,0,0,0,16266,190,40,6.8,False,26.59515,1084,1,0,262,230,32
BR1_2730839467,8,False,0,0,0,19534,257,74,7.6,False,8,True,1,0,0,18790,229,64,7.2,True,28.033766666666665,744,0,-1,331,293,38
BR1_2718311727,7,True,0,0,0,18530,239,52,7.0,False,6,False,0,0,0,16630,190,52,7.0,True,29.6313,1900,1,0,291,242,49
BR1_2731011913,7,True,0,0,0,18663,260,68,7.4,False,6,False,1,1,1,18798,250,68,7.6,True,29.20575,-135,1,-1,328,318,10
BR1_2731001781,6,True,0,0,0,16793,221,59,7.0,True,1,False,1,0,0,14217,237,68,6.8,False,26.118066666666667,2576,5,-1,280,305,-25
BR1_2730992324,0,False,1,0,0,14073,210,64,6.8,True,8,True,0,0,0,17136,212,44,7.2,False,26.52391666666667,-3063,-8,1,274,256,18
BR1_2731516133,5,True,0,0,0,16302,185,56,7.0,False,11,False,1,1,0,21854,251,62,7.4,True,28.345466666666667,-5552,-6,-1,241,313,-72
BR1_2731330048,11,True,1,0,0,19898,206,48,7.4,True,6,False,0,0,0,18196,221,56,7.2,False,28.083233333333332,1702,5,1,254,277,-23
BR1_2730193053,6,False,1,0,0,15382,180,56,6.4,False,6,True,0,1,0,16261,219,44,6.8,True,26.17995,-879,0,1,236,263,-27
BR1_2730051480,6,True,0,0,0,17409,231,48,7.6,True,9,False,1,0,0,18865,243,48,7.2,False,27.8322,-1456,-3,-1,279,291,-12
BR1_2728899826,6,False,0,0,0,15904,219,44,6.8,False,9,True,0,0,0,18764,233,51,7.0,True,26.798166666666667,-2860,-3,0,263,284,-21
BR1_2730716331,10,True,0,0,0,17494,186,52,6.8,True,8,False,0,0,0,16965,165,52,6.4,False,26.13458333333333,529,2,0,238,217,21
BR1_2730694023,12,False,1,0,0,21253,221,60,7.2,False,14,True,0,0,0,21296,231,47,7.2,True,27.60335,-43,-2,1,281,278,3
BR1_2730652529,6,False,0,1,0,17818,228,62,7.4,False,9,True,1,0,0,19190,237,58,7.6,True,29.048816666666667,-1372,-3,-1,290,295,-5
BR1_2730050107,11,True,0,0,0,18921,223,49,7.0,False,9,False,0,1,0,16571,147,56,6.6,True,26.641333333333332,2350,2,0,272,203,69
BR1_2730016904,8,True,0,0,0,16681,197,52,6.8,False,9,False,1,0,0,17617,205,56,7.4,True,26.43805,-936,-1,-1,249,261,-12
BR1_2731372717,10,False,0,1,0,20825,217,56,7.4,True,5,True,1,0,0,16649,208,52,7.0,False,27.9331,4176,5,-1,273,260,13
BR1_2731368433,8,False,0,0,0,16670,193,40,6.6,False,5,True,1,0,0,16055,223,56,6.8,True,25.725416666666668,615,3,-1,233,279,-46
BR1_2731363108,3,False,0,1,0,15054,219,52,6.8,False,10,True,1,0,0,17966,217,48,7.2,True,27.475216666666668,-2912,-7,-1,271,265,6
BR1_2730137215,8,True,1,1,0,19319,261,71,7.8,True,6,False,0,0,0,17716,246,51,7.4,False,29.424466666666667,1603,2,1,332,297,35
BR1_2730280077,9,True,0,0,0,18710,205,68,7.2,False,10,False,1,0,0,18565,239,52,7.2,True,29.121483333333334,145,-1,-1,273,291,-18
BR1_2730259750,10,False,1,1,0,19011,223,52,7.4,True,9,True,0,0,0,18726,222,56,7.2,False,27.62376666666667,285,1,1,275,278,-3
BR1_2722944687,12,False,1,0,0,20596,205,58,7.4,False,7,True,0,0,0,19463,245,56,7.2,True,28.006616666666666,1133,5,1,263,301,-38
BR1_2722907738,11,True,0,0,0,19273,199,68,6.8,True,7,False,1,0,0,16944,212,60,7.0,False,25.424516666666666,2329,4,-1,267,272,-5
BR1_2731703204,13,True,0,0,0,19362,196,72,7.2,True,7,False,0,0,0,15576,143,52,6.4,False,25.1672,3786,6,0,268,195,73
BR1_2731596081,5,False,0,0,0,15614,211,52,6.8,False,3,True,1,1,0,15153,219,47,6.8,True,26.857666666666667,461,2,-1,263,266,-3
BR1_2689676303,10,False,1,0,0,18559,236,44,7.0,True,10,True,0,0,0,19921,239,56,7.6,False,28.65435,-1362,0,1,280,295,-15
BR1_2689640957,4,True,0,0,0,14329,176,52,6.8,False,4,False,1,1,1,16900,210,56,7.0,True,25.015483333333332,-2571,0,-1,228,266,-38
BR1_2731602496,3,False,0,1,0,15855,186,58,6.8,False,15,True,1,0,0,21795,247,53,7.8,True,27.542283333333334,-5940,-12,-1,244,300,-56
BR1_2696277540,11,False,1,0,0,20166,246,46,7.4,False,5,True,0,1,0,18017,238,68,7.4,True,28.8417,2149,6,1,292,306,-14
BR1_2696277216,8,False,0,0,0,19729,256,64,7.4,True,9,True,1,0,0,19283,208,60,7.4,False,27.8686,446,-1,-1,320,268,52
BR1_2696270416,9,False,1,0,0,18900,241,66,7.6,True,6,True,0,1,0,17535,210,52,7.0,False,27.502166666666668,1365,3,1,307,262,45
BR1_2729722090,4,False,0,1,0,17675,243,56,7.6,False,6,True,1,0,0,17605,244,56,7.6,True,28.067383333333332,70,-2,-1,299,300,-1
BR1_2729695740,8,True,0,0,0,17181,215,64,7.0,False,8,False,0,0,0,17666,213,68,7.2,True,29.899516666666667,-485,0,0,279,281,-2
BR1_2731777874,4,False,0,0,0,14938,195,54,6.4,False,12,True,1,0,0,19714,205,49,6.8,True,26.83025,-4776,-8,-1,249,254,-5
BR1_2731747956,7,False,0,1,0,16879,205,68,6.8,True,5,True,1,0,0,15636,202,56,6.6,False,26.029216666666667,1243,2,-1,273,258,15
BR1_2717581996,11,True,1,0,0,19100,225,52,7.0,True,10,False,0,1,0,17337,157,44,6.4,False,25.651483333333335,1763,1,1,277,201,76
BR1_2721032392,6,True,1,0,0,19173,253,76,7.6,True,6,False,0,1,0,18948,239,56,7.4,False,28.689283333333332,225,0,1,329,295,34
BR1_2721021580,12,True,0,0,0,19827,236,62,7.6,True,7,False,1,0,0,16245,190,60,7.2,False,28.471266666666665,3582,5,-1,298,250,48
BR1_2720563246,4,False,0,0,0,16529,206,64,7.2,False,5,True,0,1,0,17089,228,44,7.4,True,29.6392,-560,-1,0,270,272,-2
BR1_2685619603,8,False,1,0,0,17740,230,48,7.8,False,9,True,0,1,0,19248,239,72,7.8,True,28.898083333333332,-1508,-1,1,278,311,-33
BR1_2685575652,8,False,0,0,0,17507,192,56,7.0,True,9,True,0,0,0,17762,215,54,7.0,False,25.32425,-255,-1,0,248,269,-21
BR1_2684475584,3,False,0,0,0,16068,236,52,7.4,False,7,True,0,1,0,18797,248,68,7.6,True,28.988383333333335,-2729,-4,0,288,316,-28
BR1_2728062543,7,False,1,0,0,15888,181,48,6.4,False,7,True,0,1,0,17741,239,47,6.8,True,26.147866666666665,-1853,0,1,229,286,-57
BR1_2731754981,8,True,0,0,0,19482,242,60,7.4,True,7,False,1,0,0,17845,240,72,7.2,False,28.249616666666668,1637,1,-1,302,312,-10
BR1_2731730446,6,True,0,0,0,18646,199,54,7.0,False,17,False,0,1,0,23108,231,76,7.8,True,27.657716666666666,-4462,-11,0,253,307,-54
BR1_2731848797,12,True,1,1,0,20536,240,64,7.6,False,5,False,0,0,0,16915,225,43,7.4,True,27.59225,3621,7,1,304,268,36
BR1_2731767424,10,False,0,0,0,19984,266,48,7.4,False,17,True,1,0,0,21789,232,48,7.6,True,28.98005,-1805,-7,-1,314,280,34
BR1_2731713585,16,True,0,0,0,19865,159,48,6.0,False,11,False,0,0,0,18438,202,36,6.8,True,25.721633333333333,1427,5,0,207,238,-31
BR1_2730763550,10,False,1,1,0,18942,214,70,7.6,True,10,True,0,0,0,19074,262,44,7.4,False,29.0082,-132,0,1,284,306,-22
BR1_2731646342,6,True,0,0,0,17604,194,48,7.0,False,8,False,1,0,0,18794,226,80,7.4,True,29.055083333333332,-1190,-2,-1,242,306,-64
BR1_2731783349,10,True,0,0,0,18418,213,44,7.0,False,13,False,1,0,0,18673,181,44,7.0,True,29.856166666666667,-255,-3,-1,257,225,32
BR1_2730959397,9,False,1,1,0,18734,244,44,7.4,True,8,True,0,0,0,18846,258,76,7.4,False,28.77835,-112,1,1,288,334,-46
BR1_2730839151,2,False,0,0,0,13892,186,54,6.4,True,5,True,0,0,0,16740,223,44,7.0,False,25.273633333333333,-2848,-3,0,240,267,-27
BR1_2730445668,1,False,0,0,0,16196,255,52,7.2,True,6,True,1,0,0,18772,266,68,7.4,False,27.619566666666667,-2576,-5,-1,307,334,-27
BR1_2731610556,7,False,0,0,0,17371,223,62,6.8,False,6,True,1,0,0,15425,173,56,6.6,True,25.0517,1946,1,-1,285,229,56
BR1_2731173935,9,True,0,1,0,18661,208,56,7.2,True,6,False,0,0,0,16951,224,63,7.4,False,28.886266666666668,1710,3,0,264,287,-23
BR1_2730257208,11,False,1,0,0,19468,215,68,7.6,True,7,True,0,0,0,17236,200,47,7.4,False,29.35795,2232,4,1,283,247,36
BR1_2729780986,10,True,0,0,0,18729,208,52,6.6,False,12,False,0,0,0,19071,205,50,6.6,True,26.928633333333334,-342,-2,0,260,255,5
BR1_2729889530,10,True,0,1,0,18968,205,48,6.4,True,8,False,0,0,0,16820,171,32,6.2,False,25.39745,2148,2,0,253,203,50
BR1_2730291821,3,False,1,0,0,16645,262,56,7.4,False,6,True,0,1,0,18330,261,72,7.8,True,29.151433333333333,-1685,-3,1,318,333,-15
BR1_2728845713,3,False,0,0,0,14037,162,40,6.2,False,9,True,1,1,0,18722,235,60,6.6,True,26.627816666666668,-4685,-6,-1,202,295,-93
BR1_2731856270,2,False,0,0,0,15798,264,60,7.2,False,6,True,1,1,0,18674,248,65,7.6,True,28.9915,-2876,-4,-1,324,313,11
BR1_2717301998,7,False,1,0,0,16031,200,60,6.6,True,9,True,0,0,0,17363,191,48,6.8,False,27.428933333333333,-1332,-2,1,260,239,21
BR1_2716254428,11,False,1,0,0,19141,193,68,7.0,True,10,True,0,0,0,19211,229,56,7.4,False,29.604383333333335,-70,1,1,261,285,-24
BR1_2714038635,9,False,0,0,0,19059,241,54,7.2,True,7,True,1,1,0,18134,234,41,7.0,False,29.835,925,2,-1,295,275,20
BR1_2725509201,6,True,1,0,0,17793,256,48,7.2,False,4,False,0,0,0,17400,250,74,7.4,True,27.990933333333334,393,2,1,304,324,-20
BR1_2725483631,5,True,1,0,0,15464,221,49,6.8,False,5,False,0,1,0,16754,228,52,7.2,True,27.376416666666668,-1290,0,1,270,280,-10
BR1_2731518372,8,True,0,1,0,17776,212,55,7.4,False,7,False,0,0,0,17754,243,44,7.0,True,29.25005,22,1,0,267,287,-20
BR1_2731486337,6,True,0,0,0,17278,223,56,7.2,False,9,False,1,0,0,18860,248,44,7.2,True,29.564333333333334,-1582,-3,-1,279,292,-13
BR1_2731472151,15,True,1,0,0,21898,280,64,7.8,True,2,False,0,0,0,15625,233,50,7.2,False,29.982966666666666,6273,13,1,344,283,61
BR1_2730224479,9,True,1,0,0,18883,205,64,7.4,True,9,False,0,1,0,19952,267,72,7.4,False,28.7013,-1069,0,1,269,339,-70
BR1_2726179403,10,True,1,0,0,17802,176,39,6.4,True,12,False,0,0,0,19018,183,48,6.8,False,26.50675,-1216,-2,1,215,231,-16
BR1_2728584256,9,True,1,1,0,18593,204,60,7.0,True,4,False,0,0,0,15057,201,52,6.6,False,27.27925,3536,5,1,264,253,11
BR1_2728562595,7,False,0,0,0,16936,195,53,6.8,False,8,True,0,0,0,16903,186,44,6.8,True,26.563166666666667,33,-1,0,248,230,18
BR1_2690515108,4,False,0,0,0,15790,207,52,6.8,False,7,True,1,0,0,17214,197,55,7.0,True,26.15105,-1424,-3,-1,259,252,7
BR1_2731467405,4,False,0,1,0,16355,207,61,7.2,False,8,True,1,0,0,19540,257,78,7.6,True,28.6131,-3185,-4,-1,268,335,-67
BR1_2731276078,7,True,0,0,0,18892,244,52,7.6,True,3,False,1,0,0,15656,226,48,7.0,False,27.683816666666665,3236,4,-1,296,274,22
BR1_2731882016,9,True,0,1,0,17758,208,55,6.8,False,3,False,0,0,0,14210,171,50,6.2,True,25.736333333333334,3548,6,0,263,221,42
BR1_2731624089,7,False,0,0,0,19276,261,56,7.2,True,11,True,1,0,0,19896,259,47,7.4,False,29.039783333333332,-620,-4,-1,317,306,11
BR1_2718726261,13,True,1,0,0,20306,221,58,7.2,True,9,False,0,1,0,18862,221,54,7.6,False,28.426983333333332,1444,4,1,279,275,4
BR1_2714509650,6,True,1,1,0,17463,217,66,7.2,True,5,False,0,0,0,17640,248,53,7.6,False,29.65748333333333,-177,1,1,283,301,-18
BR1_2730210549,12,False,0,0,0,18177,165,39,6.4,True,9,True,1,1,0,18132,192,51,7.0,False,26.067933333333333,45,3,-1,204,243,-39
BR1_2705451084,6,True,0,0,0,16559,218,48,6.8,False,6,False,1,1,0,16675,205,56,6.8,True,25.404433333333333,-116,0,-1,266,261,5
BR1_2725323965,9,True,0,0,0,20066,239,64,7.4,True,7,False,0,0,0,18078,241,56,7.2,False,28.254533333333335,1988,2,0,303,297,6
BR1_2725080718,8,False,0,1,0,18698,242,75,7.8,False,9,True,1,0,0,19675,236,60,7.4,True,28.135866666666665,-977,-1,-1,317,296,21
BR1_2730138287,13,True,0,0,0,18279,213,56,7.2,True,9,False,1,0,0,16429,200,64,7.2,False,27.455216666666665,1850,4,-1,269,264,5
BR1_2730106795,7,True,1,0,0,18409,271,52,7.8,True,3,False,0,1,0,16585,233,55,7.2,False,29.252983333333333,1824,4,1,323,288,35
BR1_2729429619,2,True,1,0,0,14752,202,64,6.6,True,3,False,0,1,0,15827,226,48,6.8,False,25.79075,-1075,-1,1,266,274,-8
BR1_2729275678,7,True,1,1,0,18984,232,60,7.4,True,1,False,0,0,0,15519,257,67,7.6,False,29.88995,3465,6,1,292,324,-32
BR1_2729258809,7,False,0,0,0,19390,226,76,7.6,False,12,True,1,1,0,20263,236,64,7.2,True,27.748166666666666,-873,-5,-1,302,300,2
BR1_2729178843,5,False,0,0,0,14467,147,55,6.2,False,9,True,1,0,0,17775,227,60,7.2,True,25.535566666666668,-3308,-4,-1,202,287,-85
BR1_2729172971,5,True,0,1,0,16952,224,64,6.8,True,5,False,1,0,0,16769,211,64,7.2,False,27.36565,183,0,-1,288,275,13
BR1_2731800464,4,False,0,0,0,15862,228,68,7.0,False,4,True,1,0,0,15137,186,60,6.8,True,26.600416666666668,725,0,-1,296,246,50
BR1_2731777619,7,False,0,0,0,17477,222,56,7.6,False,12,True,1,0,0,19405,202,79,7.8,True,29.537716666666668,-1928,-5,-1,278,281,-3
BR1_2731751443,7,True,0,1,1,19675,249,59,7.4,True,11,False,1,0,0,20101,253,72,7.4,False,29.860633333333332,-426,-4,-1,308,325,-17
BR1_2731601620,8,False,0,0,0,17909,233,28,7.4,True,3,True,1,1,0,16791,234,74,7.2,False,29.155933333333333,1118,5,-1,261,308,-47
BR1_2727905437,7,True,0,0,0,19148,258,60,7.4,True,9,False,1,0,0,18213,221,52,7.4,False,29.853483333333333,935,-2,-1,318,273,45
BR1_2682256850,14,True,0,1,0,21303,216,52,7.8,False,8,False,1,0,0,17728,207,48,7.2,True,29.274116666666668,3575,6,-1,268,255,13
BR1_2682203158,4,False,1,0,0,15169,223,56,6.8,True,5,True,0,1,0,16612,210,64,7.0,False,25.164533333333335,-1443,-1,1,279,274,5
BR1_2662776651,5,True,1,0,0,16164,223,64,7.2,False,3,False,0,0,0,15131,206,48,6.6,True,27.330583333333333,1033,2,1,287,254,33
BR1_2662723319,6,False,0,0,0,15466,206,39,6.6,False,12,True,1,0,0,19761,224,52,7.2,True,25.808583333333335,-4295,-6,-1,245,276,-31
BR1_2731720814,5,False,0,0,0,15549,218,40,6.8,False,6,True,0,1,0,17368,236,60,7.0,True,26.759866666666667,-1819,-1,0,258,296,-38
BR1_2731812706,8,False,1,0,0,18116,221,68,7.0,False,6,True,0,0,2,20860,255,60,7.4,True,28.570233333333334,-2744,2,1,289,315,-26
BR1_2698545445,10,False,0,0,0,17420,191,48,6.4,True,8,True,1,0,0,17282,186,56,6.6,False,25.869966666666667,138,2,-1,239,242,-3
BR1_2698509482,5,True,0,0,0,18026,211,68,7.2,False,10,False,1,1,0,21549,255,80,8.0,True,28.998816666666666,-3523,-5,-1,279,335,-56
BR1_2698446567,9,True,1,1,0,20560,298,68,7.8,True,5,False,0,0,0,17455,239,72,7.6,False,28.637766666666668,3105,4,1,366,311,55
BR1_2729395586,10,False,0,0,0,20658,262,72,7.6,True,8,True,1,1,0,19528,245,76,7.2,False,29.14595,1130,2,-1,334,321,13
BR1_2678264689,8,True,0,0,0,19458,245,64,7.4,True,3,False,0,0,0,16092,213,50,7.0,False,28.650366666666667,3366,5,0,309,263,46
BR1_2731934117,6,True,0,1,0,19244,274,52,7.6,True,5,False,1,0,0,16471,180,68,7.2,False,28.8716,2773,1,-1,326,248,78
BR1_2731907409,10,True,1,0,0,18692,239,46,7.4,False,3,False,0,0,0,16800,197,56,7.0,True,28.920266666666667,1892,7,1,285,253,32
BR1_2731674446,4,False,1,0,0,15445,216,52,6.6,True,4,True,0,1,0,15487,231,38,6.8,False,26.508016666666666,-42,0,1,268,269,-1
BR1_2724009320,5,False,0,0,0,14591,185,46,6.6,False,9,True,1,1,0,17992,204,71,7.0,True,25.494083333333332,-3401,-4,-1,231,275,-44
BR1_2731124901,3,False,1,0,0,14508,198,64,6.8,False,5,True,0,0,0,16939,241,72,7.2,True,27.436016666666667,-2431,-2,1,262,313,-51
BR1_2731076470,6,False,0,1,0,17088,212,48,7.0,True,11,True,1,0,0,17699,215,35,6.8,False,26.770333333333333,-611,-5,-1,260,250,10
BR1_2730877589,10,False,0,0,0,19477,224,40,7.0,False,15,True,1,1,1,22673,257,56,7.4,True,28.551366666666667,-3196,-5,-1,264,313,-49
BR1_2729240460,7,False,0,0,0,18353,210,60,7.2,False,11,True,1,1,0,20265,213,52,7.2,True,27.963783333333332,-1912,-4,-1,270,265,5
BR1_2728698219,4,True,0,0,0,16898,225,60,7.2,False,7,False,1,1,0,19859,297,80,7.8,True,28.8749,-2961,-3,-1,285,377,-92
BR1_2728683874,9,False,0,0,0,19238,262,60,7.4,False,8,True,1,0,0,18129,202,68,7.4,True,28.824316666666668,1109,1,-1,322,270,52
BR1_2730629098,6,False,0,0,0,18571,244,76,8.0,True,6,True,1,1,0,18334,257,52,7.2,False,29.48855,237,0,-1,320,309,11
BR1_2730593319,8,False,0,0,0,17387,224,46,7.2,True,6,True,0,0,0,17306,234,52,7.0,False,27.200333333333333,81,2,0,270,286,-16
BR1_2727729023,6,False,1,0,0,16030,203,48,6.8,False,5,True,0,1,0,16344,222,55,6.8,True,26.7158,-314,1,1,251,277,-26
BR1_2727717087,10,True,0,0,0,19830,223,67,7.4,True,6,False,0,0,0,17149,219,54,7.0,False,28.504466666666666,2681,4,0,290,273,17
BR1_2729117546,7,False,1,0,0,16928,202,60,7.6,True,11,True,0,0,0,19651,237,56,7.6,False,27.589933333333335,-2723,-4,1,262,293,-31
BR1_2731758917,6,True,0,0,0,17843,244,52,7.0,False,4,False,1,0,0,15406,180,43,6.8,True,28.157733333333333,2437,2,-1,296,223,73
BR1_2701242478,6,True,0,0,0,17763,232,48,7.2,True,7,False,1,0,0,18002,232,68,7.2,False,28.716916666666666,-239,-1,-1,280,300,-20
BR1_2731601558,7,False,0,1,0,18516,242,68,7.2,True,7,True,1,0,0,18106,207,54,7.2,False,28.553716666666666,410,0,-1,310,261,49
BR1_2731587293,1,False,0,0,0,14284,211,56,6.8,False,7,True,1,1,0,16224,207,48,6.8,True,25.005733333333332,-1940,-6,-1,267,255,12
BR1_2731921228,11,True,1,0,0,18010,197,52,6.6,False,8,False,0,0,0,16474,186,32,6.2,True,25.3515,1536,3,1,249,218,31
BR1_2731916092,8,True,1,0,0,16831,188,54,7.0,True,8,False,0,1,1,18141,187,44,6.8,False,25.829333333333334,-1310,0,1,242,231,11
BR1_2731779184,8,False,0,1,0,18370,208,60,7.4,True,5,True,0,0,0,16793,212,56,6.8,False,29.068266666666666,1577,3,0,268,268,0
BR1_2730380437,5,True,0,0,0,14695,192,49,6.6,True,5,False,1,1,0,16417,223,55,6.8,False,27.0839,-1722,0,-1,241,278,-37
BR1_2729738003,6,True,1,1,0,16766,195,60,6.8,True,4,False,0,0,0,15095,220,57,7.0,False,25.022933333333334,1671,2,1,255,277,-22
BR1_2731798863,5,False,0,0,0,17313,220,56,7.4,True,5,True,0,0,0,17228,220,64,7.4,False,28.994,85,0,0,276,284,-8
BR1_2716866933,4,True,0,0,0,16809,232,39,6.6,False,5,False,1,0,0,17907,258,56,7.6,True,27.980783333333335,-1098,-1,-1,271,314,-43
BR1_2723473944,3,False,0,0,0,14836,194,56,6.8,True,8,True,0,0,0,17981,227,60,7.0,False,26.528333333333332,-3145,-5,0,250,287,-37
BR1_2723463107,8,False,1,0,0,17477,204,60,7.2,True,7,True,0,1,0,18419,256,60,7.4,False,27.67225,-942,1,1,264,316,-52
BR1_2708743612,8,False,1,1,0,18539,202,72,7.6,True,5,True,0,0,0,18009,236,52,7.2,False,27.9888,530,3,1,274,288,-14
BR1_2708722123,12,False,0,0,0,19430,216,48,7.0,True,10,True,1,0,0,18413,239,56,7.2,False,29.51375,1017,2,-1,264,295,-31
BR1_2728045671,2,False,0,0,0,13885,179,52,6.0,False,6,True,1,1,1,19103,242,80,7.2,True,25.9311,-5218,-4,-1,231,322,-91
BR1_2730121257,9,False,1,0,0,17615,177,56,7.0,True,4,True,0,0,0,13386,144,40,6.4,False,26.380316666666666,4229,5,1,233,184,49
BR1_2679749269,12,True,1,0,0,20681,245,72,8.0,False,9,False,0,0,0,18468,221,51,7.4,True,29.209666666666667,2213,3,1,317,272,45
BR1_2731457873,3,False,0,0,0,16153,232,46,7.2,False,5,True,1,1,0,18089,280,77,8.0,True,28.45015,-1936,-2,-1,278,357,-79
BR1_2723312412,6,False,0,0,0,16600,206,52,6.6,False,7,True,0,0,0,17687,210,50,7.0,True,25.56833333333333,-1087,-1,0,258,260,-2
BR1_2723305964,5,False,0,0,0,14961,177,36,6.4,False,13,True,1,0,0,18754,200,44,6.8,True,25.529033333333334,-3793,-8,-1,213,244,-31
BR1_2730206531,5,False,1,0,0,17414,263,58,7.4,True,6,True,0,0,0,19059,264,62,7.8,False,28.35685,-1645,-1,1,321,326,-5
BR1_2730184051,6,False,0,1,0,16570,218,60,6.6,False,9,True,0,0,0,17191,161,64,7.2,True,26.19215,-621,-3,0,278,225,53
BR1_2713763287,5,False,0,0,0,15662,183,63,6.6,False,11,True,1,0,0,19995,217,68,7.0,True,25.466516666666667,-4333,-6,-1,246,285,-39
BR1_2731878191,9,True,1,0,0,19949,231,76,7.6,False,6,False,0,1,0,18140,218,76,7.4,True,29.082566666666665,1809,3,1,307,294,13
BR1_2730401560,8,True,1,1,0,18522,223,48,6.8,True,12,False,0,0,0,20204,210,52,7.4,False,29.573566666666668,-1682,-4,1,271,262,9
BR1_2713605144,14,True,1,0,0,19126,187,52,6.8,True,4,False,0,0,0,15345,193,48,6.8,False,25.565716666666667,3781,10,1,239,241,-2
BR1_2731257153,8,True,0,0,0,17862,242,60,7.2,True,4,False,1,1,0,15613,215,64,7.0,False,27.309866666666668,2249,4,-1,302,279,23
BR1_2730979386,12,True,1,0,0,18896,253,44,7.0,True,2,False,0,0,0,13788,164,68,6.6,False,25.2005,5108,10,1,297,232,65
BR1_2730825697,17,True,0,0,1,22183,217,52,7.0,True,3,False,0,1,0,14438,192,48,6.4,False,25.00486666666667,7745,14,0,269,240,29
BR1_2730801912,12,True,1,0,0,18865,203,52,6.8,True,7,False,0,0,0,16283,213,40,6.6,False,26.548733333333335,2582,5,1,255,253,2
BR1_2731070363,9,True,0,1,0,18958,223,60,7.2,False,10,False,1,0,0,19251,224,59,7.2,True,28.004433333333335,-293,-1,-1,283,283,0
BR1_2731058126,5,True,0,0,0,15301,211,48,6.8,False,6,False,1,0,0,17066,219,56,7.0,True,25.665583333333334,-1765,-1,-1,259,275,-16
BR1_2731845775,8,False,1,0,0,19012,256,52,7.4,False,11,True,0,1,0,20770,235,64,7.8,True,28.249016666666666,-1758,-3,1,308,299,9
BR1_2731830970,6,False,0,0,0,16233,231,48,7.0,False,8,True,1,0,0,18262,252,64,7.2,True,25.676216666666665,-2029,-2,-1,279,316,-37
BR1_2731589732,8,True,1,0,0,18610,213,52,7.2,True,13,False,0,0,0,20207,221,60,7.2,False,27.639916666666668,-1597,-5,1,265,281,-16
BR1_2731720799,3,False,0,0,0,14795,180,48,6.4,False,9,True,1,1,0,17232,196,72,7.0,True,26.70855,-2437,-6,-1,228,268,-40
BR1_2729851447,13,True,1,0,0,18742,200,43,7.0,True,9,False,0,0,0,17258,178,63,6.8,False,27.022366666666667,1484,4,1,243,241,2
BR1_2728921143,7,False,0,0,0,16603,189,60,6.6,False,8,True,1,1,0,18209,218,64,6.8,True,27.038616666666666,-1606,-1,-1,249,282,-33
BR1_2731361833,4,False,0,0,0,15226,195,47,6.8,False,8,True,1,1,0,17596,232,43,6.8,True,26.935783333333333,-2370,-4,-1,242,275,-33
BR1_2731356555,11,False,0,0,0,19751,226,48,7.4,True,13,True,1,0,0,20842,245,52,7.2,False,28.750883333333334,-1091,-2,-1,274,297,-23
BR1_2730592178,9,True,1,1,0,18244,202,52,6.8,True,7,False,0,0,0,15974,178,56,6.6,False,25.572166666666668,2270,2,1,254,234,20
BR1_2730808869,11,False,0,1,0,18573,188,44,7.0,True,9,True,1,0,0,17176,163,68,7.0,False,27.390366666666665,1397,2,-1,232,231,1
BR1_2730466888,9,False,0,0,0,17933,220,46,7.4,True,6,True,1,0,0,18245,245,72,7.4,False,28.266916666666667,-312,3,-1,266,317,-51
BR1_2730344162,9,True,0,1,0,17749,216,60,7.2,True,6,False,1,0,0,15323,176,48,6.8,False,27.382133333333332,2426,3,-1,276,224,52
BR1_2731791520,8,False,1,0,0,16631,203,54,7.0,False,6,True,0,0,0,16059,210,52,7.0,True,25.610166666666668,572,2,1,257,262,-5
BR1_2731752471,5,True,0,1,0,16876,219,55,7.4,True,4,False,1,0,0,14896,210,48,6.4,False,25.945483333333332,1980,1,-1,274,258,16
BR1_2731597422,7,True,1,1,0,16670,204,60,7.0,True,2,False,0,0,0,14196,187,60,6.6,False,25.2608,2474,5,1,264,247,17
BR1_2731168721,10,True,1,1,0,20673,256,56,7.2,True,8,False,0,0,0,18264,193,52,7.2,False,28.6284,2409,2,1,312,245,67
BR1_2731573972,7,True,0,0,0,18127,245,52,7.2,False,10,False,1,0,0,20095,257,56,7.8,True,28.57668333333333,-1968,-3,-1,297,313,-16
BR1_2731440149,6,True,1,0,0,16689,219,68,7.2,True,2,False,0,1,0,14826,187,48,7.0,False,25.563783333333333,1863,4,1,287,235,52
BR1_2730972928,6,False,0,0,0,17687,222,68,7.4,False,13,True,0,1,0,21789,247,75,7.8,True,27.758266666666668,-4102,-7,0,290,322,-32
BR1_2729195892,7,True,1,0,0,15653,195,48,6.4,True,6,False,0,1,0,16733,210,64,6.6,False,26.907416666666666,-1080,1,1,243,274,-31
BR1_2730290690,8,False,0,0,0,16290,186,52,6.6,True,6,True,0,0,0,15593,178,48,6.4,False,26.14205,697,2,0,238,226,12
BR1_2730799094,5,False,0,0,0,15147,176,45,6.6,True,10,True,0,0,0,17818,226,45,6.8,False,26.521416666666667,-2671,-5,0,221,271,-50
BR1_2731023515,1,False,1,0,0,13808,198,64,6.8,False,7,True,0,0,0,16721,216,64,7.0,True,25.17365,-2913,-6,1,262,280,-18
BR1_2731166405,18,True,0,0,1,22870,194,46,6.6,True,15,False,1,0,0,21185,185,54,6.8,False,26.278,1685,3,-1,240,239,1
BR1_2731139603,10,True,0,0,0,19862,249,64,7.6,True,2,False,0,0,0,16505,255,50,7.2,False,28.557983333333333,3357,8,0,313,305,8
BR1_2731522957,9,False,0,0,0,18742,223,60,7.0,True,10,True,0,0,0,18604,217,51,6.6,False,25.64945,138,-1,0,283,268,15
BR1_2731763764,9,True,1,0,0,18839,235,56,7.2,True,12,False,0,1,0,19786,214,60,7.0,False,28.018533333333334,-947,-3,1,291,274,17
BR1_2731812914,7,True,0,1,0,18188,214,56,7.6,True,3,False,1,0,0,17555,246,84,7.4,False,29.92181666666667,633,4,-1,270,330,-60
BR1_2726721861,16,False,0,0,0,22133,231,72,7.8,False,10,True,1,0,0,20942,229,56,7.2,True,28.0086,1191,6,-1,303,285,18
BR1_2726711486,5,False,0,0,0,14731,157,58,6.4,False,9,True,0,1,0,18343,191,52,6.6,True,26.6109,-3612,-4,0,215,243,-28
BR1_2730568524,7,True,0,1,0,17242,203,56,6.6,False,4,False,1,0,0,14861,214,44,6.6,True,26.887983333333334,2381,3,-1,259,258,1
BR1_2730554005,5,True,0,0,0,17144,209,60,7.4,False,9,False,1,1,0,20336,273,80,7.6,True,28.18948333333333,-3192,-4,-1,269,353,-84
BR1_2730520474,8,True,0,1,0,19468,250,76,8.0,True,1,False,1,0,0,16476,259,52,7.4,False,27.837533333333333,2992,7,-1,326,311,15
BR1_2730004378,5,False,0,0,0,14828,175,44,6.6,False,8,True,1,0,0,16753,208,36,6.6,True,25.123583333333332,-1925,-3,-1,219,244,-25
BR1_2731854835,11,False,1,0,0,19803,186,68,7.4,False,11,True,0,0,0,18878,192,44,7.0,True,29.6731,925,0,1,254,236,18
BR1_2723998958,9,True,0,0,0,16989,187,44,6.2,False,7,False,1,0,0,16956,197,52,6.6,True,25.423783333333333,33,2,-1,231,249,-18
BR1_2731429227,6,False,1,1,0,17745,218,68,7.6,False,5,True,0,0,0,18419,269,64,7.4,True,29.835616666666667,-674,1,1,286,333,-47
BR1_2731843797,8,False,1,0,0,17604,213,47,6.8,True,4,True,0,0,0,15679,223,60,6.8,False,25.75405,1925,4,1,260,283,-23
BR1_2731250710,6,False,0,1,0,17171,185,43,7.0,True,9,True,1,0,0,19879,245,68,7.2,False,29.4571,-2708,-3,-1,228,313,-85
BR1_2731221022,5,False,0,1,0,16190,180,55,6.6,False,14,True,1,0,0,20517,224,52,7.4,True,28.638866666666665,-4327,-9,-1,235,276,-41
BR1_2730258191,7,True,0,1,1,20657,276,60,7.4,True,5,False,0,0,0,17125,255,56,7.2,False,28.195383333333332,3532,2,0,336,311,25
BR1_2730198587,12,True,1,1,0,21067,240,68,7.6,True,9,False,0,0,0,20625,255,58,7.4,False,29.100233333333332,442,3,1,308,313,-5
BR1_2723249043,5,True,1,1,0,15730,187,48,6.2,False,5,False,0,0,0,15940,195,74,6.8,True,26.364366666666665,-210,0,1,235,269,-34
BR1_2731352090,3,True,1,0,0,17200,263,60,7.2,False,11,False,0,0,0,19694,238,48,7.4,True,29.1403,-2494,-8,1,323,286,37
BR1_2730336983,8,False,0,0,0,17476,230,64,7.6,False,6,True,1,0,0,17610,214,55,7.2,True,28.321833333333334,-134,2,-1,294,269,25
BR1_2724722028,6,True,1,0,0,16428,213,31,6.6,True,3,False,0,1,0,15544,214,44,6.8,False,25.001566666666665,884,3,1,244,258,-14
BR1_2731124749,6,False,1,0,0,17487,210,72,6.8,False,11,True,0,1,2,22637,252,56,7.4,True,28.791816666666666,-5150,-5,1,282,308,-26
BR1_2730295433,6,True,0,0,0,17499,204,72,6.8,False,8,False,1,0,0,15963,165,44,6.6,True,26.857083333333332,1536,-2,-1,276,209,67
BR1_2730270160,9,False,0,1,1,19071,231,48,6.8,True,5,True,0,0,0,16737,214,68,6.8,False,25.536416666666668,2334,4,0,279,282,-3
BR1_2730450000,5,True,1,1,0,16745,181,48,6.4,True,7,False,0,0,0,16602,197,64,7.0,False,27.099516666666666,143,-2,1,229,261,-32
BR1_2731708406,3,True,1,0,0,15155,208,49,7.2,False,11,False,0,0,0,19257,258,62,7.4,True,27.6948,-4102,-8,1,257,320,-63
BR1_2730134053,5,False,0,1,0,15686,206,60,7.0,False,3,True,1,0,0,15232,219,60,7.2,True,27.1109,454,2,-1,266,279,-13
BR1_2730079360,9,False,0,0,0,19744,197,44,6.8,False,12,True,1,1,0,20744,218,68,7.0,True,29.479883333333333,-1000,-3,-1,241,286,-45
BR1_2731651140,11,True,0,1,0,19513,207,51,7.0,False,10,False,0,0,0,18749,200,60,7.2,True,27.830333333333332,764,1,0,258,260,-2
BR1_2728896430,6,False,0,0,0,16766,182,56,7.0,False,5,True,0,0,0,17879,256,64,7.6,True,29.15105,-1113,1,0,238,320,-82
BR1_2731850413,10,False,1,0,0,19238,208,60,7.0,True,8,True,0,1,0,18035,190,67,7.2,False,28.943016666666665,1203,2,1,268,257,11
BR1_2730635580,7,True,0,0,0,18302,241,44,7.0,False,10,False,0,0,0,19315,235,60,7.6,True,28.389016666666667,-1013,-3,0,285,295,-10
BR1_2730506022,5,False,1,0,0,15924,214,52,6.6,True,5,True,0,0,0,17430,213,68,7.0,False,26.30375,-1506,0,1,266,281,-15
BR1_2730351875,7,True,0,0,0,16397,228,48,6.6,False,8,False,1,0,0,18229,223,56,7.0,True,26.9874,-1832,-1,-1,276,279,-3
BR1_2731757029,5,False,0,0,0,15314,193,60,7.0,True,4,True,1,1,0,15849,219,48,6.6,False,25.986866666666668,-535,1,-1,253,267,-14
BR1_2731643116,6,True,0,1,0,16182,191,52,6.6,False,9,False,1,0,0,17055,191,60,7.0,True,26.40965,-873,-3,-1,243,251,-8
BR1_2731132671,10,False,1,0,0,19211,224,64,7.4,False,14,True,0,1,0,22000,241,48,7.6,True,28.503983333333334,-2789,-4,1,288,289,-1
BR1_2731685154,8,True,1,0,0,17618,212,40,6.8,True,8,False,0,1,0,17913,202,56,7.2,False,25.94175,-295,0,1,252,258,-6
BR1_2731638814,10,True,0,1,0,19936,239,52,7.6,True,6,False,0,0,0,16519,189,52,6.6,False,27.6565,3417,4,0,291,241,50
BR1_2731867752,7,False,1,0,0,18921,222,59,7.4,True,12,True,0,1,0,20730,241,56,7.4,False,27.633483333333334,-1809,-5,1,281,297,-16
BR1_2731861636,8,False,0,0,0,18303,220,48,7.4,False,3,True,1,0,0,16673,230,64,7.2,True,28.08745,1630,5,-1,268,294,-26
BR1_2728875932,8,False,0,0,0,19590,229,68,7.4,True,11,True,1,1,0,21175,236,76,7.6,False,28.182516666666668,-1585,-3,-1,297,312,-15
BR1_2729825598,11,True,1,1,0,19200,207,56,7.0,True,6,False,0,0,0,16152,187,35,6.8,False,25.634183333333333,3048,5,1,263,222,41
BR1_2729819589,14,True,1,1,0,20957,216,64,7.0,True,9,False,0,0,0,19354,205,48,6.8,False,28.38985,1603,5,1,280,253,27
BR1_2731830158,10,True,1,0,0,18285,194,48,7.2,False,11,False,0,0,0,17282,187,56,7.0,True,25.19205,1003,-1,1,242,243,-1
BR1_2725993806,10,True,0,1,0,19378,221,52,7.4,False,13,False,1,0,0,20230,220,47,7.4,True,29.143616666666667,-852,-3,-1,273,267,6
BR1_2700782487,11,True,0,0,0,18055,191,52,7.0,True,6,False,0,0,0,16641,213,56,7.0,False,26.049116666666666,1414,5,0,243,269,-26
BR1_2700633193,7,True,0,1,0,17982,229,57,7.0,True,4,False,0,0,0,16117,236,48,6.8,False,26.88925,1865,3,0,286,284,2
BR1_2731470973,14,False,1,1,0,20927,210,60,7.4,True,7,True,0,0,0,18658,216,56,7.0,False,28.674833333333332,2269,7,1,270,272,-2
BR1_2702987176,7,True,1,1,0,19736,240,76,7.8,True,3,False,0,0,0,17015,258,67,7.4,False,27.648766666666667,2721,4,1,316,325,-9
BR1_2701214878,9,False,1,1,0,19638,204,72,7.4,True,8,True,0,0,1,19868,235,56,7.4,False,28.01033333333333,-230,1,1,276,291,-15
BR1_2701163851,5,True,0,1,0,16322,195,72,6.6,False,10,False,1,0,0,17946,190,40,6.8,True,26.545383333333334,-1624,-5,-1,267,230,37
BR1_2731918505,7,False,1,1,0,17256,189,76,7.2,True,10,True,0,0,0,18271,185,72,7.0,False,27.971383333333332,-1015,-3,1,265,257,8
BR1_2731695404,8,True,1,1,0,17373,202,60,7.6,False,7,False,0,0,0,17540,220,68,7.8,True,28.007566666666666,-167,1,1,262,288,-26
BR1_2708495700,7,True,1,0,0,19079,244,72,7.6,False,6,False,0,0,0,18851,268,56,7.6,True,29.80755,228,1,1,316,324,-8
BR1_2708418238,6,True,0,0,0,18211,221,76,7.8,True,3,False,1,0,0,15916,210,56,7.2,False,29.302,2295,3,-1,297,266,31
BR1_2728897412,7,False,0,0,0,18238,220,47,7.0,False,11,True,1,0,0,20588,267,60,7.6,True,29.124216666666666,-2350,-4,-1,267,327,-60
BR1_2728873404,8,True,0,1,0,17700,201,56,6.8,False,9,False,0,0,0,18220,208,52,7.0,True,25.622633333333333,-520,-1,0,257,260,-3
BR1_2728855608,9,True,0,1,0,18113,227,52,7.2,True,5,False,0,0,0,15565,200,59,6.8,False,25.935433333333332,2548,4,0,279,259,20
BR1_2728838599,9,False,0,0,0,17706,213,50,6.8,True,7,True,1,1,1,18211,208,53,6.6,False,26.686833333333333,-505,2,-1,263,261,2
BR1_2731918373,9,True,0,1,1,20102,202,52,7.0,True,8,False,1,0,0,18283,225,52,7.0,False,28.046533333333333,1819,1,-1,254,277,-23
BR1_2731790079,9,False,0,0,0,18474,216,52,7.6,True,8,True,2,0,0,18239,232,64,7.2,False,27.660533333333333,235,1,-2,268,296,-28
BR1_2731650057,7,True,0,0,0,18034,258,44,7.6,True,2,False,0,0,0,16286,249,51,7.0,False,28.131733333333333,1748,5,0,302,300,2
BR1_2731012123,4,False,0,1,0,17429,246,76,7.2,False,9,True,1,0,0,19841,250,64,7.6,True,29.183283333333332,-2412,-5,-1,322,314,8
BR1_2730739103,8,False,0,0,0,16620,195,48,6.8,True,7,True,0,0,0,16039,182,44,6.4,False,25.193766666666665,581,1,0,243,226,17
BR1_2730711360,8,True,1,0,0,16411,209,48,7.2,True,2,False,0,0,0,14129,212,55,7.0,False,27.293266666666668,2282,6,1,257,267,-10
BR1_2730190790,3,False,0,0,0,15037,214,52,6.8,False,11,True,1,0,0,19074,217,56,7.2,True,25.006383333333332,-4037,-8,-1,266,273,-7
BR1_2730109935,8,True,0,0,0,16563,178,39,6.6,False,11,False,0,0,0,18499,220,52,6.8,True,25.479566666666667,-1936,-3,0,217,272,-55
BR1_2730089222,10,False,0,0,0,18192,210,64,6.8,True,9,True,0,0,0,17471,222,44,6.6,False,27.032366666666668,721,1,0,274,266,8
BR1_2731352376,15,False,1,0,0,20163,162,64,6.6,True,10,True,0,0,0,17338,192,52,6.6,False,25.864283333333333,2825,5,1,226,244,-18
BR1_2728093605,6,False,0,0,0,16710,221,62,7.2,False,11,True,0,1,1,20570,235,66,7.6,True,27.712666666666667,-3860,-5,0,283,301,-18
BR1_2724394642,10,False,0,0,0,16875,172,45,6.8,True,4,True,0,0,0,15430,206,55,6.6,False,25.549583333333334,1445,6,0,217,261,-44
BR1_2712682458,8,True,1,0,1,17562,180,79,7.0,False,9,False,0,1,0,20813,243,48,7.6,True,29.633266666666668,-3251,-1,1,259,291,-32
BR1_2681018573,2,False,0,1,0,16404,240,64,7.6,False,7,True,1,0,0,17436,243,44,7.4,True,29.804666666666666,-1032,-5,-1,304,287,17
BR1_2680807511,9,False,0,1,0,17828,234,56,7.4,True,4,True,1,0,0,14902,186,68,7.0,False,26.960716666666666,2926,5,-1,290,254,36
BR1_2731445150,6,False,0,0,0,18123,256,52,7.2,True,6,True,1,0,0,18144,241,52,7.0,False,28.416683333333335,-21,0,-1,308,293,15
BR1_2693127548,11,False,1,0,0,19919,210,68,7.2,True,7,True,0,1,0,15733,176,52,6.6,False,26.579183333333333,4186,4,1,278,228,50
BR1_2691499491,4,False,0,0,0,15740,211,60,7.0,True,7,True,0,0,0,15986,193,52,6.6,False,26.252216666666666,-246,-3,0,271,245,26
BR1_2731852380,4,False,0,0,0,14064,167,40,6.4,False,12,True,0,1,0,19606,209,56,7.0,True,25.021866666666668,-5542,-8,0,207,265,-58
BR1_2722790642,3,False,0,0,0,15170,206,64,6.8,True,10,True,1,0,0,18204,207,56,7.2,False,26.5531,-3034,-7,-1,270,263,7
BR1_2731369163,11,True,0,0,0,19842,224,48,7.6,True,6,False,1,0,0,16642,196,52,6.8,False,28.982216666666666,3200,5,-1,272,248,24
BR1_2731361298,10,True,0,1,0,19163,235,55,7.4,True,11,False,1,0,0,19006,197,64,7.2,False,27.5088,157,-1,-1,290,261,29
BR1_2721295601,5,True,0,1,0,16075,189,56,6.4,False,6,False,1,0,0,15776,185,40,6.8,True,27.409666666666666,299,-1,-1,245,225,20
BR1_2731873681,6,False,0,0,0,17910,235,46,7.4,False,13,True,1,0,0,19899,205,53,7.2,True,28.875583333333335,-1989,-7,-1,281,258,23
BR1_2730978607,7,False,0,0,0,16594,170,40,6.4,False,10,True,0,0,0,19711,232,76,7.2,True,26.723433333333332,-3117,-3,0,210,308,-98
BR1_2730967683,7,False,1,1,0,17936,202,60,7.4,False,12,True,0,0,0,21182,222,55,7.8,True,29.92135,-3246,-5,1,262,277,-15
BR1_2730956479,11,True,0,0,0,18562,194,50,7.2,True,11,False,0,0,0,19621,226,56,7.4,False,27.680533333333333,-1059,0,0,244,282,-38
BR1_2731775591,9,True,1,0,0,17205,186,52,6.8,True,4,False,0,0,0,15917,215,60,6.8,False,26.098133333333333,1288,5,1,238,275,-37
BR1_2730631382,11,True,1,0,0,20680,242,62,7.8,True,3,False,0,1,0,15877,207,64,7.2,False,29.88405,4803,8,1,304,271,33
BR1_2730175139,9,False,0,0,0,16422,192,48,6.8,False,7,True,1,1,0,16614,168,48,6.4,True,26.154983333333334,-192,2,-1,240,216,24
BR1_2730518772,10,True,1,0,0,19607,237,60,7.4,True,7,False,0,0,0,18300,235,51,7.4,False,28.542366666666666,1307,3,1,297,286,11
BR1_2729035016,10,False,0,0,0,16027,181,36,6.6,False,10,True,0,0,0,17945,207,36,6.8,True,26.784233333333333,-1918,0,0,217,243,-26
BR1_2731790697,14,True,1,0,0,21677,234,51,7.6,True,6,False,0,0,0,15699,190,48,6.8,False,28.661266666666666,5978,8,1,285,238,47
BR1_2731456529,7,True,1,1,0,18209,204,60,7.0,True,14,False,0,0,0,20716,199,57,7.2,False,29.454883333333335,-2507,-7,1,264,256,8
BR1_2731078940,5,False,0,0,0,16278,245,64,7.4,True,4,True,1,0,0,15809,243,56,7.2,False,26.413316666666667,469,1,-1,309,299,10
BR1_2716467004,7,True,0,1,0,16602,177,64,7.0,True,3,False,1,0,0,14772,176,52,6.6,False,25.257316666666668,1830,4,-1,241,228,13
BR1_2731871891,7,True,0,0,0,16222,200,52,6.6,False,5,False,0,0,0,16189,206,62,7.2,True,26.480183333333333,33,2,0,252,268,-16
BR1_2731867588,6,False,1,0,0,16641,215,62,6.8,False,8,True,0,0,0,16975,201,52,7.0,True,25.06365,-334,-2,1,277,253,24
BR1_2731858455,7,True,1,0,0,17263,209,47,7.0,True,5,False,0,1,0,16069,209,52,6.8,False,26.934983333333335,1194,2,1,256,261,-5
BR1_2731841488,10,True,0,0,0,19642,222,60,6.8,True,8,False,1,1,0,16465,175,51,6.4,False,26.145433333333333,3177,2,-1,282,226,56
BR1_2730547041,10,True,0,0,0,19133,218,52,7.2,False,10,False,0,0,0,20110,220,51,7.4,True,27.931933333333333,-977,0,0,270,271,-1
BR1_2707499181,11,False,1,0,0,19742,231,44,7.2,True,9,True,0,1,0,20192,239,52,7.2,False,27.8491,-450,2,1,275,291,-16
BR1_2715913987,7,False,1,0,0,18982,255,52,7.8,True,3,True,0,0,0,15659,221,63,7.0,False,28.19825,3323,4,1,307,284,23
BR1_2731908879,7,False,0,1,0,19281,236,67,7.6,False,11,True,1,0,0,22703,277,64,7.6,True,27.883466666666667,-3422,-4,-1,303,341,-38
BR1_2725793707,6,False,1,1,0,17143,219,64,7.2,True,4,True,0,0,0,15460,218,72,7.0,False,26.619466666666668,1683,2,1,283,290,-7
BR1_2725372058,7,True,1,1,0,19314,254,62,7.4,True,3,False,0,0,0,15769,252,57,7.2,False,29.01675,3545,4,1,316,309,7
BR1_2730232395,12,False,0,0,0,20965,259,56,7.4,False,11,True,0,0,0,20772,237,64,7.6,True,29.132233333333332,193,1,0,315,301,14
BR1_2725819549,4,False,0,1,0,16628,210,48,6.8,False,8,True,1,0,0,19705,264,56,7.6,True,29.1368,-3077,-4,-1,258,320,-62
BR1_2721133923,7,False,0,0,0,16671,182,53,6.6,False,9,True,1,0,0,16596,197,44,6.6,True,26.5983,75,-2,-1,235,241,-6
BR1_2729030564,5,True,0,0,0,15352,214,47,6.6,True,9,False,1,0,0,17468,181,63,7.0,False,26.679816666666667,-2116,-4,-1,261,244,17
BR1_2731741675,5,True,0,0,0,15052,211,44,6.6,False,15,False,0,0,0,19200,195,56,7.0,True,26.010666666666665,-4148,-10,0,255,251,4
BR1_2730104387,12,True,1,0,0,19535,206,65,7.2,True,4,False,0,0,0,15192,195,46,6.4,False,26.896216666666668,4343,8,1,271,241,30
BR1_2731772391,7,False,0,1,0,17661,223,52,7.2,True,2,True,1,0,0,14890,225,68,6.8,False,27.1646,2771,5,-1,275,293,-18
BR1_2731697067,12,False,1,0,0,19987,222,56,7.4,False,9,True,0,0,0,18183,165,67,7.0,True,28.034516666666665,1804,3,1,278,232,46
BR1_2730121219,18,True,1,0,0,22748,241,59,7.4,True,7,False,0,1,0,19645,223,48,6.8,False,29.058933333333332,3103,11,1,300,271,29
BR1_2729565433,6,True,0,0,0,16504,215,40,7.0,False,10,False,1,0,0,19101,249,59,7.6,True,28.128433333333334,-2597,-4,-1,255,308,-53
BR1_2731804811,9,False,1,0,0,17752,202,64,6.6,True,11,True,0,0,0,18674,184,44,6.6,False,26.087416666666666,-922,-2,1,266,228,38
BR1_2731719817,11,True,0,0,0,19561,211,58,7.2,False,11,False,0,1,0,19411,187,48,7.4,True,28.570916666666665,150,0,0,269,235,34
BR1_2731878968,10,True,0,0,1,21093,218,48,7.2,False,11,False,0,0,0,18461,218,60,7.2,True,27.952366666666666,2632,-1,0,266,278,-12
BR1_2731746140,11,True,1,0,0,18984,228,55,7.0,True,6,False,0,0,0,17282,211,56,7.4,False,27.696266666666666,1702,5,1,283,267,16
BR1_2729152145,5,False,0,0,0,15152,186,36,6.8,False,9,True,1,1,0,18397,189,71,6.8,True,26.957616666666667,-3245,-4,-1,222,260,-38
BR1_2731238477,1,False,0,0,0,15283,247,64,7.0,False,5,True,1,0,0,16048,238,48,7.0,True,25.578283333333335,-765,-4,-1,311,286,25
BR1_2731276186,9,False,1,0,0,17343,176,64,6.6,True,6,True,0,1,0,15981,185,47,6.8,False,27.28045,1362,3,1,240,232,8
BR1_2724481628,8,False,0,0,0,16430,195,44,6.6,False,10,True,1,0,0,18491,250,68,7.2,True,25.126433333333335,-2061,-2,-1,239,318,-79
BR1_2730580933,1,True,0,1,0,15805,241,68,6.8,False,4,False,0,0,0,16139,256,44,7.2,True,27.714916666666667,-334,-3,0,309,300,9
BR1_2730521574,12,False,0,1,0,21753,270,53,7.6,True,4,True,1,0,0,15661,209,58,7.2,False,28.815466666666666,6092,8,-1,323,267,56
BR1_2727950939,7,True,1,1,0,18225,207,68,7.2,False,8,False,0,0,0,18963,248,60,7.2,True,28.509816666666666,-738,-1,1,275,308,-33
BR1_2728533217,12,False,1,0,0,19228,183,64,7.2,False,9,True,0,0,0,19863,251,52,7.4,True,29.22495,-635,3,1,247,303,-56
BR1_2728505384,11,False,1,0,0,18309,201,44,6.8,True,4,True,0,0,0,15544,195,60,6.6,False,26.624616666666668,2765,7,1,245,255,-10
BR1_2728457177,12,True,0,0,0,20559,252,60,7.2,True,6,False,1,0,0,17951,231,56,7.6,False,29.5263,2608,6,-1,312,287,25
BR1_2729526539,9,False,0,1,0,18020,200,64,7.0,False,9,True,1,0,0,16858,165,60,6.4,True,26.707583333333332,1162,0,-1,264,225,39
BR1_2731706452,8,False,1,1,1,21013,229,72,7.4,False,3,True,0,0,0,16293,203,72,7.0,True,28.971416666666666,4720,5,1,301,275,26
BR1_2731679659,5,False,0,1,0,15256,194,43,6.6,False,10,True,1,0,0,18269,226,56,7.0,True,26.929283333333334,-3013,-5,-1,237,282,-45
BR1_2722067437,9,True,0,1,0,20286,237,76,7.4,True,11,False,1,0,0,19032,244,51,7.4,False,28.8799,1254,-2,-1,313,295,18
BR1_2722028561,4,False,0,0,0,17228,250,76,7.2,False,11,True,1,0,0,20515,272,43,7.6,True,28.194466666666667,-3287,-7,-1,326,315,11
BR1_2726017618,10,False,0,1,0,18914,211,56,7.6,True,5,True,1,0,0,18079,209,56,7.2,False,29.0716,835,5,-1,267,265,2
BR1_2725781105,5,True,1,0,0,16709,260,54,6.8,True,4,False,0,0,0,15921,224,44,6.8,False,27.163616666666666,788,1,1,314,268,46
BR1_2731846034,8,False,1,0,0,17161,172,64,6.6,True,10,True,0,0,0,17869,183,47,6.6,False,25.03895,-708,-2,1,236,230,6
BR1_2731709207,12,True,1,0,0,20620,255,42,7.2,True,9,False,0,0,0,17841,201,59,7.0,False,28.994183333333332,2779,3,1,297,260,37
BR1_2730069272,8,False,0,0,0,17532,208,52,7.0,True,6,True,1,0,0,16326,194,64,7.0,False,26.8124,1206,2,-1,260,258,2
BR1_2731347843,1,False,0,0,0,14185,218,48,6.6,False,8,True,0,0,0,17946,230,48,7.0,True,26.915583333333334,-3761,-7,0,266,278,-12
BR1_2731027804,5,False,1,0,0,15480,199,60,6.8,False,5,True,0,0,0,16309,231,55,7.0,True,26.355516666666666,-829,0,1,259,286,-27
BR1_2730039077,8,False,0,0,0,18334,208,56,7.2,False,10,True,1,1,0,18360,225,52,7.4,True,25.147916666666667,-26,-2,-1,264,277,-13
BR1_2731169065,4,False,1,0,0,16992,226,72,7.4,True,5,True,0,1,0,18257,249,64,7.6,False,28.886566666666667,-1265,-1,1,298,313,-15
BR1_2726139564,6,False,1,0,1,19330,203,64,7.2,False,14,True,0,0,0,21423,243,52,7.4,True,28.1397,-2093,-8,1,267,295,-28
BR1_2726084564,8,True,1,0,0,19339,219,62,7.4,True,9,False,0,0,0,18982,229,52,7.2,False,29.177516666666666,357,-1,1,281,281,0
BR1_2725553371,6,True,0,0,0,19032,281,63,7.4,True,6,False,1,1,0,17786,237,60,7.4,False,28.038916666666665,1246,0,-1,344,297,47
BR1_2708547740,7,True,1,0,0,17073,212,52,7.0,True,7,False,0,0,0,16203,213,44,6.6,False,27.01405,870,0,1,264,257,7
BR1_2731382444,12,True,1,0,0,21463,274,63,7.6,True,9,False,0,1,0,18761,212,59,7.4,False,28.817633333333333,2702,3,1,337,271,66
BR1_2731375563,11,False,1,0,0,18731,205,50,6.8,True,7,True,0,0,0,15425,160,61,6.4,False,26.9516,3306,4,1,255,221,34
BR1_2731375047,11,True,0,0,0,18777,213,56,7.0,True,7,False,0,0,0,17107,216,60,7.0,False,26.861883333333335,1670,4,0,269,276,-7
BR1_2731364081,13,True,1,0,0,18865,187,50,6.4,False,15,False,0,0,0,19472,188,61,7.2,True,26.02395,-607,-2,1,237,249,-12
BR1_2731774154,11,True,0,0,0,19517,226,48,7.4,False,14,False,1,1,0,22114,225,56,7.4,True,28.922483333333332,-2597,-3,-1,274,281,-7
BR1_2731830096,4,False,0,0,0,17105,274,64,7.6,False,3,True,1,0,0,16388,246,56,7.4,True,29.5061,717,1,-1,338,302,36
BR1_2731731017,7,True,0,0,0,17713,194,52,7.0,False,11,False,0,0,0,20720,269,60,7.6,True,28.7344,-3007,-4,0,246,329,-83
BR1_2720695471,15,True,1,0,0,21312,206,60,7.6,True,7,False,0,1,0,19409,256,64,7.4,False,27.58795,1903,8,1,266,320,-54
BR1_2729835203,10,True,1,1,0,18180,180,56,6.8,False,10,False,0,0,0,17421,178,51,6.8,True,27.490066666666667,759,0,1,236,229,7
BR1_2701571579,5,False,0,0,0,17110,237,65,7.6,True,4,True,1,0,0,15714,208,66,7.2,False,29.511066666666668,1396,1,-1,302,274,28
BR1_2731643255,4,True,0,0,0,16847,215,68,7.0,False,14,False,1,1,0,20950,235,64,7.4,True,29.234533333333335,-4103,-10,-1,283,299,-16
BR1_2731767420,10,False,0,0,0,20545,242,56,7.6,True,5,True,1,1,0,17630,252,52,7.0,False,29.913783333333335,2915,5,-1,298,304,-6
BR1_2731240410,8,False,0,0,0,17009,204,52,6.4,True,8,True,1,0,0,16777,199,32,6.6,False,25.02775,232,0,-1,256,231,25
BR1_2731702433,4,False,1,1,0,15275,195,64,6.6,True,6,True,0,0,0,16840,207,56,7.0,False,27.0727,-1565,-2,1,259,263,-4
BR1_2712796746,4,False,0,0,0,15707,212,60,7.0,False,6,True,1,0,0,17421,237,56,7.0,True,25.602033333333335,-1714,-2,-1,272,293,-21
BR1_2712439680,12,True,0,0,0,19675,213,52,7.0,True,8,False,0,0,0,16188,154,52,6.6,False,27.434166666666666,3487,4,0,265,206,59
BR1_2722494914,1,False,0,0,0,13956,213,64,7.0,False,3,True,1,0,0,14660,221,48,6.8,True,27.288533333333334,-704,-2,-1,277,269,8
BR1_2722269557,12,True,0,1,0,19812,198,76,7.2,True,11,False,1,0,0,18713,171,56,7.0,False,28.508866666666666,1099,1,-1,274,227,47
BR1_2696609926,14,True,1,1,0,21581,237,62,7.0,True,3,False,0,0,0,13942,170,57,6.6,False,25.4499,7639,11,1,299,227,72
BR1_2731244835,6,False,0,0,0,18074,238,60,7.2,False,12,True,1,1,0,20947,222,64,7.6,True,29.6929,-2873,-6,-1,298,286,12
BR1_2729640721,10,True,0,0,0,19198,232,44,7.6,True,6,False,0,0,0,18041,223,64,7.2,False,28.847183333333334,1157,4,0,276,287,-11
BR1_2724152872,7,True,0,1,0,18111,230,52,7.2,False,3,False,0,0,0,16364,223,56,7.4,True,29.160916666666665,1747,4,0,282,279,3
BR1_2724619475,9,False,0,1,0,18560,212,56,7.4,True,8,True,0,0,0,18876,239,48,7.6,False,29.81745,-316,1,0,268,287,-19
BR1_2706965363,6,False,0,0,0,16943,199,52,6.8,False,18,True,1,0,0,23517,266,50,7.6,True,29.202766666666665,-6574,-12,-1,251,316,-65
BR1_2722293233,7,True,1,0,0,19698,254,54,7.4,True,1,False,0,0,0,15706,256,77,7.4,False,28.10643333333333,3992,6,1,308,333,-25
BR1_2731922328,7,False,0,0,0,17750,202,64,7.4,True,8,True,1,1,0,18932,244,64,7.2,False,28.965416666666666,-1182,-1,-1,266,308,-42
BR1_2731816556,8,True,1,0,0,17797,182,64,7.2,False,10,False,0,0,0,19798,207,52,7.2,True,27.76953333333333,-2001,-2,1,246,259,-13
BR1_2731809823,5,False,0,0,0,15619,198,59,7.2,False,4,True,1,0,0,16395,244,68,7.0,True,25.648716666666665,-776,1,-1,257,312,-55
BR1_2731242819,6,True,1,0,0,15364,186,48,6.4,False,9,False,0,0,0,19190,218,56,7.2,True,26.145433333333333,-3826,-3,1,234,274,-40
BR1_2731852144,6,False,0,0,0,17372,223,48,7.0,False,9,True,1,1,0,19267,259,60,7.6,True,29.913133333333334,-1895,-3,-1,271,319,-48
BR1_2731862522,9,False,1,0,0,18121,205,52,7.2,True,4,True,0,1,0,16267,206,68,7.0,False,29.07395,1854,5,1,257,274,-17
BR1_2731831588,9,False,0,1,0,20681,251,80,7.8,True,6,True,1,0,0,17302,205,42,7.2,False,28.282666666666668,3379,3,-1,331,247,84
BR1_2731064716,6,False,0,0,0,17690,247,52,7.4,True,10,True,0,1,0,19326,235,60,7.2,False,28.949483333333333,-1636,-4,0,299,295,4
BR1_2731864157,6,True,1,0,0,16697,193,52,6.4,True,7,False,0,0,0,15096,141,48,6.2,False,27.46085,1601,-1,1,245,189,56
BR1_2731849459,9,False,1,0,0,19392,242,48,7.4,False,7,True,0,0,0,17107,171,60,7.4,True,29.310933333333335,2285,2,1,290,231,59
BR1_2731903458,7,False,1,0,0,16505,203,48,6.4,True,7,True,0,0,0,17363,228,56,6.8,False,25.286016666666665,-858,0,1,251,284,-33
BR1_2731713944,10,False,1,0,0,19236,260,60,7.8,True,7,True,0,1,0,18048,190,64,7.0,False,29.889833333333332,1188,3,1,320,254,66
BR1_2731259676,4,False,0,0,0,17176,239,72,7.6,False,5,True,1,1,0,17462,246,52,7.4,True,29.92645,-286,-1,-1,311,298,13
BR1_2731632894,10,False,1,1,0,19771,242,60,7.4,True,9,True,0,0,0,19127,234,64,7.0,False,28.17605,644,1,1,302,298,4
BR1_2731583801,6,True,1,0,0,17768,248,60,7.2,False,6,False,0,0,0,18256,257,72,7.6,True,29.497133333333334,-488,0,1,308,329,-21
BR1_2729164513,10,True,1,0,0,17770,220,44,6.8,True,7,False,0,1,1,17483,176,60,6.8,False,25.14068333333333,287,3,1,264,236,28
BR1_2729137434,6,False,0,1,0,17230,223,68,6.8,False,11,True,1,0,0,18196,190,48,6.8,True,26.890116666666668,-966,-5,-1,291,238,53
BR1_2723201630,9,False,1,0,0,19821,255,68,7.6,True,6,True,0,0,0,17416,224,48,7.2,False,28.748566666666665,2405,3,1,323,272,51
BR1_2714997813,6,True,1,1,0,17397,215,68,7.2,True,4,False,0,0,0,15216,208,47,6.6,False,25.902916666666666,2181,2,1,283,255,28
BR1_2714978858,7,False,0,0,0,18036,220,58,7.2,False,11,True,1,0,0,20118,241,66,8.0,True,29.40445,-2082,-4,-1,278,307,-29
BR1_2727411163,12,False,0,1,0,21115,196,56,7.2,False,9,True,0,0,0,18678,207,64,7.2,True,27.968033333333334,2437,3,0,252,271,-19
BR1_2718808440,7,False,0,0,0,16412,191,35,6.4,False,17,True,1,0,0,20934,236,48,7.2,True,26.104383333333335,-4522,-10,-1,226,284,-58
BR1_2731750339,3,True,0,1,0,16563,236,44,7.6,False,10,False,0,0,0,19596,221,80,7.8,True,29.474683333333335,-3033,-7,0,280,301,-21
BR1_2730785186,9,False,1,1,0,20422,268,68,7.6,True,6,True,0,0,0,17593,187,72,7.4,False,28.231733333333334,2829,3,1,336,259,77
BR1_2731876084,11,True,1,1,0,20093,240,72,7.4,True,7,False,0,0,0,18184,221,48,7.2,False,27.518733333333333,1909,4,1,312,269,43
BR1_2731852364,8,False,0,0,0,17217,187,52,7.2,False,10,True,1,0,0,18182,220,54,7.0,True,28.002816666666668,-965,-2,-1,239,274,-35
BR1_2731302037,2,False,0,1,0,15742,217,60,7.4,True,5,True,1,0,0,17903,248,58,7.4,False,29.477116666666667,-2161,-3,-1,277,306,-29
BR1_2731252728,5,False,0,0,0,16313,228,47,7.0,False,5,True,1,0,0,16574,189,80,7.0,True,28.584466666666668,-261,0,-1,275,269,6
BR1_2730840256,3,True,0,0,0,14980,196,48,7.0,False,4,False,1,0,0,15178,195,56,6.8,True,26.9307,-198,-1,-1,244,251,-7
BR1_2731845306,14,False,1,0,0,20439,199,58,7.2,True,7,True,0,0,0,16008,180,33,6.6,False,27.043833333333332,4431,7,1,257,213,44
BR1_2731855242,8,True,1,0,0,18171,197,48,7.0,False,6,False,0,1,0,17632,231,71,6.8,True,25.021833333333333,539,2,1,245,302,-57
BR1_2731578861,4,False,1,0,0,15824,197,44,6.8,False,9,True,0,0,0,20234,238,72,7.4,True,29.857316666666666,-4410,-5,1,241,310,-69
BR1_2731564294,8,True,1,0,0,18120,190,60,7.0,False,10,False,0,0,0,18697,220,60,7.2,True,29.666883333333335,-577,-2,1,250,280,-30
BR1_2727886034,6,True,1,0,0,15274,196,43,6.4,False,8,False,0,0,0,15972,229,53,7.0,True,26.1713,-698,-2,1,239,282,-43
BR1_2731179334,10,True,0,0,0,19340,203,56,7.6,False,13,False,1,0,0,20379,230,62,7.6,True,27.875033333333334,-1039,-3,-1,259,292,-33
BR1_2731144783,11,False,0,1,0,21099,253,68,7.8,False,11,True,1,0,0,20262,245,56,7.6,True,29.677833333333332,837,0,-1,321,301,20
BR1_2731187352,9,False,0,1,0,18376,208,56,7.0,False,9,True,0,0,0,19578,242,68,7.4,True,29.605266666666665,-1202,0,0,264,310,-46
BR1_2731850762,6,False,1,0,0,16247,196,48,6.8,False,6,True,0,0,0,15934,167,52,6.6,True,25.762066666666666,313,0,1,244,219,25
BR1_2731721595,18,True,0,0,0,21602,218,40,6.8,False,12,False,1,0,0,21092,214,51,7.0,True,27.822816666666668,510,6,-1,258,265,-7
BR1_2731663933,6,False,0,0,0,17503,242,56,7.0,False,7,True,0,0,0,19358,257,71,7.4,True,29.123183333333333,-1855,-1,0,298,328,-30
BR1_2704511432,8,True,1,1,0,17521,193,56,6.6,True,7,False,0,0,0,16854,214,56,6.8,False,26.582516666666667,667,1,1,249,270,-21
BR1_2731446145,12,True,0,1,0,20321,198,60,7.2,True,7,False,0,0,0,18399,206,44,7.0,False,29.66048333333333,1922,5,0,258,250,8
BR1_2730852912,5,False,1,0,0,16720,204,56,7.2,True,7,True,0,0,0,14416,154,40,6.6,False,27.357516666666665,2304,-2,1,260,194,66
BR1_2730046344,5,True,0,1,0,18071,252,56,7.6,True,5,False,1,0,0,16831,245,56,7.6,False,28.390966666666667,1240,0,-1,308,301,7
BR1_2731206263,4,False,0,0,0,14852,149,48,6.4,False,10,True,1,0,0,17779,221,43,7.0,True,25.250166666666665,-2927,-6,-1,197,264,-67
BR1_2730824521,15,True,1,0,0,22065,219,78,7.6,True,10,False,0,0,0,19797,226,56,7.4,False,28.080283333333334,2268,5,1,297,282,15
BR1_2730805241,16,False,1,0,0,22499,245,56,7.2,True,13,True,0,1,0,21036,193,54,7.0,False,27.656616666666668,1463,3,1,301,247,54
BR1_2729172150,7,False,0,1,0,18778,232,76,7.6,False,7,True,1,0,0,18001,249,56,7.2,True,27.9751,777,0,-1,308,305,3
BR1_2729908347,11,True,0,0,0,18135,203,73,7.0,True,2,False,0,0,0,13470,189,36,6.4,False,27.347266666666666,4665,9,0,276,225,51
BR1_2731151909,14,True,1,0,0,21151,257,80,7.8,True,6,False,0,1,0,18280,224,64,7.2,False,28.627483333333334,2871,8,1,337,288,49
BR1_2716112827,9,False,0,0,0,16845,202,36,6.8,True,3,True,0,0,0,14713,212,56,6.4,False,25.0122,2132,6,0,238,268,-30
BR1_2723865317,10,False,0,0,0,19012,238,42,7.6,False,13,True,1,1,0,21784,240,84,7.6,True,29.839716666666668,-2772,-3,-1,280,324,-44
BR1_2730788622,8,False,1,0,0,16690,196,44,6.8,True,8,True,0,0,0,17528,176,52,6.8,False,26.895183333333332,-838,0,1,240,228,12
BR1_2720929785,8,False,0,0,0,16993,218,48,6.6,False,9,True,1,0,0,17382,207,56,6.8,True,25.947783333333334,-389,-1,-1,266,263,3
BR1_2729948752,16,True,0,0,0,21195,216,35,7.4,True,5,False,0,0,0,18327,212,76,7.2,False,28.37185,2868,11,0,251,288,-37
BR1_2718763267,3,False,1,1,0,15925,207,68,7.4,False,9,True,0,0,0,19284,249,60,7.4,True,28.554766666666666,-3359,-6,1,275,309,-34
BR1_2718583971,10,False,0,0,0,17445,219,60,7.4,True,8,True,1,0,0,16612,205,56,6.8,False,27.289066666666667,833,2,-1,279,261,18
BR1_2718568111,10,False,0,0,0,18842,219,52,7.2,False,12,True,1,0,0,21450,280,56,7.8,True,27.874683333333333,-2608,-2,-1,271,336,-65
BR1_2731584178,11,True,0,1,0,19136,192,40,6.8,False,6,False,0,0,0,16184,194,48,6.8,True,27.701383333333332,2952,5,0,232,242,-10
BR1_2730893097,6,True,0,0,0,16613,216,52,7.0,True,3,False,0,0,0,15684,214,59,6.8,False,27.175966666666667,929,3,0,268,273,-5
BR1_2730886533,12,False,0,0,0,19086,212,72,7.0,True,7,True,1,0,0,16496,175,71,7.0,False,26.707433333333334,2590,5,-1,284,246,38
BR1_2730881658,1,False,1,0,0,14716,242,59,6.8,False,2,True,0,1,0,14966,224,52,7.2,True,27.142783333333334,-250,-1,1,301,276,25
BR1_2726950384,9,True,1,0,0,18312,221,44,7.6,True,8,False,0,0,0,18616,213,64,7.2,False,27.936016666666667,-304,1,1,265,277,-12
BR1_2726923714,3,False,0,0,0,14955,206,44,7.0,True,6,True,0,0,0,15884,204,40,6.8,False,25.005033333333333,-929,-3,0,250,244,6
BR1_2728352376,8,False,1,0,0,18123,220,52,7.2,True,6,True,0,1,0,18001,231,52,7.2,False,28.670766666666665,122,2,1,272,283,-11
BR1_2724201304,7,False,0,0,0,19003,244,56,7.2,False,10,True,1,1,0,19844,241,64,7.6,True,28.519883333333333,-841,-3,-1,300,305,-5
BR1_2723644440,10,False,0,0,0,19821,233,56,7.4,True,11,True,1,0,0,20581,226,56,7.6,False,29.004633333333334,-760,-1,-1,289,282,7
BR1_2731705392,2,False,0,0,0,13303,170,44,6.4,False,7,True,1,0,0,17202,227,60,6.8,True,26.360883333333334,-3899,-5,-1,214,287,-73
BR1_2731648010,9,True,1,0,0,16720,195,47,7.2,True,4,False,0,1,0,14986,162,52,6.8,False,25.569733333333332,1734,5,1,242,214,28
BR1_2728561001,7,False,0,1,0,17799,247,56,7.0,False,8,True,0,0,0,18518,261,64,7.4,True,29.359966666666665,-719,-1,0,303,325,-22
BR1_2723682020,5,True,1,0,0,15558,215,44,6.8,False,2,False,0,1,0,13893,186,44,6.4,True,26.893166666666666,1665,3,1,259,230,29
BR1_2722221705,7,False,0,1,0,18013,219,68,7.0,False,9,True,1,0,0,17792,187,63,7.0,True,27.42885,221,-2,-1,287,250,37
BR1_2722197969,8,True,0,0,0,19419,253,68,7.8,True,1,False,0,1,0,15221,220,67,7.4,False,29.500566666666668,4198,7,0,321,287,34
BR1_2721507449,3,True,0,0,0,15556,204,44,6.8,True,4,False,1,1,0,17851,256,80,7.6,False,29.395816666666665,-2295,-1,-1,248,336,-88
BR1_2727499322,13,False,0,1,0,18164,169,44,7.0,True,8,True,1,0,0,16664,200,44,6.4,False,26.7243,1500,5,-1,213,244,-31
BR1_2720164477,5,False,0,0,0,15525,194,44,6.2,False,8,True,1,0,0,16964,194,48,6.6,True,27.432266666666667,-1439,-3,-1,238,242,-4
BR1_2729975208,4,False,0,0,0,14954,198,59,6.8,False,7,True,1,0,0,17135,195,52,7.2,True,25.10325,-2181,-3,-1,257,247,10
BR1_2702803834,11,False,1,0,0,19427,227,64,7.4,True,6,True,0,1,0,18099,212,56,7.2,False,29.226183333333335,1328,5,1,291,268,23
BR1_2702765960,1,False,0,0,0,15684,221,60,7.2,False,8,True,0,0,0,19649,278,64,7.8,True,29.473483333333334,-3965,-7,0,281,342,-61
BR1_2731650570,8,True,1,0,0,18019,239,36,7.0,False,4,False,0,0,0,16604,213,68,7.2,True,29.216683333333332,1415,4,1,275,281,-6
BR1_2731695127,8,False,1,0,0,17820,207,52,7.0,False,10,True,0,1,1,20969,244,56,7.2,True,29.323366666666665,-3149,-2,1,259,300,-41
BR1_2731714933,8,True,0,0,0,16013,197,44,6.8,False,11,False,0,1,0,18305,221,56,7.0,True,26.37555,-2292,-3,0,241,277,-36
BR1_2730281450,10,True,0,1,0,20530,269,40,7.6,True,7,False,1,0,0,19276,250,59,7.6,False,29.052616666666665,1254,3,-1,309,309,0
BR1_2730227036,11,False,0,0,0,19034,243,40,6.8,True,8,True,0,0,0,17273,189,48,6.8,False,26.047733333333333,1761,3,0,283,237,46
BR1_2730187372,7,True,0,1,0,17577,199,40,7.2,False,10,False,0,0,0,19934,258,59,7.6,True,29.674783333333334,-2357,-3,0,239,317,-78
BR1_2730882292,10,True,0,0,0,17150,203,44,6.8,False,10,False,1,0,0,17430,205,56,7.2,True,26.143483333333332,-280,0,-1,247,261,-14
BR1_2730449851,13,False,1,0,0,19616,221,56,7.0,True,8,True,0,0,0,17164,220,44,6.4,False,26.670416666666668,2452,5,1,277,264,13
BR1_2731166264,19,False,0,0,0,22397,186,40,7.2,False,17,True,0,0,0,21729,196,56,7.0,True,27.745283333333333,668,2,0,226,252,-26
BR1_2729435433,4,True,0,0,0,17054,255,40,7.0,True,4,False,0,1,0,16531,210,48,7.0,False,29.06355,523,0,0,295,258,37
BR1_2729400243,13,True,1,0,2,22450,240,60,7.4,True,7,False,0,1,0,18059,212,52,7.0,False,29.1163,4391,6,1,300,264,36
BR1_2731903615,10,False,0,1,0,19276,205,56,7.0,False,8,True,1,0,0,19689,227,68,7.6,True,28.61905,-413,2,-1,261,295,-34
BR1_2731433148,7,True,0,0,0,17246,238,44,7.0,False,8,False,1,1,0,18368,256,60,7.4,True,28.429333333333332,-1122,-1,-1,282,316,-34
BR1_2731687091,10,True,1,0,0,20048,252,52,7.4,True,11,False,0,1,0,20500,249,59,7.6,False,28.874116666666666,-452,-1,1,304,308,-4
BR1_2718964060,6,True,1,0,0,17874,227,68,6.8,True,11,False,0,1,0,19685,208,64,7.4,False,29.22821666666667,-1811,-5,1,295,272,23
BR1_2731182290,8,False,0,0,0,15978,169,46,6.4,False,10,True,1,0,0,17552,193,50,7.0,True,25.717,-1574,-2,-1,215,243,-28
BR1_2729300554,7,True,0,0,0,17983,214,44,6.8,True,15,False,1,0,0,21567,226,72,7.6,False,29.938883333333333,-3584,-8,-1,258,298,-40
BR1_2729281820,13,True,1,1,0,21430,210,52,7.2,False,8,False,0,0,0,18557,179,64,6.8,True,27.66265,2873,5,1,262,243,19
BR1_2731585535,5,False,0,0,0,15182,185,56,6.8,False,10,True,1,0,0,18825,202,67,7.2,True,26.67595,-3643,-5,-1,241,269,-28
BR1_2730942457,8,False,1,0,0,17515,216,56,7.0,True,6,True,0,0,0,16436,202,60,7.0,False,25.103733333333334,1079,2,1,272,262,10
BR1_2730435786,15,True,1,0,0,21468,237,56,7.6,False,6,False,0,1,0,17907,245,44,7.2,True,28.9197,3561,9,1,293,289,4
BR1_2727141041,14,True,1,1,0,21183,217,48,6.8,True,10,False,0,0,0,17566,196,48,6.4,False,26.221466666666668,3617,4,1,265,244,21
BR1_2725996335,4,False,0,0,0,16684,249,64,7.4,False,7,True,1,0,0,18650,217,70,7.8,True,27.601633333333332,-1966,-3,-1,313,287,26
BR1_2723858181,11,False,0,1,0,20382,243,56,7.4,True,8,True,0,0,0,17495,182,63,7.2,False,29.456033333333334,2887,3,0,299,245,54
BR1_2731336900,6,True,1,0,0,14880,195,44,7.0,False,6,False,0,0,0,16191,211,64,7.0,True,26.625383333333332,-1311,0,1,239,275,-36
BR1_2731323369,7,False,0,0,0,17494,224,56,7.0,False,12,True,1,1,0,19844,241,56,7.4,True,28.420916666666667,-2350,-5,-1,280,297,-17
BR1_2691390569,7,False,0,0,0,16343,186,56,6.4,False,10,True,1,1,0,18224,210,60,7.2,True,27.286216666666668,-1881,-3,-1,242,270,-28
BR1_2687773881,5,False,0,1,0,15254,197,48,7.0,False,7,True,1,0,0,16790,234,56,7.4,True,25.705883333333333,-1536,-2,-1,245,290,-45
BR1_2731024385,9,False,1,1,0,19104,219,52,7.0,True,9,True,0,0,0,17769,207,52,6.8,False,25.919483333333332,1335,0,1,271,259,12
BR1_2731855844,7,False,1,1,0,17778,213,64,7.2,False,10,True,0,0,0,19746,244,54,7.2,True,29.184533333333334,-1968,-3,1,277,298,-21
BR1_2731296024,1,False,1,0,0,15677,245,60,7.4,True,5,True,0,1,0,16596,209,76,7.6,False,28.02645,-919,-4,1,305,285,20
BR1_2698860042,2,False,0,0,0,13133,179,40,6.4,False,3,True,1,1,0,16047,229,80,7.2,True,25.589766666666666,-2914,-1,-1,219,309,-90
BR1_2698843045,10,False,1,0,0,18085,220,48,6.6,False,8,True,0,0,0,17305,229,48,7.0,True,26.14678333333333,780,2,1,268,277,-9
BR1_2685067549,3,False,0,0,0,15907,228,50,7.2,True,7,True,1,0,0,18514,262,58,7.6,False,28.521116666666668,-2607,-4,-1,278,320,-42
BR1_2730361236,14,True,1,0,0,19975,218,47,7.0,True,3,False,0,1,0,16095,204,60,7.0,False,25.30065,3880,11,1,265,264,1
BR1_2730349185,4,False,1,0,0,15191,225,60,7.0,True,2,True,0,0,0,13727,207,48,6.4,False,25.044033333333335,1464,2,1,285,255,30
BR1_2731830393,12,True,1,1,0,19439,197,52,6.8,True,4,False,0,0,0,14211,156,48,6.4,False,25.094533333333334,5228,8,1,249,204,45
BR1_2731811223,7,False,1,0,0,17552,220,60,7.2,True,9,True,0,1,0,17519,195,48,7.2,False,29.06635,33,-2,1,280,243,37
BR1_2731115406,6,False,0,0,0,17661,237,52,7.4,False,5,True,1,0,0,15940,199,40,7.0,True,29.0906,1721,1,-1,289,239,50
BR1_2731837753,8,False,1,0,0,17465,198,52,6.6,False,10,True,0,1,0,18810,221,46,6.8,True,27.15005,-1345,-2,1,250,267,-17
BR1_2731773585,15,True,1,0,0,19899,237,68,7.6,True,2,False,0,0,0,14527,219,24,6.8,False,26.178,5372,13,1,305,243,62
BR1_2731715766,10,True,0,1,0,20315,222,56,7.4,False,6,False,1,0,0,18626,262,72,7.6,True,28.99335,1689,4,-1,278,334,-56
BR1_2724912446,8,False,0,0,0,19351,247,68,7.4,True,8,True,1,0,0,18439,214,64,7.2,False,28.0842,912,0,-1,315,278,37
BR1_2713150390,6,False,1,0,0,16506,206,52,6.8,False,7,True,0,0,0,17053,212,60,7.2,True,27.221416666666666,-547,-1,1,258,272,-14
BR1_2731021348,8,False,1,0,0,17916,231,55,7.6,False,8,True,0,0,0,19339,231,60,7.6,True,28.141866666666665,-1423,0,1,286,291,-5
BR1_2727871083,7,True,0,0,0,18406,267,56,7.2,False,13,False,1,1,1,21539,207,64,7.6,True,29.1228,-3133,-6,-1,323,271,52
BR1_2727850174,6,True,0,1,0,16121,223,44,7.0,True,6,False,0,0,0,16030,227,56,7.0,False,27.49705,91,0,0,267,283,-16
BR1_2730103141,9,True,0,0,1,21130,240,64,7.6,True,7,False,0,0,0,16633,215,52,7.2,False,29.199383333333333,4497,2,0,304,267,37
BR1_2730072647,6,True,1,0,0,17195,212,44,6.8,False,2,False,0,1,0,16954,260,56,7.2,True,28.14525,241,4,1,256,316,-60
BR1_2730003980,9,False,0,0,0,19770,203,64,7.2,False,11,True,1,0,0,20195,218,48,7.2,True,28.217133333333333,-425,-2,-1,267,266,1
BR1_2715113903,10,True,1,1,0,18437,214,56,7.0,True,4,False,0,0,0,14680,193,44,6.8,False,25.388483333333333,3757,6,1,270,237,33
BR1_2714840688,14,True,0,1,0,20971,203,68,7.2,True,8,False,1,0,0,17727,181,56,7.2,False,28.2244,3244,6,-1,271,237,34
BR1_2731420773,10,True,1,0,0,18184,213,55,7.0,True,1,False,0,1,0,13742,200,48,6.6,False,25.67556666666667,4442,9,1,268,248,20
BR1_2731825332,7,True,1,0,0,16713,219,60,6.8,False,7,False,0,0,0,16752,217,52,6.8,True,25.499783333333333,-39,0,1,279,269,10
BR1_2731698597,7,True,1,1,0,18944,262,68,7.6,False,7,False,0,0,0,18300,206,59,7.2,True,28.733733333333333,644,0,1,330,265,65
BR1_2730066472,4,False,1,0,0,17754,265,60,7.6,False,7,True,0,0,0,17313,215,52,7.2,True,27.794216666666667,441,-3,1,325,267,58
BR1_2728803890,7,False,0,0,0,16188,198,44,6.6,True,7,True,0,0,0,17933,215,64,6.8,False,25.182,-1745,0,0,242,279,-37
BR1_2697874899,5,True,1,1,0,17010,230,40,7.0,True,10,False,0,0,0,19027,217,56,7.0,False,28.322516666666665,-2017,-5,1,270,273,-3
BR1_2731270172,9,False,0,0,0,18966,248,64,7.8,False,10,True,1,1,0,20658,256,72,7.6,True,29.858466666666665,-1692,-1,-1,312,328,-16
BR1_2731240217,4,True,0,0,0,16323,246,56,7.4,False,4,False,1,1,0,17492,247,68,7.6,True,29.41695,-1169,0,-1,302,315,-13
BR1_2730461477,4,True,1,0,0,15234,221,48,6.6,True,3,False,0,0,0,13899,155,44,6.4,False,26.968033333333334,1335,1,1,269,199,70
BR1_2730120052,7,True,1,0,0,18114,230,56,7.4,False,4,False,0,0,0,18717,272,68,7.6,True,29.186666666666667,-603,3,1,286,340,-54
BR1_2719866322,6,False,0,0,0,17547,227,56,7.2,False,4,True,0,1,0,16167,205,64,7.2,True,28.05045,1380,2,0,283,269,14
BR1_2713339500,8,False,0,1,0,18434,184,64,7.2,False,14,True,1,0,0,19944,195,54,7.2,True,27.657016666666667,-1510,-6,-1,248,249,-1
BR1_2730963735,5,False,0,0,0,15652,197,50,6.4,True,7,True,1,1,0,16061,163,55,6.4,False,26.047166666666666,-409,-2,-1,247,218,29
BR1_2731343815,7,False,0,0,0,15346,177,52,6.6,False,5,True,0,1,0,16153,233,40,6.8,True,25.094733333333334,-807,2,0,229,273,-44
BR1_2731872662,10,True,0,1,1,18541,186,55,7.0,False,7,False,1,0,0,15963,175,44,6.4,True,26.532783333333334,2578,3,-1,241,219,22
BR1_2731786573,13,False,1,0,0,21100,202,52,7.2,True,9,True,0,1,0,18955,220,50,7.0,False,27.54083333333333,2145,4,1,254,270,-16
BR1_2731621564,15,True,1,0,0,21102,236,52,7.6,True,8,False,0,0,0,17639,203,68,7.2,False,29.40365,3463,7,1,288,271,17
BR1_2731739843,4,False,0,1,0,14786,170,60,6.6,False,11,True,1,0,0,18839,232,56,7.6,True,25.91645,-4053,-7,-1,230,288,-58
BR1_2729831474,11,True,1,0,0,18639,212,72,7.4,True,3,False,0,0,0,15415,232,56,7.2,False,25.754966666666668,3224,8,1,284,288,-4
BR1_2730011194,7,True,0,0,0,16391,193,71,6.6,True,6,False,1,1,0,15825,176,66,6.6,False,26.070183333333333,566,1,-1,264,242,22
BR1_2731881150,12,True,1,0,0,19510,195,53,7.2,True,10,False,0,1,0,18354,199,61,7.2,False,29.0114,1156,2,1,248,260,-12
BR1_2731825563,6,True,0,1,0,18475,230,80,7.2,False,8,False,1,0,1,20916,265,60,7.6,True,28.294333333333334,-2441,-2,-1,310,325,-15
BR1_2730404013,9,True,1,0,0,17719,191,52,6.8,True,5,False,0,0,0,16371,198,52,7.0,False,25.760833333333334,1348,4,1,243,250,-7
BR1_2730387642,7,True,1,1,0,17559,203,68,7.0,True,2,False,0,0,0,15531,226,52,6.4,False,25.268416666666667,2028,5,1,271,278,-7
BR1_2715690352,10,False,1,0,0,18308,199,52,6.6,True,7,True,0,1,0,15914,192,44,6.6,False,26.609166666666667,2394,3,1,251,236,15
BR1_2712481572,8,False,0,0,0,17810,175,44,6.8,False,13,True,0,0,0,20280,178,56,7.2,True,29.847533333333335,-2470,-5,0,219,234,-15
BR1_2701236435,12,True,0,0,0,18952,185,46,6.6,False,13,False,1,0,0,19978,218,44,6.8,True,26.4179,-1026,-1,-1,231,262,-31
BR1_2713412121,5,False,0,0,0,16484,237,52,6.8,False,5,True,1,0,0,16685,239,64,7.2,True,27.012833333333333,-201,0,-1,289,303,-14
BR1_2713187517,5,False,0,0,0,18529,254,80,7.4,True,8,True,0,0,0,18965,264,62,7.4,False,28.473216666666666,-436,-3,0,334,326,8
BR1_2713168182,6,False,0,0,0,16866,215,45,7.0,False,9,True,1,1,0,20738,243,78,7.6,True,29.2685,-3872,-3,-1,260,321,-61
BR1_2713143699,9,False,0,1,0,17701,213,52,7.0,True,5,True,1,0,0,15931,206,53,6.6,False,26.5931,1770,4,-1,265,259,6
BR1_2731151663,12,True,1,0,0,19902,256,60,7.4,False,4,False,0,0,0,16977,226,60,7.0,True,27.8798,2925,8,1,316,286,30
BR1_2728080446,14,True,1,0,0,21843,214,72,7.6,True,10,False,0,0,0,18109,187,32,6.8,False,28.31575,3734,4,1,286,219,67
BR1_2731106846,9,True,1,0,0,20316,243,68,7.8,True,2,False,0,0,0,15103,197,64,6.8,False,27.834883333333334,5213,7,1,311,261,50
BR1_2722417863,4,False,0,1,0,18075,245,63,7.4,True,7,True,1,0,0,18352,219,68,7.4,False,29.800183333333333,-277,-3,-1,308,287,21
BR1_2708809416,5,False,1,1,1,18590,215,60,7.0,True,5,True,0,0,0,15463,190,48,6.4,False,25.6098,3127,0,1,275,238,37
BR1_2708803755,1,False,0,0,0,13718,194,51,6.6,False,8,True,1,1,0,18565,249,60,7.4,True,26.2999,-4847,-7,-1,245,309,-64
BR1_2731833110,12,True,0,0,0,21252,234,48,7.6,True,2,False,1,0,0,16383,244,88,7.4,False,29.1146,4869,10,-1,282,332,-50
BR1_2730836886,4,False,0,1,0,16125,211,59,7.0,False,8,True,1,0,0,18422,245,52,7.2,True,29.528883333333333,-2297,-4,-1,270,297,-27
BR1_2730391276,4,False,1,0,0,15089,171,48,6.8,True,3,True,0,0,0,15578,221,48,7.0,False,26.43413333333333,-489,1,1,219,269,-50
BR1_2730372582,7,True,0,0,0,16964,223,62,7.2,True,3,False,0,0,0,14178,207,45,6.4,False,26.129133333333332,2786,4,0,285,252,33
BR1_2729867775,5,False,0,0,0,15091,190,44,6.4,False,10,True,1,0,0,19141,237,56,7.4,True,25.71265,-4050,-5,-1,234,293,-59
BR1_2724932305,9,True,1,0,0,17698,187,56,6.8,False,6,False,0,0,0,16715,168,60,7.0,True,26.2299,983,3,1,243,228,15
BR1_2721540163,8,True,1,1,0,18158,235,36,6.8,True,3,False,0,0,0,14922,214,56,6.8,False,25.3159,3236,5,1,271,270,1
BR1_2722979629,5,True,1,0,0,17334,229,48,7.4,False,7,False,0,0,0,18324,260,62,7.6,True,27.8545,-990,-2,1,277,322,-45
BR1_2720562860,10,True,0,0,0,18143,207,44,6.4,False,16,False,0,0,0,20804,204,40,6.8,True,26.852333333333334,-2661,-6,0,251,244,7
BR1_2730913529,12,True,1,1,0,19025,211,68,6.8,True,7,False,0,0,0,16990,219,48,6.6,False,26.951016666666668,2035,5,1,279,267,12
BR1_2726665845,5,True,0,0,0,17918,252,48,7.2,False,6,False,1,1,0,18661,265,68,7.6,True,27.651733333333333,-743,-1,-1,300,333,-33
BR1_2728903074,10,False,0,0,0,17544,179,43,6.6,False,10,True,1,0,0,17804,215,48,7.0,True,25.174483333333335,-260,0,-1,222,263,-41
BR1_2728091467,15,False,1,0,0,21803,213,60,7.4,False,7,True,0,1,1,19456,206,56,6.6,True,27.720083333333335,2347,8,1,273,262,11
BR1_2713160237,8,False,0,0,0,15429,147,42,6.0,False,7,True,0,0,0,17541,198,68,6.8,True,26.148666666666667,-2112,1,0,189,266,-77
BR1_2730800590,10,False,0,1,0,19072,168,65,7.0,True,13,True,1,0,0,20643,224,58,7.2,False,29.92775,-1571,-3,-1,233,282,-49
BR1_2722026287,8,True,0,0,0,16630,186,58,6.6,False,13,False,0,0,0,20379,219,49,7.2,True,25.759266666666665,-3749,-5,0,244,268,-24
BR1_2722011298,10,True,0,1,0,18119,203,44,6.6,True,3,False,0,0,0,14106,188,46,6.6,False,25.142466666666667,4013,7,0,247,234,13
BR1_2721994180,12,True,1,1,0,21126,263,68,8.0,True,7,False,0,0,0,19164,210,68,7.2,False,28.163333333333334,1962,5,1,331,278,53
BR1_2731618376,10,False,0,1,0,19820,224,56,7.4,False,10,True,1,0,0,20227,269,64,7.6,True,27.977733333333333,-407,0,-1,280,333,-53
BR1_2731087824,3,True,1,0,0,14468,176,48,6.6,False,1,False,0,0,0,13305,187,52,6.4,True,27.073016666666668,1163,2,1,224,239,-15
BR1_2731832462,5,False,1,0,0,17762,256,60,7.6,True,8,True,0,1,0,18900,243,60,7.4,False,28.672466666666665,-1138,-3,1,316,303,13
BR1_2731636965,12,True,1,0,0,17828,184,55,6.8,True,5,False,0,0,0,15316,188,40,6.6,False,25.3856,2512,7,1,239,228,11
BR1_2723136000,5,True,1,0,0,16713,204,64,7.0,True,5,False,0,1,0,16223,214,68,7.0,False,27.474316666666667,490,0,1,268,282,-14
BR1_2718862958,6,True,0,0,0,16879,231,51,7.2,False,15,False,0,1,0,22097,253,68,8.0,True,27.562666666666665,-5218,-9,0,282,321,-39
BR1_2718838564,4,True,0,0,0,14774,173,45,6.4,False,7,False,1,0,0,16860,238,48,7.0,True,25.156983333333333,-2086,-3,-1,218,286,-68
BR1_2718314411,1,False,1,1,0,16599,280,72,7.6,True,3,True,0,0,0,16509,243,56,7.2,False,29.99575,90,-2,1,352,299,53
BR1_2728856571,12,True,1,1,0,19875,214,72,7.4,False,8,False,0,0,0,17326,206,56,7.2,True,27.89966666666667,2549,4,1,286,262,24
BR1_2731846984,5,False,0,0,0,14936,177,44,6.6,False,11,True,1,0,1,20137,230,52,7.2,True,26.70243333333333,-5201,-6,-1,221,282,-61
BR1_2730603340,6,False,0,0,0,17916,237,50,7.2,False,11,True,1,0,0,20579,243,60,7.4,True,28.557683333333333,-2663,-5,-1,287,303,-16
BR1_2730933496,12,True,0,0,0,20778,246,52,7.4,False,9,False,1,1,0,21358,213,80,7.4,True,28.0941,-580,3,-1,298,293,5
BR1_2730999632,10,False,0,1,0,17706,205,52,6.8,False,8,True,0,0,0,17126,216,40,6.6,True,27.03555,580,2,0,257,256,1
BR1_2731526388,8,True,0,0,0,17288,206,48,6.8,True,3,False,0,1,0,14159,178,68,6.8,False,27.31755,3129,5,0,254,246,8
BR1_2731691760,7,True,1,0,0,16317,173,48,6.8,True,3,False,0,0,0,14313,169,68,7.0,False,25.873466666666666,2004,4,1,221,237,-16
BR1_2731140383,6,True,1,1,0,17406,238,64,7.4,True,6,False,0,0,0,18939,236,60,7.8,False,29.769083333333334,-1533,0,1,302,296,6
BR1_2731769721,16,True,1,1,0,21987,211,57,7.6,True,18,False,0,0,0,22543,224,46,7.2,False,27.592066666666668,-556,-2,1,268,270,-2
BR1_2731856200,5,False,0,0,0,16101,221,52,7.2,True,5,True,1,0,0,15684,190,60,7.2,False,25.825733333333332,417,0,-1,273,250,23
BR1_2731810502,5,True,1,1,0,16149,191,60,6.8,False,8,False,0,0,0,17779,199,52,6.8,True,25.885433333333335,-1630,-3,1,251,251,0
BR1_2720400363,11,True,0,1,0,20798,254,52,7.6,True,6,False,0,0,0,17084,191,60,7.2,False,28.21835,3714,5,0,306,251,55
BR1_2731569003,10,False,0,0,0,19685,215,56,7.4,True,13,True,1,0,0,20063,186,60,7.0,False,28.43455,-378,-3,-1,271,246,25
BR1_2731510623,4,False,0,1,0,15992,216,44,6.6,True,8,True,1,0,0,16750,199,51,6.8,False,26.041516666666666,-758,-4,-1,260,250,10
BR1_2726635191,8,True,1,1,0,19078,237,56,7.4,True,4,False,0,0,0,14372,167,64,6.6,False,27.411383333333333,4706,4,1,293,231,62
BR1_2731114754,10,False,0,1,1,21247,231,61,7.4,True,12,True,1,0,0,20820,239,54,7.4,False,27.637733333333333,427,-2,-1,292,293,-1
BR1_2731780489,7,False,0,0,0,17740,218,60,7.4,False,10,True,0,0,0,18253,186,72,7.2,True,28.763583333333333,-513,-3,0,278,258,20
BR1_2731756717,8,False,1,0,0,18893,228,60,7.2,True,6,True,0,0,0,18016,214,68,7.2,False,29.171966666666666,877,2,1,288,282,6
BR1_2731729790,5,False,1,0,0,15658,208,64,6.8,True,6,True,0,1,0,16655,189,56,7.0,False,26.1011,-997,-1,1,272,245,27
BR1_2730783281,12,False,1,0,0,19742,201,76,7.4,True,6,True,0,0,0,17036,220,48,7.2,False,27.944266666666667,2706,6,1,277,268,9
BR1_2731834337,12,True,0,0,0,20836,215,56,7.4,False,11,False,1,0,0,21081,258,68,7.2,True,29.00295,-245,1,-1,271,326,-55
BR1_2729635540,9,False,0,0,0,19244,232,56,7.4,False,12,True,1,1,0,21475,258,64,7.4,True,27.7507,-2231,-3,-1,288,322,-34
BR1_2731905573,6,False,0,0,0,17776,236,60,7.4,True,9,True,1,1,0,20628,243,60,7.6,False,28.587666666666667,-2852,-3,-1,296,303,-7
BR1_2731637877,12,False,0,0,0,21501,244,64,7.4,True,10,True,1,0,0,18561,211,59,7.0,False,29.992833333333333,2940,2,-1,308,270,38
BR1_2726436114,9,False,0,0,0,17423,226,36,7.0,False,9,True,1,1,0,17874,233,54,7.0,True,27.112516666666668,-451,0,-1,262,287,-25
BR1_2731422206,5,True,0,0,0,14477,154,52,6.6,False,12,False,0,0,0,18849,199,56,6.8,True,25.7041,-4372,-7,0,206,255,-49
BR1_2731255562,2,False,0,0,0,14817,211,68,6.8,True,7,True,0,0,0,18242,233,64,7.2,False,26.969733333333334,-3425,-5,0,279,297,-18
BR1_2723459602,15,True,0,0,0,19844,222,54,7.2,True,6,False,0,0,0,16378,195,49,6.8,False,26.52885,3466,9,0,276,244,32
BR1_2731707463,5,True,0,0,0,15634,181,43,6.4,False,5,False,1,0,0,16160,226,53,6.8,True,25.9236,-526,0,-1,224,279,-55
BR1_2722017135,6,True,0,1,0,17730,213,60,7.2,False,6,False,1,0,0,18247,224,70,7.4,True,29.6456,-517,0,-1,273,294,-21
BR1_2721969082,5,False,0,0,0,17657,252,72,7.4,False,10,True,1,0,0,19373,256,56,7.6,True,28.57755,-1716,-5,-1,324,312,12
BR1_2709672489,5,False,0,0,0,17267,232,52,7.0,False,7,True,0,1,0,19850,253,52,7.6,True,29.175933333333333,-2583,-2,0,284,305,-21
BR1_2731658012,6,False,1,1,0,18594,215,68,7.6,True,6,True,0,0,0,17475,224,63,7.2,False,28.679816666666667,1119,0,1,283,287,-4
BR1_2731634200,6,False,0,0,0,15687,193,52,7.0,True,4,True,1,0,0,14857,183,68,6.8,False,25.994416666666666,830,2,-1,245,251,-6
BR1_2731875584,16,True,1,0,0,19423,199,52,7.0,True,7,False,0,0,0,16866,183,40,6.4,False,26.1918,2557,9,1,251,223,28
BR1_2731873074,8,True,0,0,0,17741,224,53,6.6,True,5,False,0,0,0,15209,158,49,6.4,False,27.372933333333332,2532,3,0,277,207,70
BR1_2730868281,10,True,0,0,0,19354,230,51,7.2,True,13,False,0,0,0,20434,191,56,7.2,False,27.565833333333334,-1080,-3,0,281,247,34
BR1_2731597043,1,False,0,0,0,14992,249,56,6.8,False,4,True,0,0,0,16729,246,59,7.2,True,25.05235,-1737,-3,0,305,305,0
BR1_2731562017,7,True,0,0,0,16050,187,55,6.8,False,4,False,0,0,0,15679,196,48,6.8,True,26.118433333333332,371,3,0,242,244,-2
BR1_2722163387,7,True,0,1,0,17749,212,59,7.2,True,10,False,1,0,0,19757,262,52,7.4,False,29.40615,-2008,-3,-1,271,314,-43
BR1_2725373021,8,True,0,1,0,20163,268,60,7.4,True,7,False,1,0,0,18853,245,52,7.8,False,27.572033333333334,1310,1,-1,328,297,31
BR1_2699222060,10,True,0,1,0,20957,265,64,7.8,True,6,False,1,0,0,17686,261,48,7.8,False,29.564533333333333,3271,4,-1,329,309,20
BR1_2731136533,7,True,1,0,0,18365,271,53,7.4,True,2,False,0,0,0,14939,235,51,7.4,False,26.173266666666667,3426,5,1,324,286,38
BR1_2726612005,4,False,0,0,0,15405,216,60,6.8,False,3,True,1,1,0,15578,203,63,7.0,True,25.856,-173,1,-1,276,266,10
BR1_2726222737,9,True,0,1,1,21168,238,56,7.6,False,6,False,1,0,0,16524,218,55,7.2,True,29.034383333333334,4644,3,-1,294,273,21
BR1_2724645446,11,True,0,0,0,19413,215,52,7.6,False,3,False,1,1,0,17561,254,68,7.4,True,29.597816666666667,1852,8,-1,267,322,-55
BR1_2705377467,6,True,0,0,0,16050,194,56,6.6,False,7,False,0,1,0,17977,217,60,7.0,True,25.1186,-1927,-1,0,250,277,-27
BR1_2707090393,12,False,0,0,0,19253,210,44,7.0,False,11,True,1,0,0,18910,189,56,7.2,True,29.305033333333334,343,1,-1,254,245,9
BR1_2704152634,7,True,0,0,0,16610,186,40,6.4,False,9,False,1,0,0,16762,177,46,6.8,True,27.17765,-152,-2,-1,226,223,3
BR1_2694607586,10,False,1,0,0,19938,245,48,7.2,True,5,True,0,0,0,15861,214,48,6.6,False,28.316816666666668,4077,5,1,293,262,31
BR1_2719699703,3,False,0,1,0,15224,176,62,7.2,False,5,True,1,0,0,18173,253,64,7.4,True,29.445816666666666,-2949,-2,-1,238,317,-79
BR1_2687528229,7,True,0,0,0,17171,215,44,6.4,True,4,False,0,0,0,14426,181,44,6.8,False,27.329716666666666,2745,3,0,259,225,34
BR1_2686874417,5,False,0,1,0,16049,211,40,6.8,True,13,True,1,0,0,17851,191,56,6.8,False,26.689933333333332,-1802,-8,-1,251,247,4
BR1_2731712424,5,False,0,0,0,15948,205,52,6.8,False,10,True,1,0,0,18475,198,56,7.0,True,25.84325,-2527,-5,-1,257,254,3
BR1_2731688304,4,True,0,0,0,15214,214,64,7.0,False,5,False,1,1,0,15235,179,60,6.8,True,26.0396,-21,-1,-1,278,239,39
BR1_2731661844,8,True,0,1,0,19372,234,56,7.4,True,2,False,1,0,0,15466,237,64,7.0,False,29.882583333333333,3906,6,-1,290,301,-11
BR1_2731451246,7,True,0,0,0,19203,278,72,7.8,False,3,False,0,0,0,16713,242,68,7.4,True,27.503783333333335,2490,4,0,350,310,40
BR1_2731718775,8,True,0,0,0,17344,179,58,7.2,False,9,False,1,0,0,19367,247,69,7.8,True,29.03655,-2023,-1,-1,237,316,-79
BR1_2731676265,7,False,0,1,0,17303,220,48,7.2,False,6,True,1,0,0,19064,266,72,7.6,True,28.128866666666667,-1761,1,-1,268,338,-70
BR1_2731761088,5,True,1,0,0,17823,221,62,7.2,False,6,False,0,0,0,17879,251,52,7.0,True,28.149516666666667,-56,-1,1,283,303,-20
BR1_2729278505,10,True,1,1,0,20513,255,68,7.6,True,5,False,0,0,0,17466,222,58,7.2,False,28.6604,3047,5,1,323,280,43
BR1_2731777008,8,True,0,0,0,17779,211,64,6.6,True,7,False,1,0,0,15922,215,44,7.0,False,26.244683333333334,1857,1,-1,275,259,16
BR1_2731749541,11,True,0,1,0,17650,167,52,6.6,False,8,False,0,0,0,16969,203,51,6.6,True,26.369766666666667,681,3,0,219,254,-35
BR1_2731647008,5,False,0,0,0,14729,176,56,6.8,False,13,True,1,0,0,21520,235,52,7.0,True,25.369116666666667,-6791,-8,-1,232,287,-55
BR1_2731618845,7,False,0,1,0,18196,232,46,7.2,False,15,True,1,0,0,21507,241,56,7.4,True,29.368766666666666,-3311,-8,-1,278,297,-19
BR1_2725656843,2,True,0,0,0,14726,187,56,6.4,False,9,False,1,0,0,18060,231,43,7.2,True,26.135383333333333,-3334,-7,-1,243,274,-31
BR1_2723077795,15,True,1,0,0,21060,236,36,7.2,True,6,False,0,0,0,18200,228,55,6.6,False,28.5332,2860,9,1,272,283,-11
BR1_2723053336,7,True,0,1,1,19952,228,67,7.4,False,10,False,1,0,0,20138,279,56,7.6,True,27.9425,-186,-3,-1,295,335,-40
BR1_2731665350,8,False,1,0,0,18240,242,80,7.8,True,7,True,0,1,0,18672,249,56,7.4,False,29.211933333333334,-432,1,1,322,305,17
BR1_2731641555,7,True,1,1,0,17365,229,72,7.0,True,4,False,0,0,0,14945,204,40,7.0,False,26.180733333333333,2420,3,1,301,244,57
BR1_2730761417,11,False,0,0,0,16766,190,38,6.6,False,6,True,0,0,0,15870,180,52,6.2,True,26.7619,896,5,0,228,232,-4
BR1_2727951850,5,True,0,0,0,17409,251,60,7.8,False,8,False,1,0,0,19384,271,60,7.6,True,29.7434,-1975,-3,-1,311,331,-20
BR1_2731357864,7,False,1,0,0,16380,191,55,7.0,False,8,True,0,0,0,17959,221,52,6.8,True,27.187316666666668,-1579,-1,1,246,273,-27
BR1_2730251736,8,False,0,1,0,20502,248,84,7.6,False,10,True,1,0,0,19076,224,48,7.2,True,27.900433333333332,1426,-2,-1,332,272,60
BR1_2731798610,12,False,1,1,0,21227,252,48,7.2,False,7,True,0,0,0,17906,218,60,7.2,True,29.614466666666665,3321,5,1,300,278,22
BR1_2731458691,4,True,0,0,0,16010,217,52,6.8,True,4,False,1,1,0,16703,203,60,7.0,False,25.984583333333333,-693,0,-1,269,263,6
BR1_2730819478,17,True,0,0,0,21825,221,42,7.2,True,14,False,0,0,0,21893,213,28,6.8,False,28.652033333333332,-68,3,0,263,241,22
BR1_2727475234,1,False,0,0,0,15348,239,44,7.2,False,10,True,1,0,0,20111,252,64,7.6,True,29.689783333333335,-4763,-9,-1,283,316,-33
BR1_2726410403,7,False,0,0,0,17876,232,68,7.2,False,14,True,1,0,0,20848,237,67,7.6,True,28.907716666666666,-2972,-7,-1,300,304,-4
BR1_2726282835,9,True,1,0,0,17713,193,80,6.8,False,8,False,0,0,0,17572,202,44,6.6,True,27.0208,141,1,1,273,246,27
BR1_2731020506,6,True,0,0,0,16162,205,56,7.0,False,5,False,1,1,0,16467,211,60,7.2,True,27.0583,-305,1,-1,261,271,-10
BR1_2729435651,6,True,0,0,0,15414,209,36,6.6,False,7,False,1,0,0,16205,191,75,7.0,True,27.35195,-791,-1,-1,245,266,-21
BR1_2728885376,6,True,0,0,0,17926,222,56,6.8,False,13,False,1,0,0,19349,212,48,7.2,True,28.14895,-1423,-7,-1,278,260,18
BR1_2719593587,11,True,0,0,0,18275,193,48,6.8,False,11,False,0,0,0,18736,207,52,6.8,True,27.207066666666666,-461,0,0,241,259,-18
BR1_2679803716,15,True,1,0,0,20619,202,48,7.2,True,4,False,0,1,0,15062,189,55,6.6,False,25.36305,5557,11,1,250,244,6
BR1_2693462475,12,True,0,0,0,18091,210,33,6.4,True,11,False,0,0,0,18845,195,55,7.0,False,27.369566666666667,-754,1,0,243,250,-7
BR1_2693360748,5,True,0,1,1,18899,225,62,7.4,False,6,False,1,0,0,18180,252,48,7.4,True,29.0956,719,-1,-1,287,300,-13
BR1_2730330858,4,False,0,0,0,15814,187,52,7.0,True,8,True,0,0,0,19458,260,78,7.6,False,29.14465,-3644,-4,0,239,338,-99
BR1_2731770135,6,True,0,0,0,15989,230,36,6.8,True,5,False,0,1,0,15599,179,52,6.6,False,26.48445,390,1,0,266,231,35
BR1_2730692215,6,True,0,0,0,17626,247,48,7.6,False,6,False,1,0,0,17498,226,68,7.2,True,29.922666666666668,128,0,-1,295,294,1
BR1_2725327976,5,False,1,1,0,17205,212,84,7.4,True,5,True,0,0,0,15398,199,52,7.0,False,26.6929,1807,0,1,296,251,45
BR1_2727973345,4,False,0,0,0,15504,203,56,6.4,False,9,True,1,0,0,17919,198,52,6.6,True,26.8588,-2415,-5,-1,259,250,9
BR1_2712719476,14,False,0,0,0,21737,245,48,7.6,False,12,True,0,0,1,21623,216,56,7.4,True,29.957483333333332,114,2,0,293,272,21
BR1_2731302063,10,True,1,0,0,17739,226,48,7.2,True,2,False,0,0,0,14236,215,60,6.8,False,25.53375,3503,8,1,274,275,-1
BR1_2731706936,5,False,0,0,0,16786,218,56,7.0,False,8,True,1,0,0,18739,252,60,7.4,True,29.98565,-1953,-3,-1,274,312,-38
BR1_2731663822,5,False,0,0,0,15738,206,59,6.8,False,8,True,1,1,0,17402,215,64,7.0,True,25.0194,-1664,-3,-1,265,279,-14
BR1_2729723492,6,False,0,0,0,16298,195,43,6.6,True,12,True,0,1,0,17710,158,55,6.6,False,25.1709,-1412,-6,0,238,213,25
BR1_2731504789,9,True,1,0,0,19475,251,58,7.6,True,5,False,0,1,0,17357,228,64,7.6,False,28.60675,2118,4,1,309,292,17
BR1_2731864233,12,False,0,0,0,19695,217,66,7.0,True,8,True,0,1,0,16881,183,38,6.6,False,25.5353,2814,4,0,283,221,62
BR1_2699696927,4,True,0,0,0,17270,244,64,7.4,False,5,False,1,0,0,17210,246,48,7.4,True,29.546916666666668,60,-1,-1,308,294,14
BR1_2703686274,7,True,0,1,0,17738,222,76,7.2,True,2,False,1,0,0,13679,205,40,6.6,False,26.532166666666665,4059,5,-1,298,245,53
BR1_2730918132,7,True,0,0,0,17458,223,44,6.8,True,11,False,0,1,0,19211,201,48,7.0,False,25.169983333333334,-1753,-4,0,267,249,18
BR1_2727649298,5,False,0,1,0,17283,217,60,7.0,False,10,True,0,0,0,19936,241,56,7.8,True,29.604266666666668,-2653,-5,0,277,297,-20
BR1_2729665975,8,False,0,0,0,17769,193,56,7.0,False,12,True,1,0,0,20507,241,40,7.4,True,28.64295,-2738,-4,-1,249,281,-32
BR1_2728792347,7,False,0,0,0,16275,195,40,6.8,True,8,True,1,0,0,15735,186,46,6.8,False,26.4837,540,-1,-1,235,232,3
BR1_2730515102,11,True,0,1,0,19966,214,68,7.2,False,8,False,1,0,0,18747,219,52,7.4,True,28.5404,1219,3,-1,282,271,11
BR1_2731252894,2,False,0,0,0,13718,190,52,6.4,False,6,True,1,0,0,16163,220,64,7.0,True,25.68875,-2445,-4,-1,242,284,-42
BR1_2699684500,4,True,0,0,0,14144,180,36,6.8,False,7,False,0,0,0,17986,238,64,7.0,True,25.365816666666667,-3842,-3,0,216,302,-86
BR1_2699667096,7,False,0,0,0,16898,198,64,7.0,True,5,True,0,0,0,16351,227,64,6.8,False,25.145433333333333,547,2,0,262,291,-29
BR1_2731668799,12,False,1,0,0,19692,219,56,7.4,True,14,True,0,0,0,22723,254,56,7.6,False,29.054983333333332,-3031,-2,1,275,310,-35
BR1_2731229542,5,True,1,0,0,17566,230,57,7.4,False,5,False,0,1,0,17762,215,70,7.2,True,29.421666666666667,-196,0,1,287,285,2
BR1_2731762058,12,True,0,1,0,19727,209,52,7.2,True,8,False,0,0,0,17622,206,48,6.8,False,26.153433333333332,2105,4,0,261,254,7
BR1_2730700251,4,False,0,0,0,16702,222,54,7.6,False,8,True,1,0,0,19206,262,57,7.6,True,27.782583333333335,-2504,-4,-1,276,319,-43
BR1_2730734229,6,False,1,0,0,17537,225,66,7.6,False,8,True,0,1,0,18628,218,65,7.2,True,28.68735,-1091,-2,1,291,283,8
BR1_2727978111,6,False,1,0,0,17641,253,58,7.0,False,9,True,0,1,0,19571,233,68,7.6,True,28.143616666666667,-1930,-3,1,311,301,10
BR1_2730865038,4,False,1,0,0,15158,190,56,6.8,False,8,True,0,0,0,17386,218,60,7.2,True,25.49685,-2228,-4,1,246,278,-32
BR1_2697547083,4,True,0,0,0,16264,213,76,7.6,True,7,False,1,1,0,18871,234,76,7.6,False,29.128566666666668,-2607,-3,-1,289,310,-21
BR1_2729774961,9,False,0,0,0,17894,208,56,7.0,False,15,True,0,0,0,20796,203,52,7.2,True,28.473916666666668,-2902,-6,0,264,255,9
BR1_2729762265,11,False,0,0,0,18466,228,43,6.6,True,10,True,0,0,0,17461,183,52,6.8,False,25.134533333333334,1005,1,0,271,235,36
BR1_2726833968,6,True,0,0,0,16553,207,56,6.8,False,11,False,1,1,0,18331,199,56,7.2,True,27.376283333333333,-1778,-5,-1,263,255,8
BR1_2731870485,9,False,0,0,0,17324,212,70,6.8,False,3,True,0,1,0,15347,194,40,6.8,True,25.887716666666666,1977,6,0,282,234,48
BR1_2731280750,11,False,0,1,0,19353,236,48,7.4,False,6,True,0,0,0,17825,238,60,7.0,True,29.57355,1528,5,0,284,298,-14
BR1_2727055346,12,True,0,0,0,17968,207,64,6.8,True,3,False,1,0,0,14490,206,54,6.6,False,26.261,3478,9,-1,271,260,11
BR1_2729855910,6,False,0,0,0,16540,220,60,7.2,False,5,True,1,0,0,16137,222,52,6.6,True,25.8249,403,1,-1,280,274,6
BR1_2708712078,7,False,0,0,0,14618,185,12,6.4,False,9,True,1,0,0,18266,226,80,7.4,True,25.932666666666666,-3648,-2,-1,197,306,-109
BR1_2708684031,5,False,0,0,0,17322,237,48,7.2,True,7,True,0,0,0,18646,238,52,7.2,False,28.0386,-1324,-2,0,285,290,-5
BR1_2731848580,10,True,1,0,0,19349,198,54,7.0,False,11,False,0,0,0,20465,261,52,7.6,True,28.295716666666667,-1116,-1,1,252,313,-61
BR1_2719595257,6,True,1,0,0,16966,201,63,6.8,False,7,False,0,1,0,17187,177,44,7.0,True,25.817716666666666,-221,-1,1,264,221,43
BR1_2719556242,8,True,0,1,0,19054,212,72,7.2,True,6,False,1,0,0,16780,203,76,7.2,False,27.9527,2274,2,-1,284,279,5
BR1_2731793345,10,True,1,0,0,19953,226,59,7.0,True,8,False,0,0,0,18145,252,52,7.4,False,28.514083333333332,1808,2,1,285,304,-19
BR1_2731447033,9,True,0,0,0,20019,252,54,7.4,False,12,False,0,0,0,19381,215,48,7.2,True,28.534016666666666,638,-3,0,306,263,43
BR1_2731438123,6,False,0,0,0,16979,181,56,6.8,False,11,True,1,0,0,20236,231,67,7.4,True,28.751933333333334,-3257,-5,-1,237,298,-61
BR1_2731812640,9,True,1,0,0,18940,260,72,7.8,True,4,False,0,0,0,15699,231,40,7.4,False,29.76245,3241,5,1,332,271,61
BR1_2731796164,9,True,1,0,0,18073,256,46,7.2,True,2,False,0,1,0,14777,199,77,6.6,False,25.98525,3296,7,1,302,276,26
BR1_2728037943,8,False,0,0,0,16497,174,36,6.2,True,11,True,1,1,0,18338,183,60,7.0,False,25.66775,-1841,-3,-1,210,243,-33
BR1_2728014943,11,True,1,0,0,18303,214,58,7.0,False,5,False,0,0,0,16876,229,28,6.6,True,29.044033333333335,1427,6,1,272,257,15
BR1_2730836904,12,True,1,0,0,21095,280,70,7.6,True,6,False,0,0,0,18402,223,68,7.0,False,28.184683333333332,2693,6,1,350,291,59
BR1_2730729152,5,True,0,1,0,17261,229,60,7.2,False,5,False,1,0,0,18086,244,71,7.4,True,27.617333333333335,-825,0,-1,289,315,-26
BR1_2730701034,5,False,0,0,0,15695,209,56,6.8,False,5,True,0,0,0,15649,194,67,7.0,True,27.021516666666667,46,0,0,265,261,4
BR1_2730530151,12,True,1,1,0,18711,202,52,6.8,True,8,False,0,0,0,16906,197,44,6.6,False,25.03805,1805,4,1,254,241,13
BR1_2730513812,11,False,0,1,0,18482,153,56,6.2,False,17,True,1,0,0,20526,176,36,6.8,True,27.310083333333335,-2044,-6,-1,209,212,-3
BR1_2731103024,5,False,0,0,0,15630,228,52,6.4,False,9,True,0,0,0,17992,229,56,7.2,True,26.927766666666667,-2362,-4,0,280,285,-5
BR1_2728625549,3,True,0,0,0,14137,190,48,6.8,False,8,False,0,0,0,16492,204,42,7.0,True,25.56605,-2355,-5,0,238,246,-8
BR1_2728615789,11,False,1,1,0,18508,205,60,7.2,True,6,True,0,0,0,15561,174,52,6.4,False,27.38895,2947,5,1,265,226,39
BR1_2731723427,11,True,1,1,0,17926,181,60,7.0,True,8,False,0,0,0,17680,192,72,6.8,False,25.43105,246,3,1,241,264,-23
BR1_2731648620,11,True,0,0,0,18140,208,48,7.0,True,5,False,0,0,0,15911,199,40,6.6,False,27.49,2229,6,0,256,239,17
BR1_2731865793,7,False,1,0,0,15480,178,47,6.2,False,14,True,0,0,0,20074,230,35,7.2,True,25.597716666666667,-4594,-7,1,225,265,-40
BR1_2729686333,10,False,0,0,0,16918,171,48,6.8,False,10,True,0,0,0,17184,186,68,7.0,True,25.557583333333334,-266,0,0,219,254,-35
BR1_2728914917,6,False,0,0,0,17329,183,60,7.0,False,12,True,1,0,0,18217,197,47,7.0,True,25.401916666666665,-888,-6,-1,243,244,-1
BR1_2709053267,6,False,0,0,0,16386,230,44,6.8,False,6,True,0,0,0,16387,206,56,6.8,True,25.811316666666666,-1,0,0,274,262,12
BR1_2708284919,4,False,0,0,0,14725,160,48,6.2,False,13,True,0,0,0,19019,233,48,6.8,True,25.843783333333334,-4294,-9,0,208,281,-73
BR1_2731850633,7,True,0,1,0,18346,239,68,7.8,True,7,False,1,0,0,18074,212,64,7.2,False,29.264716666666665,272,0,-1,307,276,31
BR1_2731837959,13,False,0,0,0,20531,204,52,7.6,False,8,True,1,1,0,19967,273,76,7.6,True,28.745116666666668,564,5,-1,256,349,-93
BR1_2731350269,11,True,0,0,0,18266,190,44,6.8,True,6,False,1,1,0,16307,174,60,6.4,False,26.128516666666666,1959,5,-1,234,234,0
BR1_2724832197,1,False,0,1,0,14748,223,52,7.0,False,6,True,1,0,0,15833,179,60,6.8,True,27.2243,-1085,-5,-1,275,239,36
BR1_2731345575,5,True,1,0,0,18093,248,64,7.2,False,10,False,0,1,0,20169,263,76,7.8,True,28.155366666666666,-2076,-5,1,312,339,-27
BR1_2731315062,9,True,0,1,0,17322,218,48,6.8,True,4,False,0,0,0,15165,195,56,6.8,False,26.38305,2157,5,0,266,251,15
BR1_2730303232,3,False,1,0,0,15916,226,56,7.4,False,6,True,0,1,0,18678,227,72,7.6,True,27.542766666666665,-2762,-3,1,282,299,-17
BR1_2730279001,8,False,1,0,0,18380,206,68,7.0,False,8,True,0,1,1,19337,201,56,7.2,True,29.2169,-957,0,1,274,257,17
BR1_2731177880,15,True,1,0,0,20930,182,60,7.2,True,7,False,0,0,0,16955,168,60,6.4,False,26.638466666666666,3975,8,1,242,228,14
BR1_2703689900,4,True,0,0,0,14794,200,44,6.6,False,8,False,1,0,0,17839,212,63,7.0,True,25.51105,-3045,-4,-1,244,275,-31
BR1_2703676014,8,False,1,0,0,17505,240,48,7.2,True,5,True,0,0,0,14695,188,40,6.6,False,26.358066666666666,2810,3,1,288,228,60
BR1_2731224839,4,False,0,0,0,15101,159,64,6.6,False,10,True,0,0,0,18539,216,56,7.0,True,26.887016666666668,-3438,-6,0,223,272,-49
BR1_2731809943,4,False,1,0,0,17742,267,67,7.2,True,5,True,0,0,0,17572,238,44,7.2,False,28.46595,170,-1,1,334,282,52
BR1_2729181474,5,False,0,0,0,19202,265,71,7.4,True,4,True,0,0,0,16046,197,51,7.0,False,29.7744,3156,1,0,336,248,88
BR1_2729168364,10,True,1,0,0,17569,187,56,7.0,False,9,False,0,0,0,18237,230,56,7.0,True,26.348766666666666,-668,1,1,243,286,-43
BR1_2714810195,9,False,1,0,0,19110,233,60,7.4,True,7,True,0,1,0,18207,236,60,7.0,False,29.16915,903,2,1,293,296,-3
BR1_2730756392,11,True,1,0,0,18252,235,64,7.0,True,3,False,0,0,0,15111,189,52,6.6,False,25.03611666666667,3141,8,1,299,241,58
BR1_2730244267,10,True,0,1,0,17368,209,60,7.2,False,6,False,1,0,0,16686,216,54,6.8,True,25.005216666666666,682,4,-1,269,270,-1
BR1_2726969510,8,True,0,0,0,16768,211,64,7.2,True,4,False,1,1,0,15374,213,52,7.0,False,26.716316666666668,1394,4,-1,275,265,10
BR1_2726941709,14,False,1,1,0,20983,198,64,7.2,False,17,True,0,0,0,22852,226,55,7.4,True,29.3304,-1869,-3,1,262,281,-19
BR1_2731837829,4,False,1,0,0,15163,206,48,6.8,False,4,True,0,1,0,15210,222,52,6.6,True,27.15415,-47,0,1,254,274,-20
BR1_2731230709,4,False,0,0,0,15497,212,64,7.0,False,4,True,0,0,0,15938,256,56,7.4,True,26.064566666666668,-441,0,0,276,312,-36
BR1_2730631714,12,True,0,0,0,21693,260,63,7.8,True,7,False,0,0,0,17040,232,52,7.0,False,27.621433333333332,4653,5,0,323,284,39
BR1_2730569473,7,True,0,1,0,16966,233,60,6.8,False,6,False,1,0,0,16854,209,48,6.6,True,26.921516666666665,112,1,-1,293,257,36
BR1_2726271405,12,False,0,0,0,19159,206,56,7.0,True,2,True,0,0,0,13860,183,52,6.6,False,27.358616666666666,5299,10,0,262,235,27
BR1_2726241169,8,True,0,0,0,18706,242,52,7.4,True,7,False,1,1,0,17617,192,54,7.2,False,28.70765,1089,1,-1,294,246,48
BR1_2731640010,8,True,0,0,0,17608,213,62,6.8,True,7,False,1,0,0,16695,201,52,6.6,False,25.08495,913,1,-1,275,253,22
BR1_2731617558,5,True,0,0,0,15684,217,51,6.6,False,5,False,1,0,0,16019,200,72,6.8,True,25.61403333333333,-335,0,-1,268,272,-4
BR1_2731603043,7,False,1,1,0,19387,247,62,7.6,True,7,True,0,0,0,18224,225,56,7.2,False,27.767683333333334,1163,0,1,309,281,28
BR1_2724407054,7,True,0,1,0,18265,225,60,7.4,True,3,False,0,0,0,14822,220,47,6.8,False,25.391116666666665,3443,4,0,285,267,18
BR1_2724386880,9,True,1,0,0,17458,176,56,6.8,True,12,False,0,0,0,18705,202,60,6.6,False,25.20405,-1247,-3,1,232,262,-30
BR1_2726378550,9,True,0,0,0,18640,210,36,7.0,True,6,False,0,0,0,15901,203,64,6.8,False,26.7528,2739,3,0,246,267,-21
BR1_2726350456,6,True,1,0,0,16554,228,59,7.2,False,1,False,0,1,0,14355,216,48,7.2,True,27.147966666666665,2199,5,1,287,264,23
BR1_2725760232,6,True,0,1,0,16536,219,40,6.8,True,5,False,1,0,0,16859,233,68,7.0,False,26.440816666666667,-323,1,-1,259,301,-42
BR1_2731533888,7,True,0,0,0,16961,166,52,6.6,False,12,False,1,0,0,19981,215,52,7.6,True,28.0408,-3020,-5,-1,218,267,-49
BR1_2731094622,5,True,0,0,0,15002,204,48,6.6,False,8,False,1,0,0,16647,179,60,7.0,True,26.718533333333333,-1645,-3,-1,252,239,13
BR1_2725333903,11,True,0,0,0,20573,246,55,7.8,False,8,False,1,0,0,19326,257,64,7.6,True,27.64603333333333,1247,3,-1,301,321,-20
BR1_2722283604,7,False,0,1,0,18923,226,72,7.2,False,6,True,1,0,0,18480,279,60,7.4,True,29.417183333333334,443,1,-1,298,339,-41
BR1_2721687776,6,True,0,0,0,15868,202,43,6.6,False,6,False,0,0,0,17490,238,48,7.0,True,25.499566666666666,-1622,0,0,245,286,-41
BR1_2731029845,6,False,1,0,0,17213,211,56,7.2,False,5,True,0,0,0,17983,251,51,7.2,True,28.11995,-770,1,1,267,302,-35
BR1_2731797400,5,False,0,0,0,15768,211,44,6.8,False,7,True,1,0,0,17233,242,47,7.0,True,26.63505,-1465,-2,-1,255,289,-34
BR1_2724923405,8,False,1,1,0,19111,233,66,7.2,False,10,True,0,0,0,20379,238,52,7.6,True,28.059183333333333,-1268,-2,1,299,290,9
BR1_2724862973,6,True,1,0,0,17638,222,59,7.2,False,4,False,0,1,0,17687,252,72,7.4,True,27.923816666666667,-49,2,1,281,324,-43
BR1_2724155591,4,False,0,0,0,14484,149,40,6.2,False,13,True,1,0,0,20681,210,61,7.0,True,25.13795,-6197,-9,-1,189,271,-82
BR1_2730163344,3,False,0,0,0,16395,237,48,7.2,False,10,True,1,0,0,20567,282,80,8.0,True,29.576066666666666,-4172,-7,-1,285,362,-77
BR1_2730027904,6,True,0,1,0,17173,265,52,6.6,True,2,False,1,0,0,14370,208,72,6.6,False,26.70695,2803,4,-1,317,280,37
BR1_2729561008,5,False,0,0,0,17142,228,68,7.4,False,6,True,0,1,0,17909,226,68,7.4,True,29.690183333333334,-767,-1,0,296,294,2
BR1_2730163877,7,False,0,1,1,20007,253,60,7.6,False,12,True,1,0,0,20286,221,63,7.4,True,29.29965,-279,-5,-1,313,284,29
BR1_2730136961,8,False,0,0,0,17577,189,60,7.0,False,16,True,1,0,0,22088,258,48,7.6,True,27.73,-4511,-8,-1,249,306,-57
BR1_2731908507,6,True,0,0,0,15799,175,56,6.6,False,8,False,1,0,0,17211,191,51,6.6,True,25.92685,-1412,-2,-1,231,242,-11
BR1_2728575776,6,True,0,0,0,16948,198,56,6.8,False,9,False,1,0,0,17058,178,64,6.6,True,26.995366666666666,-110,-3,-1,254,242,12
BR1_2731801868,1,False,0,0,0,13861,198,55,6.8,False,4,True,1,1,0,15632,199,60,7.2,True,25.517833333333332,-1771,-3,-1,253,259,-6
BR1_2731783110,5,False,0,1,0,15465,177,64,6.8,False,10,True,1,0,0,17589,206,43,7.0,True,26.183833333333332,-2124,-5,-1,241,249,-8
BR1_2731681847,16,True,1,1,0,21474,239,56,7.8,True,8,False,0,0,0,17834,207,60,6.8,False,28.99615,3640,8,1,295,267,28
BR1_2731938237,6,False,0,0,0,16823,196,54,7.0,False,4,True,1,0,0,17583,266,54,7.2,True,27.639733333333332,-760,2,-1,250,320,-70
BR1_2731316828,0,False,0,0,0,13307,199,58,6.4,False,6,True,1,0,0,17626,242,56,6.8,True,25.8006,-4319,-6,-1,257,298,-41
BR1_2695034659,4,False,1,1,0,15099,176,56,6.8,True,4,True,0,0,0,15011,186,60,7.0,False,25.11395,88,0,1,232,246,-14
BR1_2730137814,9,False,0,0,0,16763,219,36,6.2,True,4,True,0,0,0,14144,173,48,6.4,False,25.864216666666668,2619,5,0,255,221,34
BR1_2730322000,7,False,0,1,0,15201,146,30,6.2,False,6,True,0,0,0,15708,208,62,6.8,True,26.974866666666667,-507,1,0,176,270,-94
BR1_2730704739,11,True,1,0,0,20667,225,52,7.6,True,10,False,0,1,0,19005,220,56,7.4,False,27.6972,1662,1,1,277,276,1
BR1_2731916735,7,True,1,0,0,17430,206,45,7.0,False,9,False,0,1,0,19952,238,74,7.6,True,28.09026666666667,-2522,-2,1,251,312,-61
BR1_2731901622,8,True,0,0,0,18792,252,64,7.6,False,6,False,1,0,0,18062,245,72,7.6,True,29.365066666666667,730,2,-1,316,317,-1
BR1_2731255083,7,True,0,0,0,18358,226,56,7.4,True,12,False,1,1,0,20230,228,56,7.2,False,29.43435,-1872,-5,-1,282,284,-2
BR1_2731227271,10,True,0,1,0,19968,240,48,7.6,False,8,False,1,0,0,19283,219,62,7.2,True,28.958733333333335,685,2,-1,288,281,7
BR1_2722355449,6,False,1,0,0,16663,189,48,7.0,True,9,True,0,1,0,18347,200,64,7.2,False,25.436116666666667,-1684,-3,1,237,264,-27
BR1_2731286308,4,False,0,0,0,15455,207,60,6.6,False,7,True,1,0,0,15886,192,55,6.8,True,27.095983333333333,-431,-3,-1,267,247,20
BR1_2728714677,3,False,0,0,0,15082,199,52,6.6,True,7,True,0,0,0,16297,212,56,7.0,False,26.14,-1215,-4,0,251,268,-17
BR1_2729944469,3,False,0,0,0,14456,194,48,6.8,False,6,True,1,0,0,16272,195,64,6.8,True,26.247683333333335,-1816,-3,-1,242,259,-17
BR1_2729903259,7,True,0,0,0,16584,221,47,6.8,True,7,False,1,0,0,16946,227,60,6.8,False,27.2448,-362,0,-1,268,287,-19
BR1_2706838491,4,True,0,0,0,14976,177,56,6.4,False,9,False,1,1,0,17192,205,52,6.8,True,27.441116666666666,-2216,-5,-1,233,257,-24
BR1_2730455027,14,False,1,0,0,20456,215,52,6.8,False,10,True,0,1,0,19021,191,52,6.6,True,28.640666666666668,1435,4,1,267,243,24
BR1_2729300288,6,False,0,1,0,17980,230,52,7.2,True,9,True,1,0,0,19029,225,55,7.2,False,29.903433333333332,-1049,-3,-1,282,280,2
BR1_2728170626,7,False,1,1,0,19041,210,68,7.8,True,7,True,0,0,0,17704,229,60,7.2,False,29.106033333333333,1337,0,1,278,289,-11
BR1_2728159119,4,True,0,0,0,16651,220,68,7.4,False,3,False,1,0,0,15713,218,60,7.2,True,28.416316666666667,938,1,-1,288,278,10
BR1_2702029311,11,True,1,1,0,18345,184,54,7.0,True,4,False,0,0,0,15777,195,56,6.4,False,25.689833333333333,2568,7,1,238,251,-13
BR1_2731506232,1,False,0,0,0,13191,176,59,6.4,False,9,True,1,0,0,16674,211,44,6.8,True,25.363233333333334,-3483,-8,-1,235,255,-20
BR1_2731833637,11,True,0,0,0,20671,247,60,7.6,False,5,False,1,0,0,15271,150,52,6.8,True,27.556183333333333,5400,6,-1,307,202,105
BR1_2731036397,5,True,0,0,0,15664,208,44,6.6,False,8,False,1,1,0,17247,189,64,6.6,True,26.33341666666667,-1583,-3,-1,252,253,-1
BR1_2730789809,5,False,0,1,0,17741,251,75,7.6,False,9,True,1,0,0,19407,252,60,7.6,True,27.6722,-1666,-4,-1,326,312,14
BR1_2731622645,13,False,1,0,0,20751,184,56,6.8,False,12,True,0,0,0,20784,243,48,7.0,True,28.190833333333334,-33,1,1,240,291,-51
BR1_2731553786,9,False,0,1,0,17983,217,40,6.6,True,11,True,1,0,0,17760,156,64,7.0,False,25.80035,223,-2,-1,257,220,37
BR1_2731541897,10,True,0,0,0,18094,195,56,7.0,True,8,False,0,0,0,17519,211,52,7.0,False,27.152833333333334,575,2,0,251,263,-12
BR1_2731091019,7,False,1,1,0,17566,217,59,7.4,False,14,True,0,0,0,22084,258,64,7.8,True,29.989683333333332,-4518,-7,1,276,322,-46
BR1_2727293901,4,False,0,1,0,17618,241,59,7.4,False,6,True,1,0,0,17726,203,60,7.4,True,29.711433333333332,-108,-2,-1,300,263,37
BR1_2730129990,10,False,1,0,0,19926,221,36,7.0,True,6,True,0,1,0,17336,212,68,7.2,False,29.40375,2590,4,1,257,280,-23
BR1_2729839394,4,False,0,0,1,17149,221,24,7.2,True,13,True,1,1,0,20271,217,64,7.2,False,28.237433333333332,-3122,-9,-1,245,281,-36
BR1_2731676130,11,True,1,0,0,18988,204,64,7.2,False,15,False,0,0,0,22378,238,52,7.8,True,27.645983333333334,-3390,-4,1,268,290,-22
BR1_2731644840,6,False,0,0,0,17736,240,58,7.4,False,6,True,1,0,0,17716,237,57,7.2,True,28.470716666666668,20,0,-1,298,294,4
BR1_2731601674,4,False,0,0,0,14936,195,40,6.6,False,10,True,1,1,0,19043,215,56,7.2,True,26.59235,-4107,-6,-1,235,271,-36
BR1_2684875572,8,True,1,0,0,16375,175,56,6.6,True,6,False,0,0,0,15687,162,52,7.0,False,27.220333333333333,688,2,1,231,214,17
BR1_2681516984,13,True,0,1,0,20818,236,40,7.6,False,6,False,0,0,0,18608,228,56,7.6,True,28.728983333333332,2210,7,0,276,284,-8
BR1_2681513695,15,True,0,0,0,21406,202,59,7.6,False,12,False,1,0,0,20796,222,72,7.8,True,28.057033333333333,610,3,-1,261,294,-33
BR1_2713975274,7,True,0,0,0,18618,203,47,7.0,True,15,False,1,0,0,20865,224,44,7.4,False,29.7744,-2247,-8,-1,250,268,-18
BR1_2723696365,12,True,1,0,0,20123,249,48,7.4,True,11,False,0,0,0,18671,205,48,7.0,False,29.702083333333334,1452,1,1,297,253,44
BR1_2723676711,6,True,0,0,0,16311,215,60,6.4,False,11,False,1,0,0,18035,184,72,6.8,True,26.49245,-1724,-5,-1,275,256,19
BR1_2723655432,11,True,1,0,0,19322,215,40,7.2,True,13,False,0,1,0,20389,208,55,7.2,False,29.673066666666667,-1067,-2,1,255,263,-8
BR1_2723621318,6,False,1,0,0,16734,197,52,6.4,False,12,True,0,1,0,19169,193,56,6.6,True,26.844916666666666,-2435,-6,1,249,249,0
BR1_2731817377,6,False,1,1,0,17653,209,60,7.6,True,8,True,0,0,0,17590,228,48,7.0,False,28.21775,63,-2,1,269,276,-7
BR1_2731798522,6,False,0,0,0,16787,199,64,7.4,True,6,True,0,0,0,16760,204,44,6.8,False,26.912033333333333,27,0,0,263,248,15
BR1_2731298044,7,True,1,0,0,17765,188,56,7.4,True,6,False,0,0,0,17599,224,56,6.8,False,28.268066666666666,166,1,1,244,280,-36
BR1_2717666253,4,False,0,0,0,16354,232,64,7.0,False,5,True,0,0,0,17021,264,52,7.0,True,26.85585,-667,-1,0,296,316,-20
BR1_2716021049,10,False,0,0,0,18309,211,56,6.8,False,11,True,1,0,0,17181,154,48,6.6,True,27.1521,1128,-1,-1,267,202,65
BR1_2715975131,10,True,1,0,0,20137,246,76,7.2,True,10,False,0,1,0,18164,206,41,7.0,False,29.217283333333334,1973,0,1,322,247,75
BR1_2726340484,7,False,0,0,0,18090,217,52,7.4,True,10,True,0,1,0,19596,239,48,7.4,False,29.133483333333334,-1506,-3,0,269,287,-18
BR1_2721943000,2,False,1,0,0,14798,195,56,6.8,False,3,True,0,1,0,16694,247,64,7.2,True,29.9624,-1896,-1,1,251,311,-60
BR1_2721572934,9,False,1,0,0,17412,211,56,7.0,True,8,True,0,0,0,16959,203,43,6.8,False,25.690433333333335,453,1,1,267,246,21
BR1_2708909515,6,False,0,0,0,18008,216,56,7.2,False,18,True,1,1,0,23307,234,68,7.8,True,27.665433333333333,-5299,-12,-1,272,302,-30
BR1_2708873321,7,False,0,0,0,17753,217,40,6.4,False,14,True,1,0,0,20474,183,44,7.0,True,29.3833,-2721,-7,-1,257,227,30
BR1_2708857704,11,True,0,0,0,17796,220,38,7.0,True,5,False,0,0,0,14934,195,41,7.0,False,26.446866666666665,2862,6,0,258,236,22
BR1_2731744179,6,True,1,0,0,17620,216,64,7.0,False,10,False,0,0,0,18450,216,56,7.2,True,27.9221,-830,-4,1,280,272,8
BR1_2731718406,8,False,1,0,0,18203,208,76,7.0,True,4,True,0,0,0,15388,197,36,6.6,False,27.458116666666665,2815,4,1,284,233,51
BR1_2730635300,9,False,0,0,0,16937,203,56,7.0,False,4,True,1,0,0,15129,207,40,6.6,True,26.75155,1808,5,-1,259,247,12
BR1_2730605428,7,False,0,0,0,15807,193,48,6.6,True,8,True,1,1,0,18418,221,64,7.4,False,25.448433333333334,-2611,-1,-1,241,285,-44
BR1_2729428370,4,True,0,1,0,14980,192,48,6.8,False,5,False,0,0,0,15968,211,44,6.6,True,26.76565,-988,-1,0,240,255,-15
BR1_2731905959,4,True,1,1,0,17505,271,56,7.4,True,1,False,0,0,0,15654,251,60,7.4,False,28.90135,1851,3,1,327,311,16
BR1_2731430995,11,False,1,1,0,20801,239,60,7.2,True,12,True,0,0,0,20445,235,56,7.6,False,29.442533333333333,356,-1,1,299,291,8
BR1_2723104943,8,True,1,0,0,17069,214,30,7.0,False,12,False,0,1,0,20339,211,62,7.4,True,27.74513333333333,-3270,-4,1,244,273,-29
BR1_2731640492,9,True,0,1,0,20150,261,55,7.8,True,6,False,0,0,0,18211,233,60,7.2,False,28.667316666666668,1939,3,0,316,293,23
BR1_2731614175,3,True,0,0,0,15892,231,56,7.4,False,2,False,1,1,0,15654,230,63,7.2,True,27.618016666666666,238,1,-1,287,293,-6
BR1_2731171769,4,False,0,1,1,17024,246,52,7.6,False,8,True,0,0,0,21215,280,60,7.6,True,28.174766666666667,-4191,-4,0,298,340,-42
BR1_2731150220,6,True,1,0,0,17548,222,65,7.2,True,5,False,0,0,0,17012,205,75,7.4,False,29.093583333333335,536,1,1,287,280,7
BR1_2698288892,5,False,1,0,0,17014,209,64,7.0,False,9,True,0,0,1,19707,239,44,7.4,True,27.763516666666668,-2693,-4,1,273,283,-10
BR1_2698254041,8,True,1,0,0,16499,204,54,7.0,False,6,False,0,0,0,16566,233,54,7.2,True,26.061766666666667,-67,2,1,258,287,-29
BR1_2731343088,2,False,0,1,0,16085,189,68,7.0,False,10,True,1,0,0,18576,199,44,7.2,True,28.97895,-2491,-8,-1,257,243,14
BR1_2725485489,8,False,0,0,0,16682,168,50,6.6,False,13,True,0,0,0,19993,211,41,6.8,True,25.390483333333332,-3311,-5,0,218,252,-34
BR1_2725093661,4,False,0,0,0,14376,186,52,6.6,False,13,True,0,0,0,18478,201,44,7.0,True,26.61725,-4102,-9,0,238,245,-7
BR1_2699791319,6,True,0,0,0,15735,164,52,6.6,False,8,False,0,0,0,17864,202,64,7.2,True,25.0771,-2129,-2,0,216,266,-50
BR1_2731586544,6,True,0,0,0,15770,202,54,6.8,False,7,False,1,0,0,16528,181,54,7.0,True,27.014966666666666,-758,-1,-1,256,235,21
BR1_2731478934,2,True,0,0,0,15580,194,56,6.8,False,17,False,1,1,0,21783,226,55,7.8,True,28.668266666666668,-6203,-15,-1,250,281,-31
BR1_2730853046,13,True,0,0,0,19660,198,40,6.4,True,6,False,0,1,0,15735,149,68,6.2,False,25.743866666666666,3925,7,0,238,217,21
BR1_2731741171,10,False,0,0,0,18304,212,56,6.8,False,9,True,1,0,0,16491,171,34,6.6,True,26.083316666666665,1813,1,-1,268,205,63
BR1_2729807054,8,True,1,1,0,18345,226,73,7.2,True,4,False,0,0,0,14973,187,62,6.8,False,27.1389,3372,4,1,299,249,50
BR1_2729793856,7,False,1,1,0,16535,215,68,7.0,True,2,True,0,0,0,14781,220,56,6.4,False,26.00245,1754,5,1,283,276,7
BR1_2729771438,8,False,1,0,0,16056,134,64,6.4,True,8,True,0,1,0,17158,219,52,6.6,False,27.491333333333333,-1102,0,1,198,271,-73
BR1_2726065955,10,True,0,0,0,19498,241,52,7.0,False,9,False,0,1,0,19219,208,60,7.2,True,29.26665,279,1,0,293,268,25
BR1_2731687735,10,True,0,1,0,20498,213,64,7.4,True,6,False,0,0,0,18016,238,60,7.0,False,28.582216666666667,2482,4,0,277,298,-21
BR1_2731664345,6,True,0,0,0,18319,197,62,7.0,False,11,False,1,0,0,20267,233,76,7.8,True,28.328216666666666,-1948,-5,-1,259,309,-50
BR1_2730779893,6,True,1,0,0,16453,203,68,7.0,False,8,False,0,1,0,17441,191,52,6.8,True,27.2223,-988,-2,1,271,243,28
BR1_2725079857,9,True,1,0,0,19083,250,60,7.6,False,7,False,0,1,1,19539,220,60,7.2,True,28.6622,-456,2,1,310,280,30
BR1_2724222114,12,True,0,0,0,20036,222,54,7.4,True,9,False,1,0,0,18638,190,60,7.0,False,28.739483333333332,1398,3,-1,276,250,26
BR1_2718573962,5,False,0,0,0,15280,184,44,6.6,False,7,True,1,0,0,16426,208,64,6.8,True,27.2645,-1146,-2,-1,228,272,-44
BR1_2716628611,10,False,0,1,0,19597,238,48,6.8,True,9,True,1,0,0,19079,208,44,7.2,False,27.6707,518,1,-1,286,252,34
BR1_2730833423,8,False,0,1,0,19235,236,64,7.4,True,9,True,0,0,0,18251,191,42,7.2,False,29.60246666666667,984,-1,0,300,233,67
BR1_2718941671,9,True,1,0,0,19483,261,60,7.6,False,6,False,1,0,0,17431,241,52,7.2,True,29.611233333333335,2052,3,0,321,293,28
BR1_2731626949,10,True,0,0,0,17447,175,56,6.8,True,10,False,1,0,0,18159,207,48,6.8,False,26.163966666666667,-712,0,-1,231,255,-24
BR1_2721650411,11,True,1,0,0,17982,211,48,7.4,True,4,False,0,0,0,15146,193,52,6.8,False,27.007266666666666,2836,7,1,259,245,14
BR1_2716184291,11,True,0,0,0,20545,267,56,7.6,True,7,False,1,0,0,18840,234,64,7.4,False,29.1395,1705,4,-1,323,298,25
BR1_2731800712,6,True,0,0,0,17408,184,48,7.0,False,9,False,0,0,0,19664,274,72,7.6,True,28.995033333333332,-2256,-3,0,232,346,-114
BR1_2730853821,8,True,0,0,0,18083,241,45,6.8,False,10,False,1,0,0,20665,235,74,7.8,True,28.283916666666666,-2582,-2,-1,286,309,-23
BR1_2729955595,9,True,1,0,0,18423,223,55,7.0,True,5,False,0,1,0,16812,222,80,7.6,False,29.649233333333335,1611,4,1,278,302,-24
BR1_2731383610,5,True,0,0,0,16389,223,68,7.4,False,4,False,1,0,0,17745,257,68,8.0,True,29.379633333333334,-1356,1,-1,291,325,-34
BR1_2731074611,8,False,0,1,0,17388,188,44,7.0,False,11,True,1,0,0,18239,184,60,7.0,True,27.4623,-851,-3,-1,232,244,-12
BR1_2727762509,7,False,0,1,0,16761,206,48,6.8,False,9,True,1,0,0,18472,221,52,7.0,True,26.9804,-1711,-2,-1,254,273,-19
BR1_2727396929,4,False,1,0,0,15288,205,52,6.6,True,7,True,0,1,0,17456,241,64,7.0,False,27.396283333333333,-2168,-3,1,257,305,-48
BR1_2731051294,7,True,1,0,0,16444,204,64,7.2,False,10,False,0,0,0,20234,254,48,7.4,True,28.10435,-3790,-3,1,268,302,-34
BR1_2731630325,7,True,0,0,0,18822,281,78,7.6,True,6,False,0,0,0,17628,277,40,7.2,False,29.659833333333335,1194,1,0,359,317,42
BR1_2726161749,10,False,0,1,0,18798,231,56,7.4,True,8,True,0,0,0,19133,243,56,7.4,False,27.73285,-335,2,0,287,299,-12
BR1_2726142177,5,True,0,0,0,17836,250,68,7.2,False,6,False,1,1,0,19227,263,64,7.6,True,28.48185,-1391,-1,-1,318,327,-9
BR1_2727701502,13,True,0,0,0,18717,212,48,7.0,True,1,False,0,0,0,13401,173,44,6.6,False,26.413083333333333,5316,12,0,260,217,43
BR1_2730149060,6,True,0,1,0,18391,233,56,7.2,False,9,False,1,0,0,17744,211,60,7.4,True,28.162816666666668,647,-3,-1,289,271,18
BR1_2722150792,7,False,1,1,0,17397,194,64,7.0,True,9,True,0,0,0,18819,227,52,7.2,False,28.189266666666665,-1422,-2,1,258,279,-21
BR1_2722132652,8,True,0,0,0,18417,201,56,7.2,False,16,False,1,0,0,22153,266,64,7.6,True,29.503866666666667,-3736,-8,-1,257,330,-73
BR1_2722121301,10,True,0,0,0,17991,208,52,6.8,False,8,False,1,0,0,17534,196,64,7.0,True,26.392566666666667,457,2,-1,260,260,0
BR1_2721932516,8,True,0,1,0,19280,258,50,7.4,False,9,False,1,0,0,19608,233,56,7.4,True,27.809616666666667,-328,-1,-1,308,289,19
BR1_2731153047,7,False,0,0,0,18318,237,48,7.4,False,8,True,1,1,0,19970,256,72,7.8,True,28.071116666666665,-1652,-1,-1,285,328,-43
BR1_2731461147,13,True,0,0,0,20681,226,76,7.6,True,4,False,0,0,0,16476,200,52,6.8,False,28.005316666666666,4205,9,0,302,252,50
BR1_2723782146,4,False,0,1,0,16137,235,48,7.0,True,7,True,1,0,0,17603,248,60,7.2,False,25.408016666666665,-1466,-3,-1,283,308,-25
BR1_2729755581,7,True,1,0,0,18562,219,60,7.4,False,7,False,0,0,0,18951,279,60,7.4,True,29.875766666666667,-389,0,1,279,339,-60
BR1_2729681197,5,True,0,0,0,15889,204,52,6.8,False,5,False,0,0,0,16204,210,67,7.0,True,25.34935,-315,0,0,256,277,-21
BR1_2730709144,6,False,0,0,0,17082,208,56,7.2,True,12,True,1,0,0,20024,253,52,7.6,False,29.244833333333332,-2942,-6,-1,264,305,-41
BR1_2729381557,3,True,0,1,0,15917,197,80,6.6,False,8,False,1,0,0,16533,175,47,6.6,True,27.2293,-616,-5,-1,277,222,55
BR1_2731917457,7,False,0,0,0,18437,242,56,7.4,False,9,True,1,1,1,20274,244,52,7.2,True,29.139733333333332,-1837,-2,-1,298,296,2
BR1_2731577720,5,False,1,0,0,15735,199,56,6.8,True,4,True,0,1,0,15530,188,64,6.8,False,27.377566666666667,205,1,1,255,252,3
BR1_2731182537,4,False,0,1,0,16241,224,51,7.0,True,7,True,0,0,0,17154,199,48,7.4,False,27.7212,-913,-3,0,275,247,28
BR1_2731670884,4,True,0,1,0,17834,239,64,7.4,False,6,False,1,0,0,17812,236,79,7.6,True,29.9409,22,-2,-1,303,315,-12
BR1_2728515942,6,False,1,0,0,17124,226,52,7.2,False,4,True,0,0,0,16551,214,59,7.2,True,29.454483333333332,573,2,1,278,273,5
BR1_2728455445,5,True,1,0,0,15492,171,56,6.6,False,10,False,0,1,0,18279,210,56,7.2,True,27.060766666666666,-2787,-5,1,227,266,-39
BR1_2707356355,7,True,0,0,1,17196,203,53,6.8,True,6,False,1,0,0,19117,246,56,7.2,False,28.060283333333334,-1921,1,-1,256,302,-46
BR1_2686664768,8,False,0,1,0,15547,155,52,6.4,False,8,True,0,0,0,18002,197,64,6.8,True,25.205183333333334,-2455,0,0,207,261,-54
BR1_2682946079,5,False,0,0,0,15299,201,48,6.8,False,5,True,1,1,0,16036,210,68,7.0,True,26.062533333333334,-737,0,-1,249,278,-29
BR1_2728907169,7,True,1,1,0,16571,185,46,7.0,True,6,False,0,0,0,16786,252,50,6.6,False,26.8066,-215,1,1,231,302,-71
BR1_2724868381,7,False,0,0,0,17700,209,56,7.2,False,11,True,1,0,0,19033,224,52,7.4,True,29.240016666666666,-1333,-4,-1,265,276,-11
BR1_2731870572,9,False,0,0,0,19529,220,58,7.0,False,13,True,1,0,0,20383,228,56,7.4,True,27.679083333333335,-854,-4,-1,278,284,-6
BR1_2731860801,3,True,0,1,0,14594,192,48,6.2,False,13,False,1,0,0,18257,190,64,7.0,True,25.616966666666666,-3663,-10,-1,240,254,-14
BR1_2731842292,14,True,0,0,1,21177,225,68,7.6,True,4,False,0,0,0,15078,169,52,6.8,False,27.077466666666666,6099,10,0,293,221,72
BR1_2731162931,11,True,1,1,1,22926,229,68,7.2,True,6,False,0,0,0,17009,207,52,7.0,False,29.65435,5917,5,1,297,259,38
BR1_2730492056,17,True,1,0,1,23084,239,56,7.4,True,8,False,0,0,0,18176,188,52,7.0,False,28.076116666666667,4908,9,1,295,240,55
BR1_2731671128,7,False,1,0,0,17166,224,63,7.2,False,4,True,0,0,0,14872,208,52,7.0,True,27.343283333333332,2294,3,1,287,260,27
BR1_2724894071,15,True,1,1,0,22234,226,56,7.6,True,5,False,0,0,0,17162,244,60,7.6,False,28.040683333333334,5072,10,1,282,304,-22
BR1_2731867491,10,False,1,1,0,19791,247,72,7.4,False,9,True,0,0,0,19604,233,72,7.6,True,28.835416666666667,187,1,1,319,305,14
BR1_2708232813,13,False,1,0,0,20382,198,68,7.4,True,10,True,0,1,0,19847,209,52,7.2,False,29.932833333333335,535,3,1,266,261,5
BR1_2731791512,8,True,0,0,0,19204,228,52,7.4,True,11,False,1,0,0,20984,266,64,7.4,False,28.041783333333335,-1780,-3,-1,280,330,-50
BR1_2731265969,6,True,0,1,0,18361,244,64,7.2,True,6,False,1,0,0,19097,262,60,7.6,False,29.183566666666668,-736,0,-1,308,322,-14
BR1_2725293446,8,True,1,0,0,19015,258,48,7.2,False,6,False,0,1,0,17621,246,65,7.2,True,28.280483333333333,1394,2,1,306,311,-5
BR1_2731923825,4,False,0,1,1,19806,274,76,7.8,False,4,True,1,0,0,16389,222,48,7.2,True,28.096766666666667,3417,0,-1,350,270,80
BR1_2731917789,7,True,0,0,0,16992,195,39,6.6,False,6,False,1,0,0,16467,236,53,6.8,True,25.923583333333333,525,1,-1,234,289,-55
BR1_2717119925,10,False,0,0,0,17839,196,44,6.4,True,9,True,1,0,0,17187,184,48,7.0,False,27.43575,652,1,-1,240,232,8
BR1_2716892334,8,True,1,1,0,19552,243,56,7.0,True,8,False,0,0,0,18975,232,60,7.4,False,29.11405,577,0,1,299,292,7
BR1_2710878229,9,True,0,0,0,18216,195,48,7.2,False,9,False,0,0,0,18982,212,48,7.4,True,28.287266666666667,-766,0,0,243,260,-17
BR1_2731649128,6,False,0,0,0,17060,206,59,7.0,True,7,True,1,0,0,15477,173,47,6.8,False,26.956683333333334,1583,-1,-1,265,220,45
BR1_2731114463,4,False,1,1,0,16019,214,56,7.0,True,6,True,0,0,0,16247,188,68,6.8,False,26.628966666666667,-228,-2,1,270,256,14
BR1_2731165456,10,True,1,0,0,18847,200,72,7.0,True,8,False,0,0,0,16781,153,52,6.6,False,25.836466666666666,2066,2,1,272,205,67
BR1_2700165507,16,True,1,0,0,21429,250,64,7.6,False,6,False,0,0,0,18440,199,51,7.2,True,27.50045,2989,10,1,314,250,64
BR1_2700089425,12,True,0,1,0,19318,199,44,6.8,False,5,False,0,0,0,16058,187,60,6.4,True,27.477833333333333,3260,7,0,243,247,-4
BR1_2731760695,6,True,0,1,0,16918,229,48,7.4,False,8,False,1,0,0,19689,269,52,7.6,True,27.72645,-2771,-2,-1,277,321,-44
BR1_2731763780,10,True,0,0,0,19509,211,60,7.2,False,12,False,1,1,0,20345,199,52,7.2,True,29.244533333333333,-836,-2,-1,271,251,20
BR1_2730738229,8,False,1,0,0,17142,203,60,6.6,True,5,True,0,0,0,15367,196,56,6.6,False,26.849733333333333,1775,3,1,263,252,11
BR1_2727517811,12,False,1,0,0,19428,209,42,6.8,True,11,True,0,0,0,18824,196,60,6.8,False,29.39405,604,1,1,251,256,-5
BR1_2722311684,6,False,1,0,0,16098,205,64,7.2,True,4,True,0,1,0,15770,201,60,7.0,False,26.709433333333333,328,2,1,269,261,8
BR1_2731743249,6,True,0,1,0,17071,189,56,6.6,False,5,False,0,0,0,15504,202,56,6.6,True,27.456233333333333,1567,1,0,245,258,-13
BR1_2731693282,5,False,0,1,0,17129,231,60,6.8,False,8,True,1,0,0,18097,225,56,7.2,True,29.6959,-968,-3,-1,291,281,10
BR1_2731467442,10,True,1,1,0,18052,235,61,7.0,True,8,False,0,0,0,16895,171,40,6.6,False,25.226433333333333,1157,2,1,296,211,85
BR1_2730989013,4,False,0,0,0,16229,198,60,7.4,True,5,True,1,0,0,17937,244,56,7.2,False,28.48735,-1708,-1,-1,258,300,-42
BR1_2729315378,8,True,1,0,0,16059,205,43,6.8,False,6,False,0,0,0,16308,192,48,6.4,True,26.9227,-249,2,1,248,240,8
BR1_2730479579,8,False,0,0,0,18817,244,50,7.0,False,11,True,1,0,0,20332,257,50,7.4,True,28.69386666666667,-1515,-3,-1,294,307,-13
BR1_2715387428,2,False,1,1,0,13831,179,52,6.4,False,6,True,0,0,0,16145,210,64,7.0,True,26.578483333333335,-2314,-4,1,231,274,-43
BR1_2713672000,7,True,1,0,0,16420,191,56,6.8,True,4,False,0,0,0,15459,206,68,7.2,False,25.356,961,3,1,247,274,-27
BR1_2713121264,3,False,0,0,0,13916,188,60,6.8,False,6,True,1,0,0,17420,213,60,6.8,True,26.672533333333334,-3504,-3,-1,248,273,-25
BR1_2729579899,4,False,1,1,0,15861,189,60,7.4,True,11,True,0,0,0,20098,211,52,7.6,False,28.251133333333332,-4237,-7,1,249,263,-14
BR1_2729423674,12,True,1,0,0,20677,213,61,7.4,False,11,False,0,0,0,19126,233,38,7.2,True,29.070333333333334,1551,1,1,274,271,3
BR1_2731572940,7,False,0,0,0,18459,215,56,6.8,False,7,True,1,0,0,17411,187,64,7.0,True,28.5013,1048,0,-1,271,251,20
BR1_2730632341,2,False,0,1,0,14255,200,52,7.0,True,6,True,1,0,0,16004,171,52,6.8,False,27.214316666666665,-1749,-4,-1,252,223,29
BR1_2727513468,6,False,1,1,0,17026,227,56,6.8,False,8,True,0,0,0,17402,204,72,7.0,True,27.303633333333334,-376,-2,1,283,276,7
BR1_2731422885,11,True,0,0,0,21143,231,67,7.6,True,6,False,0,1,0,17241,224,52,7.2,False,28.109183333333334,3902,5,0,298,276,22
BR1_2731843835,9,True,1,1,0,17422,191,64,6.8,True,6,False,0,0,0,16605,216,62,6.6,False,25.232333333333333,817,3,1,255,278,-23
BR1_2731507540,8,True,1,1,0,18451,226,60,7.4,False,10,False,0,0,0,19230,214,67,7.8,True,28.1496,-779,-2,1,286,281,5
BR1_2731525904,11,False,1,0,0,19283,220,28,6.6,False,10,True,0,0,1,20716,221,68,7.6,True,27.729,-1433,1,1,248,289,-41
BR1_2731934009,7,False,0,0,0,18209,236,60,7.6,False,8,True,0,0,0,19422,239,56,7.4,True,28.943083333333334,-1213,-1,0,296,295,1
BR1_2724802360,10,False,0,0,0,19975,250,52,7.4,True,8,True,1,0,0,18877,228,68,7.4,False,27.906666666666666,1098,2,-1,302,296,6
BR1_2731167300,13,True,0,0,0,18980,211,52,7.2,True,10,False,0,0,0,17073,190,48,6.6,False,25.772433333333332,1907,3,0,263,238,25
BR1_2701787877,3,False,0,0,0,13771,156,47,6.2,False,11,True,0,1,1,19274,217,56,7.2,True,27.224466666666668,-5503,-8,0,203,273,-70
BR1_2701742844,6,True,0,0,0,15469,197,48,6.2,False,7,False,1,0,0,15398,174,48,6.4,True,26.4034,71,-1,-1,245,222,23
BR1_2731908893,11,False,0,0,0,20248,209,68,7.4,False,12,True,0,0,0,20479,233,52,7.6,True,29.062716666666667,-231,-1,0,277,285,-8
BR1_2731404492,6,False,0,0,0,15480,181,47,6.2,False,7,True,0,0,0,17167,233,46,6.8,True,26.40685,-1687,-1,0,228,279,-51
BR1_2731674174,7,False,1,1,0,18115,250,60,7.6,False,9,True,0,0,0,19657,253,64,7.6,True,27.71826666666667,-1542,-2,1,310,317,-7
BR1_2730389868,10,True,0,0,0,17882,182,51,6.6,False,8,False,0,0,1,21472,254,48,7.4,True,28.53098333333333,-3590,2,0,233,302,-69
BR1_2730381098,10,False,0,0,0,17767,210,36,6.8,False,10,True,0,1,0,18629,202,72,7.2,True,27.367933333333333,-862,0,0,246,274,-28
BR1_2702850988,7,True,1,0,0,17128,212,64,6.8,True,5,False,0,0,0,16482,206,65,7.0,False,25.9958,646,2,1,276,271,5
BR1_2731721493,11,True,1,0,0,20175,222,80,7.8,False,7,False,0,0,0,18275,235,52,7.4,True,28.615166666666667,1900,4,1,302,287,15
BR1_2731672914,8,True,1,0,0,19054,266,68,7.8,True,4,False,0,1,0,16608,201,60,7.2,False,29.277516666666667,2446,4,1,334,261,73
BR1_2731628360,8,False,0,0,0,19245,238,56,7.4,True,9,True,0,0,0,19061,222,64,7.0,False,29.307416666666665,184,-1,0,294,286,8
BR1_2720649454,8,True,1,0,0,16765,177,56,7.0,True,5,False,0,0,0,15280,160,52,6.8,False,25.55245,1485,3,1,233,212,21
BR1_2720219810,8,False,1,0,0,18698,227,56,7.4,True,4,True,0,0,0,17541,252,68,7.4,False,29.057266666666667,1157,4,1,283,320,-37
BR1_2720155565,10,True,0,1,0,18758,181,61,7.2,False,10,False,1,0,0,19092,204,59,7.6,True,28.89605,-334,0,-1,242,263,-21
BR1_2731788088,11,True,0,0,0,20023,238,46,7.4,True,2,False,1,0,0,15789,199,62,7.2,False,29.215,4234,9,-1,284,261,23
BR1_2731055796,7,False,0,0,0,16683,202,53,7.0,True,4,True,0,0,0,14969,225,48,7.0,False,27.426983333333332,1714,3,0,255,273,-18
BR1_2730444845,9,False,1,0,0,18442,206,59,7.2,False,11,True,0,1,0,20662,228,64,7.4,True,28.521766666666668,-2220,-2,1,265,292,-27
BR1_2728782067,4,False,1,1,0,17135,226,64,7.0,True,4,True,0,0,0,15930,232,52,6.8,False,26.257316666666668,1205,0,1,290,284,6
BR1_2731923163,5,False,0,0,0,15882,184,72,6.8,False,11,True,1,0,0,18224,212,44,6.8,True,25.598666666666666,-2342,-6,-1,256,256,0
BR1_2731515007,9,False,0,0,0,18292,226,48,7.2,True,13,True,0,0,0,20697,235,36,7.4,False,29.721916666666665,-2405,-4,0,274,271,3
BR1_2731530028,11,True,1,0,0,17173,164,48,6.4,False,7,False,0,0,0,16726,186,48,6.6,True,25.877966666666666,447,4,1,212,234,-22
BR1_2731491166,9,True,1,0,0,18944,213,60,7.2,False,8,False,0,1,0,20078,231,67,7.2,True,28.8914,-1134,1,1,273,298,-25
BR1_2697092042,6,False,1,1,0,15849,198,44,6.6,False,11,True,0,0,0,19005,192,52,6.8,True,26.157083333333333,-3156,-5,1,242,244,-2
BR1_2697065689,13,True,0,1,0,19735,208,60,7.2,True,5,False,0,0,0,15449,172,52,6.4,False,25.8234,4286,8,0,268,224,44
BR1_2727066876,4,False,0,0,0,16846,197,42,7.2,False,10,True,1,0,0,19791,224,76,7.6,True,27.830483333333333,-2945,-6,-1,239,300,-61
BR1_2730382373,6,False,0,1,0,16061,199,56,6.6,False,9,True,1,0,0,17125,211,68,7.4,True,27.025316666666665,-1064,-3,-1,255,279,-24
BR1_2730371050,10,True,1,0,0,20510,262,60,7.6,True,5,False,0,1,0,17180,224,63,7.2,False,29.112466666666666,3330,5,1,322,287,35
BR1_2730354885,13,False,1,0,0,20295,272,52,7.6,True,3,True,0,0,0,15016,178,56,6.8,False,29.235016666666667,5279,10,1,324,234,90
BR1_2731454639,7,True,0,0,0,18382,223,48,7.4,False,7,False,0,0,0,17702,253,48,7.2,True,29.309833333333334,680,0,0,271,301,-30
BR1_2729365139,7,False,1,0,0,19365,250,74,7.2,True,8,True,0,0,0,18430,222,54,6.8,False,29.217883333333333,935,-1,1,324,276,48
BR1_2729137718,7,True,1,0,0,16382,205,52,7.0,False,4,False,0,0,0,15518,209,42,6.6,True,26.130733333333332,864,3,1,257,251,6
BR1_2731904945,7,False,1,0,0,17829,233,52,7.4,True,6,True,0,0,0,17502,226,68,7.0,False,29.647916666666667,327,1,1,285,294,-9
BR1_2730033417,6,False,0,0,0,17362,247,48,7.4,False,7,True,1,1,1,19840,244,60,7.2,True,29.540566666666667,-2478,-1,-1,295,304,-9
BR1_2729999159,10,True,1,0,0,18810,205,56,6.6,True,7,False,0,0,0,18061,211,40,6.4,False,25.40165,749,3,1,261,251,10
BR1_2722969828,9,False,0,1,0,19855,218,64,7.8,True,5,True,1,0,0,17157,260,52,7.2,False,29.3228,2698,4,-1,282,312,-30
BR1_2722355633,10,True,0,1,0,19916,262,60,7.6,False,6,False,0,0,0,17139,205,67,7.2,True,28.4087,2777,4,0,322,272,50
BR1_2729280620,5,True,1,1,0,16749,237,52,6.8,False,7,False,0,0,0,16330,195,60,7.2,True,25.3055,419,-2,1,289,255,34
BR1_2675071907,10,True,1,0,0,19857,220,48,7.4,True,6,False,0,0,0,17084,218,48,7.2,False,29.079483333333332,2773,4,1,268,266,2
BR1_2675053566,2,False,0,0,0,14908,210,55,6.8,False,8,True,1,1,1,21237,284,64,8.0,True,29.34498333333333,-6329,-6,-1,265,348,-83
BR1_2731597064,6,True,0,0,0,16680,199,60,7.6,False,7,False,0,0,0,16607,199,40,7.4,True,28.074816666666667,73,-1,0,259,239,20
BR1_2731575389,9,True,0,1,0,18100,198,68,7.2,True,4,False,0,0,0,15770,203,64,7.2,False,27.583366666666667,2330,5,0,266,267,-1
BR1_2730220183,5,True,0,0,0,16632,219,52,6.8,False,15,False,1,1,0,22156,231,60,7.4,True,27.822233333333333,-5524,-10,-1,271,291,-20
BR1_2697381584,5,False,0,0,0,15346,206,38,6.6,False,8,True,0,0,0,17640,209,57,7.2,True,25.970533333333332,-2294,-3,0,244,266,-22
BR1_2730864170,8,False,0,1,0,17086,184,50,6.4,True,11,True,1,0,0,18277,209,54,7.0,False,25.581083333333332,-1191,-3,-1,234,263,-29
BR1_2730030929,9,False,0,1,0,18087,210,44,7.4,False,13,True,1,0,1,22250,246,68,7.8,True,28.30225,-4163,-4,-1,254,314,-60
BR1_2728440089,6,False,1,0,0,15923,187,36,6.8,False,6,True,0,0,0,15910,184,51,6.8,True,26.22755,13,0,1,223,235,-12
BR1_2731256260,9,True,0,0,0,18648,211,60,7.2,True,7,False,0,0,0,17438,206,55,7.0,False,28.4316,1210,2,0,271,261,10
BR1_2730947448,10,False,1,0,0,19809,231,51,7.6,True,10,True,0,1,0,19857,189,56,7.0,False,29.1585,-48,0,1,282,245,37
BR1_2730767087,7,True,0,1,0,18104,225,66,7.6,False,7,False,0,0,0,19291,237,61,7.6,True,28.690833333333334,-1187,0,0,291,298,-7
BR1_2731570762,11,False,0,0,0,18713,218,60,7.2,True,7,True,1,0,0,16248,203,48,6.8,False,25.459133333333334,2465,4,-1,278,251,27
BR1_2690590744,13,True,0,0,0,21432,246,60,7.6,True,4,False,0,0,0,15917,201,64,7.0,False,29.78165,5515,9,0,306,265,41
BR1_2731255912,5,False,1,1,0,16150,210,69,6.8,False,9,True,0,0,0,17410,208,51,7.0,True,26.74155,-1260,-4,1,279,259,20
BR1_2730763128,15,True,0,1,0,22143,202,61,7.0,False,13,False,0,0,0,22222,234,70,7.4,True,28.621233333333333,-79,2,0,263,304,-41
BR1_2730715335,11,False,0,1,0,19294,245,56,7.6,False,8,True,0,0,0,18045,218,64,7.2,True,28.4253,1249,3,0,301,282,19
BR1_2730084190,11,False,0,0,0,18130,212,50,6.8,False,16,True,1,0,1,23090,218,36,7.2,True,28.4189,-4960,-5,-1,262,254,8
BR1_2730052525,11,True,0,0,0,19292,227,50,6.8,True,7,False,0,1,0,16553,179,49,6.8,False,26.148583333333335,2739,4,0,277,228,49
BR1_2730716966,7,True,1,0,0,16896,200,60,6.6,False,11,False,0,0,0,19842,209,64,7.4,True,27.218066666666665,-2946,-4,1,260,273,-13
BR1_2730694768,9,True,1,1,0,20533,259,67,7.4,True,5,False,0,0,0,17127,226,56,7.2,False,28.396,3406,4,1,326,282,44
BR1_2731415050,2,True,0,1,0,14518,217,60,6.8,False,5,False,0,0,0,15642,214,48,6.8,True,26.420266666666667,-1124,-3,0,277,262,15
BR1_2729820340,6,True,1,1,0,16877,207,56,6.6,True,9,False,0,0,1,18625,189,56,6.6,False,26.538883333333334,-1748,-3,1,263,245,18
BR1_2729218174,5,True,0,0,0,15790,215,48,6.6,False,8,False,1,1,0,17997,228,60,7.2,True,27.261883333333333,-2207,-3,-1,263,288,-25
BR1_2729175418,10,True,0,0,0,17334,181,43,6.6,False,3,False,1,0,0,15688,186,60,6.8,True,27.105716666666666,1646,7,-1,224,246,-22
BR1_2729165591,8,False,1,1,0,18927,241,60,7.4,True,5,True,0,0,0,16904,231,56,7.0,False,27.802216666666666,2023,3,1,301,287,14
BR1_2723463628,7,True,1,0,0,16801,207,48,6.8,True,8,False,0,0,0,17212,196,60,6.8,False,27.197466666666667,-411,-1,1,255,256,-1
BR1_2712679023,4,False,0,0,0,17543,225,64,7.0,False,8,True,0,0,0,19238,227,69,7.2,True,29.190316666666668,-1695,-4,0,289,296,-7
BR1_2731052277,9,True,0,0,0,16846,188,24,6.6,True,12,False,0,0,0,19849,172,68,7.2,False,29.0359,-3003,-3,0,212,240,-28
BR1_2731023728,7,False,1,0,0,18091,260,56,7.6,False,5,True,0,0,0,15755,198,56,7.0,True,28.541516666666666,2336,2,1,316,254,62
BR1_2731904477,5,False,1,1,0,17643,232,72,7.2,False,3,True,0,0,0,16480,232,60,7.4,True,29.1497,1163,2,1,304,292,12
BR1_2708875761,5,True,0,1,0,16827,209,79,7.2,True,4,False,1,0,0,14905,196,44,6.4,False,26.110683333333334,1922,1,-1,288,240,48
BR1_2722511945,5,False,0,0,0,15923,200,67,7.0,False,7,True,1,0,0,17026,225,76,6.8,True,26.354816666666668,-1103,-2,-1,267,301,-34
BR1_2731934520,5,False,0,1,1,18460,206,68,7.4,False,7,True,1,0,0,19342,226,71,7.2,True,28.089433333333332,-882,-2,-1,274,297,-23
BR1_2731923507,5,False,1,0,0,15043,185,60,7.0,False,4,True,0,0,0,16845,254,64,7.0,True,26.643483333333332,-1802,1,1,245,318,-73
BR1_2726207475,8,True,0,0,0,15390,166,41,6.2,False,11,False,1,0,0,18272,200,45,6.8,True,26.18955,-2882,-3,-1,207,245,-38
BR1_2726173258,12,True,1,0,0,19775,213,40,6.8,True,9,False,0,1,0,18777,204,60,7.0,False,25.474033333333335,998,3,1,253,264,-11
BR1_2731835871,16,True,1,1,0,21445,243,51,7.6,True,6,False,0,0,0,17312,203,56,7.0,False,28.06535,4133,10,1,294,259,35
BR1_2731839111,15,True,0,0,0,19958,181,52,6.8,True,9,False,0,0,0,17180,190,48,6.8,False,26.937483333333333,2778,6,0,233,238,-5
BR1_2731910636,7,True,0,0,0,16715,211,56,6.8,True,9,False,1,0,0,18027,213,72,7.4,False,25.62848333333333,-1312,-2,-1,267,285,-18
BR1_2731899516,5,False,0,1,0,16420,227,54,7.0,True,2,True,1,0,0,14343,189,61,6.6,False,27.142983333333333,2077,3,-1,281,250,31
BR1_2731775156,10,False,1,0,1,18599,235,58,6.8,True,3,True,0,1,0,17064,235,52,7.0,False,25.038416666666667,1535,7,1,293,287,6
BR1_2731738880,7,True,0,1,0,19076,257,44,7.4,True,5,False,1,0,0,17671,238,56,7.4,False,28.632733333333334,1405,2,-1,301,294,7
BR1_2731780147,3,False,0,1,0,15698,210,68,7.0,False,6,True,1,0,0,17330,237,64,7.4,True,29.072266666666668,-1632,-3,-1,278,301,-23
BR1_2731616183,5,True,1,0,0,16695,207,60,7.0,False,11,False,0,0,0,18318,229,44,6.8,True,25.221116666666667,-1623,-6,1,267,273,-6
BR1_2729717299,9,True,1,0,0,17379,166,41,6.4,True,10,False,0,0,0,17221,191,46,6.8,False,25.21141666666667,158,-1,1,207,237,-30
BR1_2724432604,9,True,1,1,0,18423,240,60,7.0,True,4,False,0,0,0,16354,227,48,7.0,False,26.563116666666666,2069,5,1,300,275,25
BR1_2724415655,6,False,1,0,0,18014,241,60,7.0,True,4,True,0,0,0,16323,233,52,7.0,False,29.51075,1691,2,1,301,285,16
BR1_2724351102,7,False,1,0,0,18160,245,56,7.2,False,8,True,1,0,0,18731,231,59,7.2,True,27.671566666666667,-571,-1,0,301,290,11
BR1_2691006172,4,True,0,0,0,15939,257,56,7.0,False,2,False,1,1,0,15714,244,60,7.0,True,27.1708,225,2,-1,313,304,9
BR1_2690531035,3,False,0,0,0,14978,196,47,6.6,False,8,True,1,0,0,16697,202,64,6.8,True,26.472133333333332,-1719,-5,-1,243,266,-23
BR1_2688936270,11,False,0,0,0,17835,201,60,6.8,True,11,True,1,0,0,18200,187,48,7.2,False,26.6328,-365,0,-1,261,235,26
BR1_2731759640,13,False,1,1,0,20816,229,52,7.6,True,8,True,0,0,0,19014,207,56,7.4,False,27.978466666666666,1802,5,1,281,263,18
BR1_2714066660,5,True,1,0,0,16674,217,72,7.0,True,5,False,0,1,0,16610,228,52,7.2,False,26.910516666666666,64,0,1,289,280,9
BR1_2712940930,5,False,0,1,0,17218,218,56,7.0,False,11,True,1,0,0,20569,264,52,7.6,True,28.054033333333333,-3351,-6,-1,274,316,-42
BR1_2713947699,4,True,1,0,0,14999,171,60,6.6,False,4,False,0,1,0,15316,205,63,7.0,True,27.17365,-317,0,1,231,268,-37
BR1_2707161103,7,False,0,0,0,16213,193,20,6.8,False,10,True,1,1,0,18368,209,56,7.0,True,27.220583333333334,-2155,-3,-1,213,265,-52
BR1_2731627915,9,True,0,1,0,17917,231,56,6.8,False,9,False,1,0,0,17781,220,56,7.0,True,26.473566666666667,136,0,-1,287,276,11
BR1_2731539349,4,True,0,1,0,15365,214,56,6.8,True,5,False,1,0,0,16426,210,56,7.2,False,25.549933333333332,-1061,-1,-1,270,266,4
BR1_2719821182,4,True,1,0,0,14326,185,48,6.2,False,12,False,0,1,0,20188,212,56,7.0,True,25.42406666666667,-5862,-8,1,233,268,-35
BR1_2718611077,7,False,0,0,0,15829,170,47,6.4,False,9,True,1,1,0,18348,208,68,6.8,True,26.99545,-2519,-2,-1,217,276,-59
BR1_2718585337,12,True,1,1,1,20928,205,56,7.0,True,4,False,0,0,0,15214,184,53,6.6,False,25.733366666666665,5714,8,1,261,237,24
BR1_2731455990,7,True,0,0,0,18372,221,44,7.2,True,15,False,1,1,0,20562,195,44,7.4,False,28.673633333333335,-2190,-8,-1,265,239,26
BR1_2731447628,11,False,1,0,0,19779,217,56,7.4,True,12,True,0,1,0,21745,247,64,7.4,False,27.9959,-1966,-1,1,273,311,-38
BR1_2731598474,8,False,0,0,0,17511,209,52,7.4,False,7,True,1,0,0,17641,213,64,7.2,True,27.56685,-130,1,-1,261,277,-16
BR1_2727412070,12,True,1,1,0,19665,214,48,7.4,False,10,False,0,0,0,20191,249,60,7.6,True,28.378066666666665,-526,2,1,262,309,-47
BR1_2728844665,8,True,1,0,0,18485,220,59,7.2,False,7,False,0,1,0,18750,236,71,7.2,True,28.80216666666667,-265,1,1,279,307,-28
BR1_2728743095,6,True,0,0,0,17368,267,48,7.4,False,4,False,1,0,0,16365,228,80,7.2,True,27.603366666666666,1003,2,-1,315,308,7
BR1_2728724493,4,False,0,0,0,15361,207,40,6.8,False,5,True,1,0,0,15365,203,72,6.8,True,26.962566666666667,-4,-1,-1,247,275,-28
BR1_2728584969,6,False,0,1,0,18512,232,56,7.2,False,7,True,1,0,0,18261,237,68,7.4,True,27.597533333333335,251,-1,-1,288,305,-17
BR1_2729476379,6,True,0,0,0,19676,271,60,7.8,True,9,False,1,0,0,18691,246,56,7.6,False,28.6138,985,-3,-1,331,302,29
BR1_2722675153,9,True,1,0,0,18550,198,64,7.2,False,8,False,0,1,0,20631,262,52,7.6,True,28.42585,-2081,1,1,262,314,-52
BR1_2730740719,8,True,0,1,0,19028,212,56,7.8,True,8,False,1,0,0,18642,225,76,7.6,False,28.637516666666667,386,0,-1,268,301,-33
BR1_2729094952,9,False,1,0,0,19031,215,60,7.4,True,8,True,0,0,0,18851,237,60,7.4,False,28.3606,180,1,1,275,297,-22
BR1_2727668139,9,False,1,0,0,20320,223,56,6.8,True,11,True,0,1,0,20373,237,64,7.6,False,28.1142,-53,-2,1,279,301,-22
BR1_2731496022,9,True,1,0,0,17467,241,52,7.2,True,2,False,0,0,0,14526,226,60,7.0,False,25.27405,2941,7,1,293,286,7
BR1_2730916809,9,True,1,0,0,19355,215,60,7.6,True,6,False,0,0,0,17593,238,52,7.6,False,27.951966666666667,1762,3,1,275,290,-15
BR1_2730896950,5,True,1,0,0,15822,184,40,6.4,False,7,False,0,1,0,17564,193,56,6.8,True,25.937383333333333,-1742,-2,1,224,249,-25
BR1_2729887489,6,False,1,0,0,16380,196,69,6.8,True,8,True,0,0,0,16896,214,32,6.6,False,27.47455,-516,-2,1,265,246,19
BR1_2731773351,8,True,0,1,0,17809,225,56,7.0,False,9,False,1,0,0,16919,179,52,7.0,True,29.445366666666665,890,-1,-1,281,231,50
BR1_2731715903,6,False,1,0,0,18631,219,60,7.2,False,16,True,0,1,1,23458,258,59,7.6,True,28.240316666666665,-4827,-10,1,279,317,-38
BR1_2731691793,6,False,0,0,0,18524,239,64,7.0,False,7,True,0,0,0,17534,236,52,7.6,True,28.173233333333332,990,-1,0,303,288,15
BR1_2730746226,14,True,0,1,0,20099,191,44,7.0,True,5,False,1,0,0,15362,175,63,6.4,False,25.3754,4737,9,-1,235,238,-3
BR1_2704358434,3,False,0,0,0,14743,208,52,6.8,False,9,True,1,0,0,18714,226,56,7.0,True,26.167183333333334,-3971,-6,-1,260,282,-22
BR1_2731789218,5,True,0,1,0,17770,247,64,7.2,True,3,False,0,0,0,16252,242,60,7.2,False,29.899416666666667,1518,2,0,311,302,9
BR1_2731673279,10,False,1,0,0,19663,243,52,7.4,True,11,True,0,1,0,20052,221,60,7.4,False,28.067133333333334,-389,-1,1,295,281,14
BR1_2731649202,11,True,1,0,0,20633,236,56,7.8,True,7,False,0,0,0,18786,209,56,7.6,False,27.6964,1847,4,1,292,265,27
BR1_2728927358,7,True,1,0,0,18532,249,72,7.8,True,6,False,0,0,0,16707,254,48,7.2,False,27.7424,1825,1,1,321,302,19
BR1_2728900954,3,False,0,1,0,14552,199,48,7.0,False,8,True,1,0,0,17985,221,63,7.2,True,27.278783333333333,-3433,-5,-1,247,284,-37
BR1_2709538120,8,True,1,0,0,17634,198,60,6.6,False,11,False,0,0,0,18025,204,36,6.8,True,25.409,-391,-3,1,258,240,18
BR1_2731522685,17,True,1,0,0,21047,191,70,7.6,True,9,False,0,1,0,19745,218,56,7.6,False,29.7983,1302,8,1,261,274,-13
BR1_2731839239,8,False,1,0,0,18891,252,42,7.2,True,10,True,0,0,0,18652,231,36,7.2,False,28.96795,239,-2,1,294,267,27
BR1_2730297863,8,False,0,0,0,18486,215,68,7.2,False,10,True,0,0,0,19221,222,56,7.4,True,27.914766666666665,-735,-2,0,283,278,5
BR1_2729731974,9,True,1,0,0,18712,213,52,7.4,True,5,False,0,0,0,16959,230,52,7.2,False,29.012916666666666,1753,4,1,265,282,-17
BR1_2731128655,5,False,1,0,0,16607,172,60,7.0,False,8,True,0,1,1,20473,263,68,7.8,True,27.985283333333335,-3866,-3,1,232,331,-99
BR1_2731527915,7,True,1,0,0,18444,245,72,7.4,False,12,False,0,1,0,20483,227,44,7.4,True,27.8763,-2039,-5,1,317,271,46
BR1_2731515846,9,True,0,0,0,18458,222,48,6.8,True,10,False,0,0,0,16967,181,52,6.8,False,26.936916666666665,1491,-1,0,270,233,37
BR1_2727598050,6,True,0,0,0,15790,194,52,6.6,False,11,False,1,0,0,19024,236,60,7.0,True,27.376416666666668,-3234,-5,-1,246,296,-50
BR1_2708764491,7,False,1,0,0,17692,211,60,7.4,False,7,True,0,1,0,19259,253,64,7.8,True,28.384883333333335,-1567,0,1,271,317,-46
BR1_2730814143,6,False,0,0,0,18833,235,68,7.4,True,9,True,1,0,0,18480,221,56,7.2,False,28.656783333333333,353,-3,-1,303,277,26
BR1_2730690800,6,True,0,0,0,16938,205,60,7.0,True,5,False,0,0,0,14932,202,44,6.6,False,26.213616666666667,2006,1,0,265,246,19
BR1_2727916718,3,False,0,1,0,18074,257,60,7.4,False,5,True,1,0,0,17795,243,72,7.4,True,29.738666666666667,279,-2,-1,317,315,2
BR1_2727894778,7,False,1,0,0,16094,203,40,6.4,True,6,True,0,0,0,15936,195,56,6.4,False,26.173333333333332,158,1,1,243,251,-8
BR1_2727350854,8,False,1,1,0,18770,259,64,7.4,True,5,True,0,0,0,18149,269,64,7.8,False,28.43701666666667,621,3,1,323,333,-10
BR1_2727336181,5,False,0,1,0,18001,209,68,7.0,False,14,True,1,0,0,21295,239,36,7.6,True,29.130066666666668,-3294,-9,-1,277,275,2
BR1_2731832520,10,True,0,0,0,19247,227,40,7.4,True,7,False,0,1,0,16868,192,48,7.0,False,28.86425,2379,3,0,267,240,27
BR1_2731760003,6,False,0,0,0,15678,179,56,7.0,True,6,True,1,0,0,19314,277,56,7.6,False,28.242333333333335,-3636,0,-1,235,333,-98
BR1_2730484375,6,False,1,1,0,18696,225,76,7.6,True,7,True,0,0,0,17293,230,52,7.4,False,27.903333333333332,1403,-1,1,301,282,19
BR1_2729728064,8,False,1,0,0,17265,220,60,7.0,True,5,True,0,0,0,16449,205,60,7.0,False,26.77465,816,3,1,280,265,15
BR1_2729700397,14,False,1,1,0,20453,243,76,7.8,True,4,True,0,0,0,16314,202,52,6.8,False,28.7581,4139,10,1,319,254,65
BR1_2731760618,8,True,0,1,0,16917,203,36,6.8,False,9,False,1,0,0,19323,253,60,7.6,True,29.489233333333335,-2406,-1,-1,239,313,-74
BR1_2731741518,8,True,0,1,0,17097,199,48,6.8,False,10,False,1,0,0,18698,223,52,6.8,True,26.104916666666668,-1601,-2,-1,247,275,-28
BR1_2731195243,10,False,0,1,0,18571,232,56,7.2,False,13,True,1,0,0,21695,245,58,7.6,True,29.73915,-3124,-3,-1,288,303,-15
BR1_2718903717,4,True,0,0,0,15994,239,72,7.0,True,2,False,0,1,0,14512,227,40,6.8,False,26.100833333333334,1482,2,0,311,267,44
BR1_2718878220,5,False,0,1,0,17815,259,75,7.4,True,2,True,1,0,0,15182,239,55,7.2,False,28.688216666666666,2633,3,-1,334,294,40
BR1_2725467977,12,False,0,1,0,19157,218,57,7.4,False,8,True,1,0,0,18854,230,53,7.6,True,28.736633333333334,303,4,-1,275,283,-8
BR1_2706321057,9,True,1,0,0,17229,209,52,6.6,True,6,False,0,0,0,14705,170,44,6.4,False,25.200916666666668,2524,3,1,261,214,47
BR1_2727546604,6,False,0,0,0,16012,205,56,7.2,False,10,True,1,1,1,20955,244,68,8.0,True,28.046283333333335,-4943,-4,-1,261,312,-51
BR1_2727459553,6,True,0,0,0,15856,207,52,6.8,False,5,False,1,0,0,16036,216,56,6.8,True,27.47005,-180,1,-1,259,272,-13
BR1_2727433783,7,True,0,0,0,17122,193,56,6.8,False,8,False,1,1,0,17239,213,56,6.8,True,25.165216666666666,-117,-1,-1,249,269,-20
BR1_2731609461,9,True,1,0,2,20105,180,40,6.8,False,11,False,0,1,0,19801,230,60,7.4,True,28.613,304,-2,1,220,290,-70
BR1_2731372696,3,True,1,1,0,16238,232,64,7.0,True,1,False,0,0,0,14817,244,56,7.0,False,25.126166666666666,1421,2,1,296,300,-4
BR1_2730471648,13,False,0,0,0,19382,180,56,6.6,False,9,True,1,1,0,17857,208,56,6.8,True,25.92556666666667,1525,4,-1,236,264,-28
BR1_2730324337,9,True,0,1,0,19629,258,48,7.4,True,4,False,0,0,0,16625,235,55,7.0,False,27.735766666666667,3004,5,0,306,290,16
BR1_2728473029,11,True,1,0,0,19568,182,60,6.8,False,11,False,0,1,0,18719,190,48,6.6,True,27.3206,849,0,1,242,238,4
BR1_2728404182,8,True,0,0,0,18560,236,64,7.6,False,6,False,0,0,0,17001,212,59,7.4,True,28.926583333333333,1559,2,0,300,271,29
BR1_2728330294,8,False,1,0,0,19017,258,56,7.6,False,8,True,0,1,0,18527,257,56,7.2,True,29.495116666666668,490,0,1,314,313,1
BR1_2730363957,5,False,1,1,0,17056,240,67,7.6,False,6,True,0,0,0,18048,227,56,7.4,True,29.858766666666668,-992,-1,1,307,283,24
BR1_2696761692,6,True,1,0,0,16731,193,52,7.2,False,9,False,0,0,0,19118,236,52,7.2,True,28.4298,-2387,-3,1,245,288,-43
BR1_2696343723,6,False,0,1,0,18041,214,68,7.4,False,11,True,1,0,0,19703,217,72,7.6,True,27.608583333333332,-1662,-5,-1,282,289,-7
BR1_2717467141,7,True,0,0,0,16991,223,60,6.8,False,5,False,1,0,0,15559,214,52,6.8,True,25.470766666666666,1432,2,-1,283,266,17
BR1_2727091882,6,False,0,0,0,15861,168,55,6.4,False,6,True,0,0,0,15536,208,56,6.8,True,27.177783333333334,325,0,0,223,264,-41
BR1_2731654740,7,True,1,0,0,16098,184,63,7.0,True,5,False,0,0,0,15923,227,36,6.6,False,25.49685,175,2,1,247,263,-16
BR1_2731295954,7,False,0,0,0,17911,228,49,7.4,False,7,True,0,1,0,18878,242,54,7.4,True,27.622616666666666,-967,0,0,277,296,-19
BR1_2731873968,5,False,0,1,0,16395,196,50,6.6,True,10,True,0,0,0,17366,189,50,6.8,False,26.736533333333334,-971,-5,0,246,239,7
BR1_2731433525,10,True,0,0,0,19939,239,48,7.4,False,7,False,1,1,0,17467,222,65,7.6,True,29.9136,2472,3,-1,287,287,0
BR1_2730068045,1,False,0,0,0,13929,232,51,7.0,False,6,True,0,1,0,16214,204,53,6.8,True,26.725516666666667,-2285,-5,0,283,257,26
BR1_2710432964,9,False,0,0,0,18147,208,42,7.0,False,15,True,1,1,0,21307,239,65,7.4,True,28.672616666666666,-3160,-6,-1,250,304,-54
BR1_2729976849,11,False,1,0,0,20605,262,32,7.4,False,14,True,0,1,0,21142,215,64,7.4,True,28.442416666666666,-537,-3,1,294,279,15
BR1_2731021756,7,False,0,1,0,17431,218,60,7.0,False,6,True,1,0,0,17596,229,57,7.4,True,29.450983333333333,-165,1,-1,278,286,-8
BR1_2727619614,6,False,0,0,0,16298,197,52,6.8,False,9,True,0,0,0,18302,213,68,7.0,True,26.345983333333333,-2004,-3,0,249,281,-32
BR1_2713373779,12,True,0,1,0,20709,271,58,7.8,True,6,False,1,0,0,17607,239,36,7.6,False,28.9679,3102,6,-1,329,275,54
BR1_2713353708,10,False,0,0,0,18486,227,71,7.2,False,8,True,0,0,0,19797,260,40,7.2,True,29.33535,-1311,2,0,298,300,-2
BR1_2731633345,9,True,0,0,0,19717,239,76,7.6,True,10,False,0,1,0,19375,205,60,7.4,False,27.729366666666667,342,-1,0,315,265,50
BR1_2730200296,7,True,1,0,0,17749,211,68,7.0,False,6,False,0,1,0,17448,224,64,7.4,True,29.181366666666666,301,1,1,279,288,-9
BR1_2729301698,5,False,1,0,0,16227,188,58,6.8,False,9,True,0,0,0,18534,186,66,6.8,True,29.479583333333334,-2307,-4,1,246,252,-6
BR1_2731507253,5,True,0,0,0,16555,209,46,6.8,False,14,False,1,0,0,20946,210,45,7.4,True,28.742183333333333,-4391,-9,-1,255,255,0
BR1_2731464165,9,False,0,1,0,19231,264,59,7.4,False,7,True,1,0,0,19573,258,60,7.4,True,29.913566666666668,-342,2,-1,323,318,5
BR1_2728271030,8,False,1,0,0,17852,183,65,6.6,True,11,True,0,0,0,19377,216,45,7.0,False,29.5484,-1525,-3,1,248,261,-13
BR1_2730252494,9,True,0,1,1,19804,232,64,7.2,True,6,False,0,0,0,17696,220,48,6.8,False,28.281033333333333,2108,3,0,296,268,28
BR1_2730184442,7,False,0,1,1,19741,205,56,7.0,True,10,True,1,0,0,20023,228,56,7.4,False,27.65215,-282,-3,-1,261,284,-23
BR1_2729460358,7,False,0,0,0,16989,215,48,7.0,False,6,True,1,1,0,16716,229,56,7.0,True,25.101816666666668,273,1,-1,263,285,-22
BR1_2727458853,7,False,0,0,0,15244,171,42,6.8,False,6,True,0,0,0,15556,169,60,6.6,True,25.346816666666665,-312,1,0,213,229,-16
BR1_2727425427,8,True,1,0,0,17014,208,48,7.2,True,6,False,0,0,0,18895,264,68,7.4,False,29.041683333333335,-1881,2,1,256,332,-76
BR1_2727404115,4,False,0,0,0,15738,205,48,6.8,False,4,True,0,0,0,16592,257,54,7.0,True,26.957833333333333,-854,0,0,253,311,-58
BR1_2730810461,10,True,1,0,0,19271,212,56,7.2,True,7,False,0,1,0,18172,246,44,7.0,False,29.647183333333334,1099,3,1,268,290,-22
BR1_2705683124,8,False,0,0,0,16589,178,44,6.4,False,12,True,0,0,0,18126,168,40,6.4,True,27.088366666666666,-1537,-4,0,222,208,14
BR1_2731287668,11,True,0,1,1,20775,200,50,7.2,False,11,False,1,0,0,20581,214,66,7.2,True,28.45,194,0,-1,250,280,-30
BR1_2731187301,19,True,1,1,0,23415,222,56,7.4,True,4,False,0,0,0,16697,192,56,7.2,False,27.76825,6718,15,1,278,248,30
BR1_2731845837,8,True,0,0,0,16953,181,41,6.4,False,10,False,0,0,0,17183,180,43,6.8,True,27.312866666666668,-230,-2,0,222,223,-1
BR1_2731833565,6,False,0,1,1,17082,204,56,7.2,False,5,True,1,0,0,15996,224,68,7.0,True,25.212783333333334,1086,1,-1,260,292,-32
BR1_2731792783,8,False,1,0,0,18916,242,52,7.2,True,3,True,0,1,0,16549,263,60,7.2,False,29.644216666666665,2367,5,1,294,323,-29
BR1_2731770794,11,False,1,0,0,19515,227,52,7.4,True,7,True,0,1,0,17786,212,60,7.2,False,29.48715,1729,4,1,279,272,7
BR1_2730984910,7,True,0,0,0,16512,175,47,6.8,True,5,False,0,0,0,15165,197,44,6.6,False,25.061566666666668,1347,2,0,222,241,-19
BR1_2731684228,8,True,0,1,0,17183,205,53,7.0,False,5,False,1,0,0,15981,215,46,6.4,True,25.724933333333333,1202,3,-1,258,261,-3
BR1_2731306751,9,True,1,0,0,19415,193,64,7.2,False,11,False,0,1,0,19753,215,52,7.0,True,27.77466666666667,-338,-2,1,257,267,-10
BR1_2731664391,7,False,1,0,0,16746,201,44,6.8,True,9,True,0,1,0,19142,199,56,7.2,False,29.68545,-2396,-2,1,245,255,-10
BR1_2731708575,2,False,0,0,0,14120,192,63,7.0,False,6,True,1,0,0,17937,260,76,7.4,True,26.444766666666666,-3817,-4,-1,255,336,-81
BR1_2723435029,5,False,0,0,0,15880,199,40,6.6,False,8,True,1,0,0,17308,204,52,6.8,True,25.06985,-1428,-3,-1,239,256,-17
BR1_2723186173,9,False,1,0,0,19435,243,48,7.6,True,6,True,0,0,0,17266,251,48,7.2,False,29.052716666666665,2169,3,1,291,299,-8
BR1_2731098325,10,True,0,0,0,18300,208,52,6.6,False,13,False,1,0,0,18213,177,48,6.8,True,26.783633333333334,87,-3,-1,260,225,35
BR1_2723018214,5,True,1,0,0,15940,193,48,6.6,False,7,False,0,0,0,16461,186,47,6.6,True,25.437666666666665,-521,-2,1,241,233,8
BR1_2731815636,11,True,0,0,0,20525,229,80,7.8,True,7,False,1,1,0,17717,208,56,7.4,False,29.407116666666667,2808,4,-1,309,264,45
BR1_2731735017,10,True,1,1,0,19174,214,56,7.6,True,9,False,0,0,0,17546,214,60,7.8,False,27.961733333333335,1628,1,1,270,274,-4
BR1_2731256352,11,True,1,0,0,19928,233,63,7.4,True,4,False,0,0,0,16068,196,60,7.2,False,28.11841666666667,3860,7,1,296,256,40
BR1_2731915762,4,True,0,0,0,15083,187,48,7.0,False,8,False,1,1,0,19657,233,72,7.6,True,28.6779,-4574,-4,-1,235,305,-70
BR1_2731789589,8,False,1,0,0,16903,232,44,7.4,True,6,True,0,0,0,16853,211,51,7.2,False,29.023483333333335,50,2,1,276,262,14
BR1_2731660777,7,True,0,0,0,15967,172,52,6.8,True,3,False,0,0,0,14140,178,56,6.8,False,25.823183333333333,1827,4,0,224,234,-10
BR1_2713057786,8,False,1,0,0,16835,204,52,6.6,True,6,True,0,1,0,16682,202,44,6.8,False,26.64995,153,2,1,256,246,10
BR1_2731804528,8,False,1,1,0,19342,248,64,7.6,False,12,True,0,0,0,19381,201,44,7.2,True,29.1442,-39,-4,1,312,245,67
BR1_2731366964,4,True,1,0,0,15646,224,64,6.6,True,3,False,0,0,0,13972,167,52,6.2,False,25.905833333333334,1674,1,1,288,219,69
BR1_2731555665,8,True,0,0,0,18554,239,56,7.4,True,7,False,0,1,0,17663,217,64,7.2,False,29.192966666666667,891,1,0,295,281,14
BR1_2728802735,2,False,0,1,0,14228,194,52,6.6,False,13,True,1,0,0,19493,205,52,7.0,True,25.029166666666665,-5265,-11,-1,246,257,-11
BR1_2721669589,13,True,0,0,0,18942,213,60,7.0,False,11,False,1,0,0,19655,195,56,7.4,True,27.735166666666668,-713,2,-1,273,251,22
BR1_2725972851,11,False,1,0,0,18756,197,60,7.2,True,6,True,0,0,0,15506,200,36,6.4,False,25.923866666666665,3250,5,1,257,236,21
BR1_2677474737,8,False,1,1,0,19077,211,57,6.8,True,14,True,0,0,0,21056,220,42,7.0,False,27.571566666666666,-1979,-6,1,268,262,6
BR1_2677457746,7,True,0,0,0,17853,226,56,7.6,False,6,False,0,0,0,17337,204,60,7.4,True,29.520566666666667,516,1,0,282,264,18
BR1_2677441557,5,True,1,0,0,18394,259,68,8.0,True,5,False,0,0,0,16531,233,52,7.4,False,29.645266666666668,1863,0,1,327,285,42
BR1_2731082173,8,False,0,0,0,18685,205,70,7.4,True,10,True,1,0,0,19156,224,52,7.4,False,29.14075,-471,-2,-1,275,276,-1
BR1_2719239885,6,True,0,0,0,17323,200,72,7.0,True,6,False,1,1,0,15398,190,52,6.8,False,25.3075,1925,0,-1,272,242,30
BR1_2731828720,7,False,0,0,0,19611,251,56,7.4,True,11,True,1,0,0,20323,243,52,7.6,False,29.101766666666666,-712,-4,-1,307,295,12
BR1_2731186340,7,True,0,0,0,16887,198,48,7.0,False,6,False,1,1,0,18464,216,67,7.2,True,27.666116666666667,-1577,1,-1,246,283,-37
BR1_2731568730,3,True,0,0,0,14416,209,48,6.8,False,4,False,1,1,0,15918,218,60,6.8,True,25.5278,-1502,-1,-1,257,278,-21
BR1_2730859867,9,True,1,1,1,20788,237,62,7.2,True,8,False,0,0,0,17947,220,51,7.0,False,28.054133333333333,2841,1,1,299,271,28
BR1_2731031229,8,True,0,0,0,17226,165,46,6.4,True,8,False,0,0,0,15980,195,47,7.0,False,26.767083333333332,1246,0,0,211,242,-31
BR1_2729177349,7,True,0,0,0,16822,189,48,6.6,False,11,False,1,0,0,18687,191,48,6.8,True,26.840066666666665,-1865,-4,-1,237,239,-2
BR1_2725267780,12,True,0,0,0,20528,211,60,7.4,False,9,False,1,1,0,19378,256,64,7.4,True,29.799666666666667,1150,3,-1,271,320,-49
BR1_2724221714,7,True,1,0,0,15715,174,36,6.6,True,3,False,0,0,0,14977,182,55,6.4,False,25.2339,738,4,1,210,237,-27
BR1_2727867967,2,False,0,1,0,14991,238,33,7.2,False,6,True,1,0,0,18424,244,75,7.6,True,29.310883333333333,-3433,-4,-1,271,319,-48
BR1_2730653510,7,False,0,0,0,16404,196,40,6.6,True,9,True,1,0,1,17290,179,52,6.6,False,26.97175,-886,-2,-1,236,231,5
BR1_2731806940,11,True,0,0,0,19270,228,56,7.2,False,8,False,0,1,0,18591,211,48,7.2,True,29.162016666666666,679,3,0,284,259,25
BR1_2731779162,8,True,0,1,0,19345,272,63,7.8,True,8,False,1,0,0,18833,259,56,7.4,False,28.207933333333333,512,0,-1,335,315,20
BR1_2731736603,15,True,0,0,0,19917,212,52,6.8,False,8,False,0,0,0,16791,169,32,6.2,True,25.566133333333333,3126,7,0,264,201,63
BR1_2730884261,8,False,0,0,0,17709,193,52,6.8,True,11,True,0,0,0,18305,203,32,6.6,False,26.985516666666665,-596,-3,0,245,235,10
BR1_2731272176,10,True,1,1,0,20144,202,52,7.4,True,7,False,0,0,0,17963,219,60,7.0,False,27.751316666666668,2181,3,1,254,279,-25
BR1_2731202658,12,True,1,0,0,20123,228,60,7.4,True,5,False,0,1,0,18915,231,51,7.2,False,28.1048,1208,7,1,288,282,6
BR1_2731759459,8,True,1,1,1,18692,207,70,7.6,True,3,False,0,0,0,14802,211,54,7.2,False,26.652083333333334,3890,5,1,277,265,12
BR1_2731130527,7,False,1,1,0,16322,226,52,7.0,True,4,True,0,0,0,15762,246,44,6.6,False,26.898516666666666,560,3,1,278,290,-12
BR1_2729008638,6,False,1,0,0,16782,204,54,7.0,False,7,True,0,0,0,18115,254,45,7.2,True,29.1986,-1333,-1,1,258,299,-41
BR1_2719386602,7,True,1,0,0,17586,213,46,7.0,True,6,False,0,0,0,17088,216,55,7.4,False,29.017666666666667,498,1,1,259,271,-12
BR1_2701595247,11,True,1,0,0,18478,230,55,7.6,False,5,False,0,0,0,17054,223,48,7.0,True,28.559833333333334,1424,6,1,285,271,14
BR1_2720832532,8,False,0,0,0,18315,221,48,7.2,True,11,True,0,0,0,18479,212,48,7.0,False,28.159233333333333,-164,-3,0,269,260,9
BR1_2731633531,18,True,0,0,0,22798,208,52,7.2,False,17,False,1,0,0,21212,199,44,6.8,True,28.047633333333334,1586,1,-1,260,243,17
BR1_2731610802,6,True,1,0,0,17674,260,46,7.4,True,11,False,0,1,0,20337,263,51,7.6,False,29.87585,-2663,-5,1,306,314,-8
BR1_2731595326,10,True,0,0,0,18620,233,32,6.8,True,5,False,0,0,0,16540,202,56,6.4,False,25.93865,2080,5,0,265,258,7
BR1_2731074292,7,True,1,1,0,18231,240,67,7.0,True,6,False,0,0,0,15802,213,64,7.0,False,26.946983333333332,2429,1,1,307,277,30
BR1_2726324641,14,True,1,0,0,20969,241,48,7.4,True,5,False,0,0,0,16590,197,58,6.8,False,28.128166666666665,4379,9,1,289,255,34
BR1_2729672551,10,False,1,1,0,19061,210,44,7.2,True,4,True,0,0,0,15278,201,47,6.8,False,27.778616666666668,3783,6,1,254,248,6
BR1_2729644746,9,False,0,0,0,18445,198,60,7.2,False,20,True,0,1,0,22434,223,48,7.2,True,29.549216666666666,-3989,-11,0,258,271,-13
BR1_2728963665,13,True,1,0,0,18416,181,58,6.8,True,3,False,0,0,0,14602,188,53,6.6,False,26.926683333333333,3814,10,1,239,241,-2
BR1_2731060571,4,True,0,0,0,16595,243,60,7.2,True,7,False,1,0,0,17560,241,60,7.4,False,27.823433333333334,-965,-3,-1,303,301,2
BR1_2731042485,9,True,1,0,0,19194,221,68,7.6,False,6,False,0,1,0,17865,244,64,7.2,True,28.989516666666667,1329,3,1,289,308,-19
BR1_2730542107,9,False,0,0,0,19394,225,52,7.4,True,10,True,1,1,0,20437,239,60,7.4,False,29.413266666666665,-1043,-1,-1,277,299,-22
BR1_2730119854,7,False,0,0,0,18163,235,72,7.8,True,5,True,0,1,0,17779,238,64,7.4,False,27.5981,384,2,0,307,302,5
BR1_2730043854,10,True,0,0,0,18668,187,56,7.0,True,14,False,1,0,0,20911,219,52,7.4,False,27.564583333333335,-2243,-4,-1,243,271,-28
BR1_2731913223,4,False,0,0,0,16787,229,56,7.6,False,5,True,1,0,0,18857,252,64,7.6,True,28.701,-2070,-1,-1,285,316,-31
BR1_2731757684,5,False,0,0,0,17203,247,52,7.4,True,8,True,1,0,0,17783,223,44,7.2,False,28.5937,-580,-3,-1,299,267,32
BR1_2731145828,8,False,0,1,0,18503,206,34,6.8,False,15,True,0,0,0,21703,218,61,7.2,True,28.944883333333333,-3200,-7,0,240,279,-39
BR1_2731100774,6,False,0,0,0,15657,194,36,6.6,False,6,True,0,0,0,16615,196,51,6.6,True,25.500133333333334,-958,0,0,230,247,-17
BR1_2731542785,6,False,0,0,0,18578,257,60,7.6,True,6,True,1,1,0,18093,223,56,7.0,False,29.991733333333332,485,0,-1,317,279,38
BR1_2731194287,8,True,1,1,0,18756,214,72,7.6,True,2,False,0,0,0,16194,220,56,7.4,False,29.5877,2562,6,1,286,276,10
BR1_2731776228,7,False,0,0,0,19457,256,63,7.2,False,10,True,1,0,0,20333,255,68,7.4,True,29.469783333333332,-876,-3,-1,319,323,-4
BR1_2731537072,9,True,0,1,0,19801,210,80,7.6,True,7,False,1,0,0,17937,230,40,7.2,False,27.672066666666666,1864,2,-1,290,270,20
BR1_2731644128,6,False,0,0,0,17131,216,43,7.4,False,11,True,0,0,0,20013,245,48,7.6,True,27.8566,-2882,-5,0,259,293,-34
BR1_2727833891,5,True,0,0,0,14185,148,36,6.0,False,14,False,1,1,0,19224,201,60,7.0,True,27.103716666666667,-5039,-9,-1,184,261,-77
BR1_2727608474,7,True,1,1,0,18454,238,70,7.4,False,5,False,0,0,0,18190,216,62,7.4,True,29.640516666666667,264,2,1,308,278,30
BR1_2730951545,5,True,0,1,0,18505,236,62,7.4,True,3,False,1,0,0,16162,241,53,7.0,False,28.832966666666668,2343,2,-1,298,294,4
BR1_2731629485,12,False,1,0,0,20605,262,68,7.8,True,5,True,0,0,0,16807,227,48,7.2,False,27.70841666666667,3798,7,1,330,275,55
BR1_2731605997,4,True,1,0,0,15835,225,63,7.0,True,0,False,0,0,0,14009,237,44,6.8,False,26.601566666666667,1826,4,1,288,281,7
BR1_2730214573,5,True,0,0,0,16684,203,63,6.8,True,7,False,1,0,0,16352,189,39,6.8,False,26.71915,332,-2,-1,266,228,38
BR1_2731476063,6,False,0,1,0,17506,208,56,7.0,True,12,True,1,0,0,20659,224,56,7.8,False,28.641583333333333,-3153,-6,-1,264,280,-16
BR1_2731664420,10,False,0,0,0,18239,220,47,7.2,True,6,True,1,0,0,14757,173,40,6.6,False,25.01343333333333,3482,4,-1,267,213,54
BR1_2731296499,7,True,0,0,0,18537,215,44,7.2,True,10,False,1,0,0,19736,245,72,7.2,False,28.497783333333334,-1199,-3,-1,259,317,-58
BR1_2725571876,12,True,1,0,0,20315,225,45,7.4,False,8,False,0,0,0,17730,202,49,7.0,True,27.611033333333335,2585,4,1,270,251,19
BR1_2725549513,8,True,1,0,0,17634,227,65,7.0,True,7,False,0,0,0,16941,211,42,6.8,False,27.058833333333332,693,1,1,292,253,39
BR1_2715398249,6,False,0,0,0,16865,192,55,7.2,False,9,True,0,1,0,20396,243,60,7.6,True,29.1017,-3531,-3,0,247,303,-56
BR1_2730591452,7,False,0,0,0,16949,205,43,6.8,False,13,True,1,0,0,19965,214,65,7.8,True,28.777783333333332,-3016,-6,-1,248,279,-31
BR1_2731170783,7,True,0,1,0,17114,198,64,7.0,False,10,False,0,0,0,19488,239,56,7.4,True,27.90945,-2374,-3,0,262,295,-33
BR1_2731159231,3,False,0,0,0,15608,212,51,6.8,False,7,True,0,0,0,17605,211,56,7.2,True,25.18665,-1997,-4,0,263,267,-4
BR1_2731452752,13,True,1,0,0,20050,227,63,7.0,True,9,False,0,0,0,19967,247,77,7.8,False,29.085883333333335,83,4,1,290,324,-34
BR1_2729662778,10,False,0,0,0,18559,177,59,6.8,True,11,True,1,0,0,18360,168,52,7.0,False,26.609416666666668,199,-1,-1,236,220,16
BR1_2727290013,6,True,0,1,0,16777,201,52,6.4,False,8,False,1,0,0,16428,190,60,7.2,True,26.6696,349,-2,-1,253,250,3
BR1_2726054229,9,False,0,0,0,18763,224,64,7.4,True,7,True,0,0,0,18676,240,51,7.0,False,28.5924,87,2,0,288,291,-3
BR1_2674543828,4,True,0,0,0,15323,205,52,6.6,True,7,False,1,0,0,17721,217,52,7.0,False,26.09785,-2398,-3,-1,257,269,-12
BR1_2731741501,11,True,0,1,0,20500,230,51,7.8,True,6,False,1,0,0,17004,234,48,7.4,False,29.51435,3496,5,-1,281,282,-1
BR1_2729576309,4,True,1,0,0,14746,200,36,6.6,False,9,False,0,1,0,18437,245,55,7.2,True,27.012716666666666,-3691,-5,1,236,300,-64
BR1_2721672912,10,False,1,0,0,19405,239,60,7.4,True,7,True,0,1,0,18404,252,51,7.4,False,29.27595,1001,3,1,299,303,-4
BR1_2721657159,5,True,0,0,0,15938,193,40,6.6,False,8,False,1,0,0,16988,197,44,6.8,True,27.0461,-1050,-3,-1,233,241,-8
BR1_2721566352,11,True,0,0,0,18753,229,55,7.0,True,2,False,1,0,0,15041,204,72,6.6,False,27.08245,3712,9,-1,284,276,8
BR1_2730750795,9,True,0,0,0,19899,248,56,7.0,False,8,False,1,0,0,19745,235,68,7.4,True,28.610133333333334,154,1,-1,304,303,1
BR1_2727390526,5,True,0,0,0,15610,208,60,6.8,False,11,False,1,0,0,17933,187,48,6.8,True,25.9196,-2323,-6,-1,268,235,33
BR1_2727310028,6,True,1,0,0,15505,204,54,7.0,False,7,False,0,0,0,18411,224,65,7.0,True,27.4439,-2906,-1,1,258,289,-31
BR1_2727268375,6,True,1,0,0,17128,192,64,7.4,True,6,False,0,1,0,18188,225,60,7.4,False,28.008,-1060,0,1,256,285,-29
BR1_2729745389,5,False,0,0,0,16424,196,68,7.2,False,9,True,1,0,0,18856,231,48,7.6,True,28.468883333333334,-2432,-4,-1,264,279,-15
BR1_2729719900,6,False,0,0,0,16976,216,40,7.0,False,10,True,1,0,0,20164,250,60,7.6,True,29.48005,-3188,-4,-1,256,310,-54
BR1_2729697193,6,True,1,0,0,16174,192,56,6.6,False,7,False,0,1,1,18239,221,40,6.8,True,25.578833333333332,-2065,-1,1,248,261,-13
BR1_2728386382,6,True,1,0,0,17942,213,52,7.2,True,6,False,0,0,0,16972,208,60,7.2,False,28.194666666666667,970,0,1,265,268,-3
BR1_2731627325,6,True,1,0,0,17606,239,72,7.6,True,4,False,0,0,0,16874,243,64,7.4,False,29.493983333333333,732,2,1,311,307,4
BR1_2731607038,9,True,0,0,0,19566,244,71,7.6,True,7,False,1,0,0,17205,201,66,7.6,False,28.407933333333332,2361,2,-1,315,267,48
BR1_2731670798,6,True,0,0,0,18331,250,52,7.8,True,6,False,1,1,0,18430,244,56,7.4,False,28.712566666666667,-99,0,-1,302,300,2
BR1_2717455359,8,False,1,0,0,18073,172,48,6.8,False,15,True,0,0,0,21337,196,42,7.0,True,27.61328333333333,-3264,-7,1,220,238,-18
BR1_2717361063,12,True,1,0,0,19481,211,64,6.8,True,11,False,0,0,0,17972,193,36,6.8,False,25.573566666666668,1509,1,1,275,229,46
BR1_2731933011,11,True,1,1,0,21727,262,64,7.6,True,5,False,0,0,0,16792,223,48,7.2,False,29.500883333333334,4935,6,1,326,271,55
BR1_2731919034,4,True,0,0,0,16440,230,60,7.0,False,7,False,1,0,0,16423,201,52,6.8,True,27.334583333333335,17,-3,-1,290,253,37
BR1_2722932328,6,True,1,1,0,16556,220,52,7.0,True,1,False,0,0,0,13713,225,52,6.6,False,27.0971,2843,5,1,272,277,-5
BR1_2731734628,6,False,0,1,0,15150,160,44,6.6,True,6,True,0,0,0,15880,215,44,6.6,False,26.43625,-730,0,0,204,259,-55
BR1_2731264480,5,False,0,0,0,16227,211,48,7.0,False,4,True,0,0,0,16118,206,56,6.8,True,26.582616666666667,109,1,0,259,262,-3
BR1_2731800217,15,False,0,0,0,21051,227,68,7.6,False,10,True,1,0,0,19910,190,59,6.8,True,28.548966666666665,1141,5,-1,295,249,46
BR1_2731112647,7,True,1,0,0,17149,179,56,6.6,False,13,False,0,1,0,19409,217,44,7.0,True,26.694533333333332,-2260,-6,1,235,261,-26
BR1_2722020854,6,False,1,0,0,17291,216,58,7.0,False,10,True,0,0,0,19104,209,40,7.8,True,27.58615,-1813,-4,1,274,249,25
BR1_2688672627,9,False,0,0,0,18408,223,43,7.6,False,13,True,1,1,0,22084,268,64,8.0,True,28.284683333333334,-3676,-4,-1,266,332,-66
BR1_2688529123,11,False,0,0,0,17978,193,55,7.0,False,9,True,1,0,0,16042,173,56,6.6,True,26.03685,1936,2,-1,248,229,19
BR1_2731763872,11,False,1,0,0,18346,193,64,7.0,True,5,True,0,0,0,16842,238,44,6.6,False,27.006316666666667,1504,6,1,257,282,-25
BR1_2731786930,13,True,0,0,0,20028,209,52,6.8,True,7,False,0,1,0,18276,211,52,7.4,False,28.715633333333333,1752,6,0,261,263,-2
BR1_2731746447,8,True,1,0,0,18823,240,60,7.6,True,9,False,0,1,0,18973,212,52,7.4,False,27.991016666666667,-150,-1,1,300,264,36
BR1_2731648866,9,False,0,1,1,20138,219,64,7.2,True,10,True,1,0,0,19581,227,64,7.6,False,29.4265,557,-1,-1,283,291,-8
BR1_2731511509,8,False,1,0,0,18520,167,60,7.2,False,15,True,0,0,0,21518,189,64,7.2,True,28.036183333333334,-2998,-7,1,227,253,-26
BR1_2731746078,11,False,0,0,0,19011,186,56,7.2,False,11,True,1,0,0,21166,250,64,7.2,True,27.725816666666667,-2155,0,-1,242,314,-72
BR1_2726092085,19,True,0,1,2,26389,235,64,7.4,True,9,False,1,0,0,16580,150,40,6.4,False,29.115683333333333,9809,10,-1,299,190,109
BR1_2724417621,4,False,1,0,0,16213,220,40,7.0,False,5,True,0,0,0,18096,249,44,7.4,True,29.84755,-1883,-1,1,260,293,-33
BR1_2691228396,5,True,0,1,0,16795,213,58,7.0,False,7,False,1,0,0,18398,241,72,7.6,True,29.301666666666666,-1603,-2,-1,271,313,-42
BR1_2731649221,8,False,0,0,0,15964,179,60,6.8,False,10,True,1,0,0,17889,190,56,6.8,True,25.075533333333333,-1925,-2,-1,239,246,-7
BR1_2729170102,10,False,0,1,0,20342,217,60,7.0,False,15,True,1,0,0,20804,207,51,7.4,True,29.176166666666667,-462,-5,-1,277,258,19
BR1_2714556400,4,False,0,0,0,14514,190,55,6.6,False,10,True,1,1,0,18742,213,56,7.0,True,25.95306666666667,-4228,-6,-1,245,269,-24
BR1_2731432875,13,False,1,0,0,19940,213,48,7.0,True,16,True,0,0,0,22482,220,52,6.8,False,29.92155,-2542,-3,1,261,272,-11
BR1_2703065003,3,True,1,0,0,16223,231,56,7.0,False,8,False,0,0,0,18893,237,60,7.4,True,27.704083333333333,-2670,-5,1,287,297,-10
BR1_2698384419,6,True,0,0,0,15556,201,40,7.0,True,3,False,1,0,0,13504,158,50,6.4,False,25.108116666666668,2052,3,-1,241,208,33
BR1_2731727645,4,False,0,0,0,16694,230,64,7.2,False,9,True,1,0,0,18522,248,72,7.6,True,28.946533333333335,-1828,-5,-1,294,320,-26
BR1_2731702757,6,False,0,1,0,16984,185,51,6.8,True,11,True,1,0,0,18370,192,56,6.6,False,26.0316,-1386,-5,-1,236,248,-12
BR1_2731583987,7,False,1,0,0,18041,222,52,7.2,False,15,True,0,1,0,20759,230,72,7.6,True,29.781833333333335,-2718,-8,1,274,302,-28
BR1_2731103053,9,True,0,0,0,19214,212,67,7.4,True,1,False,1,0,0,15124,227,56,6.8,False,28.36185,4090,8,-1,279,283,-4
BR1_2729103990,7,True,0,0,0,16033,182,56,6.8,True,6,False,0,0,0,16241,187,45,6.6,False,26.12285,-208,1,0,238,232,6
BR1_2728452767,6,True,0,1,0,16503,211,50,7.4,True,2,False,1,0,0,16556,271,56,7.4,False,27.957616666666667,-53,4,-1,261,327,-66
BR1_2695799446,12,True,1,1,0,19335,236,52,7.6,True,5,False,0,0,0,16411,209,64,7.0,False,26.921616666666665,2924,7,1,288,273,15
BR1_2692312962,2,False,0,0,0,14833,201,70,6.8,False,5,True,1,0,0,15598,213,42,6.8,True,26.6703,-765,-3,-1,271,255,16
BR1_2731691150,5,False,1,1,0,16202,202,71,7.0,True,3,True,0,0,0,14562,203,47,6.8,False,25.720216666666666,1640,2,1,273,250,23
BR1_2731617361,4,True,1,1,0,17116,193,68,7.0,True,8,False,0,0,0,17766,231,52,7.2,False,28.085083333333333,-650,-4,1,261,283,-22
BR1_2731776764,8,False,0,0,0,17384,191,56,6.8,False,5,True,1,0,0,15929,177,56,6.6,True,27.2096,1455,3,-1,247,233,14
BR1_2731211762,4,False,1,0,0,15789,227,64,7.2,False,6,True,0,0,0,15579,204,42,7.2,True,25.620033333333332,210,-2,1,291,246,45
BR1_2726973630,4,False,0,0,0,14892,186,60,7.0,False,5,True,0,0,0,16292,212,68,7.2,True,25.374933333333335,-1400,-1,0,246,280,-34
BR1_2726891487,9,False,0,0,0,15603,172,28,6.0,False,10,True,0,1,0,18602,219,36,6.8,True,25.067116666666667,-2999,-1,0,200,255,-55
BR1_2731592537,4,False,1,0,0,15074,193,42,6.6,False,7,True,0,0,0,16752,224,48,7.0,True,26.288333333333334,-1678,-3,1,235,272,-37
BR1_2731428800,9,True,0,1,0,19753,260,40,7.6,True,8,False,1,0,0,17916,215,48,7.2,False,28.194366666666667,1837,1,-1,300,263,37
BR1_2731209508,6,False,1,0,0,16315,212,56,6.8,True,7,True,0,0,0,16026,176,52,6.8,False,25.5982,289,-1,1,268,228,40
BR1_2726056605,11,True,0,0,0,20650,249,54,7.6,True,8,False,1,1,0,18982,247,70,7.2,False,28.904833333333332,1668,3,-1,303,317,-14
BR1_2730211963,8,False,1,0,0,17995,204,52,7.0,True,9,True,0,1,0,17206,191,40,6.8,False,25.184783333333332,789,-1,1,256,231,25
BR1_2730170524,5,True,0,0,0,17393,251,44,7.2,True,0,False,1,1,0,15271,262,56,7.6,False,28.537933333333335,2122,5,-1,295,318,-23
BR1_2730569549,2,True,1,0,0,13935,213,48,6.6,True,5,False,0,0,0,15573,233,55,6.8,False,27.19065,-1638,-3,1,261,288,-27
BR1_2727713486,7,True,0,0,0,17806,224,56,7.2,False,10,False,0,0,0,20057,231,56,7.2,True,29.525383333333334,-2251,-3,0,280,287,-7
BR1_2731874984,5,False,0,0,0,17533,199,55,7.2,False,10,True,1,0,0,18918,210,56,7.2,True,28.85965,-1385,-5,-1,254,266,-12
BR1_2721216293,5,True,0,0,0,15826,196,72,7.0,False,4,False,1,1,0,15794,225,44,6.8,True,26.409583333333334,32,1,-1,268,269,-1
BR1_2731608509,12,False,0,0,0,20407,212,46,7.6,False,11,True,1,1,0,19510,199,64,7.2,True,29.845483333333334,897,1,-1,258,263,-5
BR1_2731594062,4,False,0,0,0,17201,207,66,7.4,True,11,True,1,0,0,20750,249,58,7.8,False,29.254366666666666,-3549,-7,-1,273,307,-34
BR1_2731565348,8,True,0,0,0,18794,237,59,7.0,False,11,False,1,0,0,20584,230,52,7.4,True,28.252033333333333,-1790,-3,-1,296,282,14
BR1_2731243700,9,False,0,1,0,19024,219,40,6.8,True,8,True,0,0,0,17240,215,52,6.8,False,25.608083333333333,1784,1,0,259,267,-8
BR1_2731754579,7,True,0,0,0,16787,198,64,7.2,True,1,False,0,0,0,13716,200,61,6.8,False,25.1316,3071,6,0,262,261,1
BR1_2731699243,12,True,1,0,0,17890,188,63,7.0,False,8,False,0,1,0,16298,176,56,6.8,True,25.164166666666667,1592,4,1,251,232,19
BR1_2731563813,10,True,0,0,0,19064,234,63,7.4,False,6,False,1,1,0,18023,207,52,7.2,True,29.219816666666667,1041,4,-1,297,259,38
BR1_2731503417,0,False,0,0,0,13273,210,48,6.6,False,7,True,0,0,0,18348,244,60,7.0,True,26.79681666666667,-5075,-7,0,258,304,-46
BR1_2731933764,4,True,0,0,0,14896,187,52,6.4,False,11,False,0,1,0,18260,177,40,6.8,True,26.42725,-3364,-7,0,239,217,22
BR1_2731809521,12,True,0,0,0,20576,223,56,7.4,True,8,False,1,0,0,16872,148,40,6.6,False,29.36845,3704,4,-1,279,188,91
BR1_2731817838,8,True,1,0,0,17709,209,51,7.0,True,6,False,0,1,0,19351,264,69,7.8,False,27.509366666666665,-1642,2,1,260,333,-73
BR1_2731792794,9,False,0,0,0,18968,230,51,7.4,False,11,True,1,1,0,21176,225,72,7.6,True,28.205566666666666,-2208,-2,-1,281,297,-16
BR1_2728444328,7,True,0,0,0,18585,243,56,7.2,False,5,False,1,1,0,18554,242,68,7.4,True,28.212583333333335,31,2,-1,299,310,-11
BR1_2722455220,11,True,0,1,1,21216,232,44,7.4,True,13,False,1,0,0,20626,220,40,6.8,False,28.34636666666667,590,-2,-1,276,260,16
BR1_2724916599,9,False,1,1,0,17231,184,38,6.6,True,12,True,0,0,0,17994,174,56,7.0,False,25.3822,-763,-3,1,222,230,-8
BR1_2731835395,9,False,0,1,0,17250,179,60,6.8,True,9,True,1,0,0,16914,141,60,6.6,False,25.112233333333332,336,0,-1,239,201,38
BR1_2731620727,8,True,1,0,0,16722,205,56,7.2,True,3,False,0,0,0,15212,228,72,6.8,False,27.033183333333334,1510,5,1,261,300,-39
BR1_2731602282,6,False,0,0,0,15880,206,50,6.6,False,5,True,1,0,0,15321,229,48,6.8,True,25.479283333333335,559,1,-1,256,277,-21
BR1_2731219984,10,True,1,0,0,18951,221,44,7.2,True,6,False,0,1,0,17857,223,56,7.2,False,29.4748,1094,4,1,265,279,-14
BR1_2691054690,7,False,0,0,0,17339,241,52,7.2,True,5,True,0,1,0,16857,187,64,7.2,False,29.6951,482,2,0,293,251,42
BR1_2693433155,9,False,1,0,0,16119,177,48,6.4,False,10,True,0,0,0,17889,203,51,6.6,True,25.81505,-1770,-1,1,225,254,-29
BR1_2693352639,3,True,0,0,0,16346,237,50,7.2,False,2,False,2,1,0,17113,263,74,7.6,True,28.00485,-767,1,-2,287,337,-50
BR1_2730618586,11,True,0,1,0,19702,260,52,7.4,True,6,False,1,0,0,17466,191,71,7.2,False,28.459466666666668,2236,5,-1,312,262,50
BR1_2730580069,5,False,0,1,0,17073,213,72,7.4,False,10,True,1,0,0,19137,213,44,7.6,True,29.100033333333332,-2064,-5,-1,285,257,28
BR1_2730174320,8,True,1,1,0,19414,250,60,7.4,True,8,False,0,0,0,19435,236,56,7.6,False,28.698266666666665,-21,0,1,310,292,18
BR1_2701712986,6,False,1,0,0,18089,261,52,7.6,True,3,True,0,0,0,16346,236,60,7.2,False,27.614166666666666,1743,3,1,313,296,17
BR1_2701687311,9,True,0,0,0,18054,211,52,7.6,False,7,False,1,1,0,18594,199,72,7.2,True,29.1636,-540,2,-1,263,271,-8
BR1_2731732057,11,True,1,0,0,20522,253,68,7.6,True,3,False,0,1,0,16280,211,56,7.2,False,29.50655,4242,8,1,321,267,54
BR1_2730572866,7,True,0,0,0,16367,177,56,6.4,False,10,False,0,0,0,17707,203,36,6.6,True,26.542616666666667,-1340,-3,0,233,239,-6
BR1_2724264811,6,False,1,1,0,17808,228,52,7.2,True,10,True,0,0,0,20273,253,68,7.4,False,29.539766666666665,-2465,-4,1,280,321,-41
BR1_2724095445,10,False,0,1,0,16445,120,48,6.4,False,16,True,1,0,0,21018,198,48,7.0,True,26.2842,-4573,-6,-1,168,246,-78
BR1_2707913090,4,True,1,0,0,17656,276,44,7.0,False,9,False,0,0,0,18939,227,63,7.2,True,28.90785,-1283,-5,1,320,290,30
BR1_2726448263,5,True,0,0,0,17231,266,68,7.6,False,5,False,1,0,0,17760,261,56,7.4,True,28.636533333333333,-529,0,-1,334,317,17
BR1_2724992423,8,True,1,1,0,16685,189,55,6.6,True,6,False,0,0,0,16502,198,45,6.8,False,26.0559,183,2,1,244,243,1
BR1_2727599453,7,False,1,1,0,19107,221,44,7.2,True,10,True,0,0,0,19630,217,60,7.4,False,29.943466666666666,-523,-3,1,265,277,-12
BR1_2727588184,5,False,0,0,0,15901,188,52,6.8,False,9,True,1,0,0,17857,228,48,7.0,True,25.187,-1956,-4,-1,240,276,-36
BR1_2731618325,4,True,0,1,0,14685,187,52,6.6,False,11,False,1,0,0,18405,195,56,7.2,True,25.2981,-3720,-7,-1,239,251,-12
BR1_2712510006,6,True,0,0,0,16031,195,47,6.6,False,8,False,1,0,0,16482,159,60,7.0,True,26.5901,-451,-2,-1,242,219,23
BR1_2725506405,12,False,1,0,0,19920,210,56,7.4,True,8,True,0,0,0,17502,194,52,7.2,False,29.68936666666667,2418,4,1,266,246,20
BR1_2717639611,6,True,0,0,0,17899,214,52,7.0,False,7,False,1,1,0,18515,222,63,7.2,True,27.823666666666668,-616,-1,-1,266,285,-19
BR1_2729275435,5,False,1,0,0,17896,257,64,7.4,True,4,True,0,1,0,16380,212,51,7.2,False,29.050433333333334,1516,1,1,321,263,58
BR1_2731270692,5,True,0,0,0,16772,205,52,6.8,True,5,False,1,0,0,15656,223,52,7.2,False,27.0765,1116,0,-1,257,275,-18
BR1_2731245600,12,False,1,1,0,20248,246,60,7.6,True,8,True,0,0,0,21056,282,64,8.0,False,29.781833333333335,-808,4,1,306,346,-40
BR1_2730819790,3,False,0,0,0,15567,203,56,7.2,False,8,True,1,1,0,19184,267,57,7.6,True,28.1789,-3617,-5,-1,259,324,-65
BR1_2731922037,9,True,1,0,0,19419,220,68,7.2,True,7,False,0,1,0,17991,221,72,7.0,False,27.912166666666668,1428,2,1,288,293,-5
BR1_2731715431,7,True,1,1,0,18564,236,72,7.4,True,3,False,0,0,0,16700,248,68,7.4,False,29.2055,1864,4,1,308,316,-8
BR1_2731518536,14,True,1,1,0,21497,220,64,7.6,True,10,False,0,0,0,18208,172,44,6.8,False,29.29981666666667,3289,4,1,284,216,68
BR1_2731080518,8,True,0,0,0,17225,223,60,6.8,True,4,False,0,0,0,15566,213,44,6.6,False,27.452783333333333,1659,4,0,283,257,26
BR1_2720403760,8,False,0,0,0,16887,213,46,7.4,False,7,True,0,1,0,19567,250,76,7.6,True,27.825116666666666,-2680,1,0,259,326,-67
BR1_2698155059,7,False,0,0,1,18069,201,52,7.2,False,10,True,1,1,0,21401,252,60,7.6,True,28.133316666666666,-3332,-3,-1,253,312,-59
BR1_2731783013,6,False,0,0,0,16605,210,56,7.4,False,6,True,1,1,0,18582,247,68,7.2,True,29.683516666666666,-1977,0,-1,266,315,-49
BR1_2730801181,6,True,1,0,0,17720,227,56,7.4,False,8,False,0,0,0,18150,218,52,7.6,True,28.944316666666666,-430,-2,1,283,270,13
BR1_2688870006,7,False,0,0,0,16085,185,52,6.8,False,8,True,1,0,0,17102,223,48,7.2,True,26.6954,-1017,-1,-1,237,271,-34
BR1_2731679882,6,True,1,0,0,15457,194,44,6.8,False,3,False,0,0,0,14832,193,63,6.8,True,26.661666666666665,625,3,1,238,256,-18
BR1_2731745047,15,True,1,1,1,22983,223,73,8.0,True,7,False,0,0,0,18845,204,50,7.0,False,29.9932,4138,8,1,296,254,42
BR1_2731711218,10,True,1,0,0,19452,269,66,7.6,True,3,False,0,1,0,15877,211,56,7.2,False,29.5892,3575,7,1,335,267,68
BR1_2731687345,5,True,0,0,0,15934,193,48,6.6,False,11,False,1,0,0,18529,223,56,7.2,True,26.896816666666666,-2595,-6,-1,241,279,-38
BR1_2729889793,8,False,1,1,0,18223,212,52,7.0,False,8,True,0,0,0,18009,225,48,7.2,True,28.45243333333333,214,0,1,264,273,-9
BR1_2729881144,5,False,0,0,0,15745,183,48,7.0,False,12,True,1,1,0,19014,211,56,7.2,True,25.996816666666668,-3269,-7,-1,231,267,-36
BR1_2726421039,0,False,0,0,0,12374,168,46,6.4,False,6,True,1,0,0,17258,262,66,7.2,True,25.2157,-4884,-6,-1,214,328,-114
BR1_2679289926,6,False,1,0,1,17449,198,52,6.8,False,15,True,0,1,1,23945,245,36,7.6,True,28.172916666666666,-6496,-9,1,250,281,-31
BR1_2724178268,7,False,0,0,0,17155,226,54,7.0,True,5,True,1,0,0,16051,220,68,6.6,False,26.608633333333334,1104,2,-1,280,288,-8
BR1_2723737264,5,True,0,1,0,16691,218,48,7.4,True,5,False,1,0,0,17989,254,56,7.2,False,29.365583333333333,-1298,0,-1,266,310,-44
BR1_2731456731,4,True,1,1,0,15842,205,60,6.6,True,6,False,0,0,0,17201,227,64,7.2,False,27.34715,-1359,-2,1,265,291,-26
BR1_2731185257,8,False,0,1,0,18108,207,56,7.2,False,9,True,0,0,0,19343,249,49,7.4,True,27.713716666666667,-1235,-1,0,263,298,-35
BR1_2726247732,9,True,0,0,0,15959,177,48,6.6,True,14,False,0,0,0,18933,177,55,7.0,False,27.428233333333335,-2974,-5,0,225,232,-7
BR1_2726202928,2,True,0,0,0,14602,189,50,6.8,False,7,False,0,0,0,17982,248,65,7.8,True,28.16655,-3380,-5,0,239,313,-74
BR1_2726172688,11,True,0,0,0,20940,267,64,7.2,False,8,False,1,1,0,19189,241,56,7.2,True,29.341516666666667,1751,3,-1,331,297,34
BR1_2723714247,4,False,0,0,0,16479,250,56,7.4,False,4,True,0,1,0,17494,245,58,7.4,True,28.00345,-1015,0,0,306,303,3
BR1_2731710788,6,True,0,0,0,18216,267,60,7.6,True,6,False,0,0,0,18431,252,72,7.4,False,29.0913,-215,0,0,327,324,3
BR1_2731653487,10,True,0,0,0,19896,250,59,7.4,True,10,False,1,1,1,19507,175,76,7.4,False,27.806983333333335,389,0,-1,309,251,58
BR1_2730330147,10,False,0,1,0,19344,173,56,6.8,True,16,True,0,0,0,21689,233,48,7.4,False,29.517416666666666,-2345,-6,0,229,281,-52
BR1_2729470424,3,True,1,0,0,14696,216,64,7.0,True,1,False,0,1,0,13846,202,56,6.8,False,25.192133333333334,850,2,1,280,258,22
BR1_2728813121,3,False,1,0,0,16407,238,57,7.4,True,1,True,0,0,0,15228,216,52,7.0,False,29.386583333333334,1179,2,1,295,268,27
BR1_2728525360,8,True,0,1,0,19726,262,72,7.8,True,3,False,0,0,0,15187,187,60,6.8,False,28.50945,4539,5,0,334,247,87
BR1_2715408824,4,True,1,1,0,16422,228,60,7.4,False,4,False,0,0,0,16570,248,56,7.6,True,28.0988,-148,0,1,288,304,-16
BR1_2724860437,7,True,0,0,0,17885,222,48,6.8,True,7,False,0,0,0,16905,226,43,7.0,False,27.453583333333334,980,0,0,270,269,1
BR1_2730143631,8,True,1,1,0,19169,236,63,7.6,True,4,False,0,0,0,17912,249,68,7.4,False,29.640183333333333,1257,4,1,299,317,-18
BR1_2730098780,6,False,0,0,0,17848,223,44,7.4,False,12,True,1,1,0,20354,235,80,7.6,True,29.776333333333334,-2506,-6,-1,267,315,-48
BR1_2731635852,7,False,0,0,0,16750,195,52,7.0,False,9,True,1,1,0,18565,238,64,7.4,True,26.14816666666667,-1815,-2,-1,247,302,-55
BR1_2731607784,9,True,0,0,0,16519,194,36,7.0,True,4,False,0,0,0,14910,194,50,6.2,False,27.23315,1609,5,0,230,244,-14
BR1_2707401101,4,True,0,1,0,16071,208,52,6.8,True,5,False,0,0,0,15451,196,48,6.8,False,26.258316666666666,620,-1,0,260,244,16
BR1_2707311182,9,True,1,0,0,18206,234,56,6.8,True,7,False,0,0,0,16644,178,67,6.6,False,26.244766666666667,1562,2,1,290,245,45
BR1_2707302532,12,True,0,0,0,19906,234,58,7.4,False,9,False,0,0,0,18829,238,62,7.4,True,28.2105,1077,3,0,292,300,-8
BR1_2728373070,10,True,1,0,1,20939,228,59,7.4,False,12,False,0,0,0,20191,211,64,7.4,True,28.05901666666667,748,-2,1,287,275,12
BR1_2728214029,5,False,0,1,1,17638,203,58,7.0,True,9,True,1,0,0,18707,205,60,7.0,False,26.6871,-1069,-4,-1,261,265,-4
BR1_2731369541,11,True,1,1,0,20913,242,60,7.4,True,8,False,0,0,0,17950,219,51,7.2,False,28.930933333333332,2963,3,1,302,270,32
BR1_2727914138,9,False,0,0,0,18844,207,52,7.6,True,10,True,1,1,0,20120,264,68,7.6,False,28.2361,-1276,-1,-1,259,332,-73
BR1_2722676184,10,True,1,0,0,19740,213,48,7.0,True,6,False,0,1,0,18827,216,64,7.2,False,28.893933333333333,913,4,1,261,280,-19
BR1_2730255038,9,False,0,1,0,18846,209,56,7.6,True,12,True,1,0,0,20044,202,56,7.6,False,28.648616666666666,-1198,-3,-1,265,258,7
BR1_2731830491,4,False,0,0,0,15238,183,60,6.8,False,10,True,1,0,0,19188,241,64,7.2,True,27.278466666666667,-3950,-6,-1,243,305,-62
BR1_2731812357,8,True,1,0,0,17143,221,64,7.0,True,4,False,0,0,0,14593,190,47,6.8,False,26.999583333333334,2550,4,1,285,237,48
BR1_2731252950,1,False,0,0,0,14471,215,52,6.6,True,8,True,0,0,0,16029,199,44,6.6,False,26.96315,-1558,-7,0,267,243,24
BR1_2731682336,5,True,0,0,0,16551,220,56,7.2,False,9,False,1,0,0,18909,214,68,7.2,True,28.11335,-2358,-4,-1,276,282,-6
BR1_2731625507,8,True,0,0,0,17533,199,44,7.0,True,10,False,1,0,0,18912,217,64,7.4,False,29.491366666666668,-1379,-2,-1,243,281,-38
BR1_2730682239,8,True,0,0,0,19914,242,62,7.4,True,10,False,1,1,0,20023,243,58,7.4,False,29.11235,-109,-2,-1,304,301,3
BR1_2728881418,6,True,0,0,0,17725,210,56,7.4,True,2,False,1,0,0,15672,243,55,7.2,False,29.685033333333333,2053,4,-1,266,298,-32
BR1_2729981809,6,True,1,0,0,17550,225,76,7.4,False,5,False,0,0,0,17572,230,67,7.6,True,29.2727,-22,1,1,301,297,4
BR1_2731206039,8,False,1,0,0,17954,245,60,7.0,True,5,True,0,0,0,15767,205,52,7.0,False,27.1954,2187,3,1,305,257,48
BR1_2728937953,11,False,0,1,0,19067,194,59,7.4,True,8,True,1,0,0,18173,250,56,7.4,False,28.7812,894,3,-1,253,306,-53
BR1_2721030579,9,True,1,1,0,17831,179,60,7.0,True,5,False,0,0,0,14210,144,64,6.6,False,26.354933333333335,3621,4,1,239,208,31
BR1_2730708405,6,False,0,0,0,16730,245,52,7.0,True,6,True,0,1,0,18550,265,56,7.6,False,28.672033333333335,-1820,0,0,297,321,-24
BR1_2713875583,3,True,0,0,0,16957,226,56,7.0,False,10,False,1,1,0,20161,242,64,7.8,True,28.155133333333332,-3204,-7,-1,282,306,-24
BR1_2731445537,6,True,0,1,0,17386,207,64,7.4,False,7,False,0,0,0,17874,238,76,7.4,True,29.9833,-488,-1,0,271,314,-43
BR1_2731428964,11,False,0,0,0,19623,213,52,7.4,False,8,True,1,0,0,19180,237,68,7.4,True,29.81665,443,3,-1,265,305,-40
BR1_2726861272,16,True,0,0,0,21742,199,52,7.2,True,15,False,0,0,0,20353,189,68,7.0,False,25.1143,1389,1,0,251,257,-6
BR1_2731716370,6,True,0,0,0,17516,233,60,7.4,False,7,False,1,1,0,18656,266,48,7.6,True,28.648966666666666,-1140,-1,-1,293,314,-21
BR1_2708820873,4,False,0,1,0,17425,254,62,7.2,False,8,True,1,0,0,18358,260,48,7.6,True,28.61995,-933,-4,-1,316,308,8
BR1_2708633075,11,False,0,1,0,21190,221,60,7.4,True,11,True,0,0,0,19069,202,40,7.0,False,27.5731,2121,0,0,281,242,39
BR1_2731511751,5,True,1,0,0,15617,196,46,6.6,True,4,False,0,1,0,16346,220,57,7.2,False,25.70555,-729,1,1,242,277,-35
BR1_2731307545,9,True,1,0,0,18180,215,68,7.0,True,5,False,0,0,0,15683,192,40,6.4,False,25.685283333333334,2497,4,1,283,232,51
BR1_2730870539,4,False,0,0,0,16526,218,64,7.0,False,13,True,1,1,0,21435,231,68,7.2,True,27.503983333333334,-4909,-9,-1,282,299,-17
BR1_2731492114,7,False,0,0,0,16364,200,56,7.2,False,7,True,0,1,0,18752,249,40,7.2,True,29.354733333333332,-2388,0,0,256,289,-33
BR1_2731631265,9,True,1,0,0,18720,241,48,7.2,True,7,False,0,0,0,18054,231,48,7.4,False,28.312483333333333,666,2,1,289,279,10
BR1_2731607948,2,False,0,0,0,13971,181,44,7.2,False,6,True,0,0,0,17044,234,60,7.2,True,25.121466666666667,-3073,-4,0,225,294,-69
BR1_2731488006,6,True,1,0,0,15773,213,46,6.6,True,6,False,0,0,0,16305,195,64,7.2,False,27.18705,-532,0,1,259,259,0
BR1_2731324651,13,True,1,0,0,18410,205,52,6.6,True,7,False,0,0,0,16093,174,52,6.6,False,25.357983333333333,2317,6,1,257,226,31
BR1_2731371846,9,True,1,0,0,17949,210,43,6.8,True,9,False,0,0,0,17820,190,52,6.6,False,26.374966666666666,129,0,1,253,242,11
BR1_2730943824,10,False,0,0,0,18642,190,60,7.2,False,10,True,1,0,0,20601,249,76,7.8,True,29.211966666666665,-1959,0,-1,250,325,-75
BR1_2730870550,10,True,0,0,0,17914,207,36,6.6,False,9,False,0,0,0,18134,165,71,6.6,True,25.299516666666666,-220,1,0,243,236,7
BR1_2700807127,8,True,0,1,0,17654,194,50,6.8,True,8,False,0,0,0,17531,203,52,7.0,False,25.23865,123,0,0,244,255,-11
BR1_2700773042,6,False,1,1,0,18055,269,57,7.2,True,8,True,0,0,0,19158,217,54,7.6,False,28.14775,-1103,-2,1,326,271,55
BR1_2700574970,10,False,0,1,0,18798,184,55,7.0,False,17,True,1,0,0,22777,238,56,7.2,True,29.233833333333333,-3979,-7,-1,239,294,-55
BR1_2731606787,7,False,1,0,0,17469,216,56,6.8,True,6,True,0,1,0,16124,200,56,7.0,False,26.188716666666668,1345,1,1,272,256,16
BR1_2731498741,11,True,0,0,0,20569,239,60,7.6,True,10,False,0,0,0,19446,245,32,7.0,False,28.665016666666666,1123,1,0,299,277,22
BR1_2689027512,4,False,0,0,0,16474,210,56,7.4,False,8,True,1,1,0,18892,245,52,7.4,True,27.774033333333332,-2418,-4,-1,266,297,-31
BR1_2718133450,10,True,1,1,0,19331,223,47,7.2,False,5,False,0,0,0,16485,219,54,7.2,True,27.738566666666667,2846,5,1,270,273,-3
BR1_2718112108,8,False,1,0,0,16979,215,51,6.6,True,7,True,0,0,0,17192,182,48,6.6,False,27.621333333333332,-213,1,1,266,230,36
BR1_2731850657,11,True,0,1,0,19534,177,44,7.0,False,12,False,1,0,0,20989,264,48,7.6,True,27.746066666666668,-1455,-1,-1,221,312,-91
BR1_2731784181,2,False,0,0,0,13829,183,60,6.6,False,10,True,1,0,0,17470,167,64,7.0,True,26.427316666666666,-3641,-8,-1,243,231,12
BR1_2731681482,4,True,1,0,0,15969,236,56,7.0,True,3,False,0,0,0,15416,226,52,7.0,False,28.664033333333332,553,1,1,292,278,14
BR1_2731265481,13,True,1,0,0,19075,186,68,7.2,True,3,False,0,0,0,13852,175,35,6.4,False,26.8007,5223,10,1,254,210,44
BR1_2725943682,13,True,1,1,1,21098,250,48,7.4,True,8,False,0,0,0,17849,208,56,7.2,False,28.618166666666667,3249,5,1,298,264,34
BR1_2725932889,3,False,0,0,0,16503,192,56,7.0,False,10,True,1,1,0,19926,256,76,8.0,True,28.71135,-3423,-7,-1,248,332,-84
BR1_2728603361,7,True,1,0,0,17107,223,51,7.2,True,6,False,0,1,0,17040,218,55,7.0,False,28.504916666666666,67,1,1,274,273,1
BR1_2731725287,11,True,0,1,0,19755,209,76,7.2,True,6,False,1,0,0,18430,243,72,7.4,False,27.5895,1325,5,-1,285,315,-30
BR1_2730229550,11,False,0,0,0,20806,220,56,7.4,True,10,True,1,1,0,20129,238,68,7.4,False,29.4712,677,1,-1,276,306,-30
BR1_2730078368,8,True,1,0,0,16964,225,48,6.8,True,1,False,0,0,0,13623,182,44,6.4,False,26.388966666666665,3341,7,1,273,226,47
BR1_2731803806,16,True,1,0,0,20368,208,44,7.4,True,7,False,0,0,0,16831,180,48,6.8,False,28.392466666666667,3537,9,1,252,228,24
BR1_2731186280,6,False,0,1,0,18662,244,64,7.4,False,13,True,1,0,1,21720,250,76,7.6,True,28.0197,-3058,-7,-1,308,326,-18
BR1_2731326228,7,True,0,0,0,16220,239,36,6.8,False,9,False,1,0,0,17449,205,56,7.2,True,25.930666666666667,-1229,-2,-1,275,261,14
BR1_2730797756,8,True,0,1,0,17053,201,60,7.0,True,5,False,1,0,0,16020,190,52,6.6,False,26.378783333333335,1033,3,-1,261,242,19
BR1_2718166083,9,True,1,0,0,18334,209,44,7.2,True,4,False,0,0,0,17556,233,72,7.4,False,29.052066666666665,778,5,1,253,305,-52
BR1_2717925691,9,True,1,0,0,18939,220,60,7.4,True,6,False,0,0,0,18339,237,59,7.2,False,28.094133333333332,600,3,1,280,296,-16
BR1_2717903772,5,False,0,0,0,17036,228,44,7.0,False,5,True,1,0,0,17269,192,67,7.0,True,29.18675,-233,0,-1,272,259,13
BR1_2720956848,11,True,1,0,0,21077,259,64,7.6,True,8,False,0,0,0,17635,193,52,6.8,False,29.4752,3442,3,1,323,245,78
BR1_2730074418,3,False,1,0,0,15912,240,64,7.2,False,5,True,0,1,0,17485,223,52,7.6,True,29.050183333333333,-1573,-2,1,304,275,29
BR1_2730020951,7,True,1,1,0,18259,239,68,7.6,True,6,False,0,0,0,18071,241,52,7.8,False,28.86178333333333,188,1,1,307,293,14
BR1_2730675392,9,True,0,1,0,17465,214,60,7.0,True,3,False,0,0,0,14289,202,48,6.8,False,26.970183333333335,3176,6,0,274,250,24
BR1_2730267564,11,False,0,0,0,19915,234,64,7.4,True,12,True,0,1,0,20544,229,54,7.6,False,29.123416666666667,-629,-1,0,298,283,15
BR1_2730238275,8,False,0,1,0,18947,227,61,7.2,True,9,True,1,0,0,19006,227,66,8.0,False,29.516183333333334,-59,-1,-1,288,293,-5
BR1_2730985526,6,True,0,1,0,18173,224,57,7.4,True,5,False,1,0,0,17150,239,52,7.2,False,28.5547,1023,1,-1,281,291,-10
BR1_2730972487,10,True,1,0,0,18358,182,44,6.8,True,3,False,0,0,0,14549,179,52,6.4,False,26.01481666666667,3809,7,1,226,231,-5
BR1_2729205765,6,False,0,1,0,18739,233,56,7.2,True,11,True,0,0,0,19505,230,52,7.4,False,27.655616666666667,-766,-5,0,289,282,7
BR1_2731827713,2,False,1,1,0,14562,184,64,6.6,False,7,True,0,0,0,16226,232,60,7.2,True,25.47605,-1664,-5,1,248,292,-44
BR1_2731785533,3,False,0,0,0,15889,222,47,7.0,False,7,True,1,0,0,18088,257,48,7.2,True,28.175083333333333,-2199,-4,-1,269,305,-36
BR1_2731762619,13,True,0,0,0,18974,196,43,6.4,True,1,False,0,0,0,12771,176,44,6.4,False,25.9899,6203,12,0,239,220,19
BR1_2731645754,7,False,0,0,0,19035,218,60,7.2,False,11,True,1,1,0,21001,240,64,7.2,True,29.881433333333334,-1966,-4,-1,278,304,-26
BR1_2730092515,9,True,1,1,0,17895,195,68,7.0,True,6,False,0,0,0,15928,191,60,6.8,False,25.801316666666665,1967,3,1,263,251,12
BR1_2729418526,8,True,0,0,0,17007,192,52,6.8,True,4,False,1,0,0,14415,172,44,6.6,False,26.001933333333334,2592,4,-1,244,216,28
BR1_2715905480,5,True,0,0,0,16871,208,60,7.2,False,9,False,1,0,0,19275,220,60,7.4,True,27.9955,-2404,-4,-1,268,280,-12
BR1_2731101376,10,True,0,1,2,19273,226,38,6.6,True,10,False,1,0,0,17580,188,60,6.8,False,25.748466666666666,1693,0,-1,264,248,16
BR1_2731080869,6,True,1,0,0,17526,214,56,7.2,True,4,False,0,0,0,16862,245,68,7.2,False,29.202133333333332,664,2,1,270,313,-43
BR1_2731211779,11,True,1,1,0,21494,257,72,7.8,True,3,False,0,0,0,16348,228,56,7.4,False,28.3306,5146,8,1,329,284,45
BR1_2730742228,10,True,1,0,0,16185,180,44,6.8,False,6,False,0,0,0,15445,166,56,6.6,True,27.41355,740,4,1,224,222,2
BR1_2695565862,7,True,0,0,0,17488,202,56,7.0,False,5,False,1,1,0,19182,264,64,7.6,True,28.572433333333333,-1694,2,-1,258,328,-70
BR1_2695286534,5,True,1,1,1,17580,237,60,7.0,True,4,False,0,0,0,14343,167,48,6.6,False,25.19558333333333,3237,1,1,297,215,82
BR1_2695073788,8,True,1,0,0,16678,218,52,7.0,True,2,False,0,0,0,14440,200,59,6.6,False,25.41195,2238,6,1,270,259,11
BR1_2727466480,11,False,0,1,0,19086,213,54,7.8,True,8,True,0,0,0,18566,209,40,7.0,False,28.5373,520,3,0,267,249,18
BR1_2724125207,8,False,1,0,1,19454,205,66,7.6,True,6,True,0,1,1,19000,252,72,7.2,False,28.507083333333334,454,2,1,271,324,-53
BR1_2730824382,12,True,0,1,0,19349,214,56,7.2,True,2,False,0,0,0,13888,210,36,6.2,False,25.93295,5461,10,0,270,246,24
BR1_2731621511,9,True,1,0,0,18012,219,28,6.8,False,8,False,0,1,0,17147,203,75,7.0,True,25.719166666666666,865,1,1,247,278,-31
BR1_2731587472,6,False,0,0,0,17072,228,64,7.0,True,4,True,1,0,0,14860,201,48,6.8,False,25.091633333333334,2212,2,-1,292,249,43
BR1_2703801476,10,True,1,0,0,18181,195,56,7.0,True,6,False,0,1,0,17125,201,48,6.6,False,27.385566666666666,1056,4,1,251,249,2
BR1_2730437007,6,False,1,0,0,15389,167,48,6.2,True,9,True,0,1,0,18469,243,40,7.0,False,26.640216666666667,-3080,-3,1,215,283,-68
BR1_2728951082,8,False,1,1,0,17815,208,60,7.0,True,4,True,0,0,0,15350,205,64,6.8,False,25.174466666666667,2465,4,1,268,269,-1
BR1_2728516659,3,False,0,0,0,14229,198,44,6.4,False,5,True,1,0,0,16270,232,60,7.0,True,26.257216666666668,-2041,-2,-1,242,292,-50
BR1_2731605161,12,True,0,0,0,20776,246,51,7.6,True,8,False,1,1,0,17726,197,56,7.2,False,29.14285,3050,4,-1,297,253,44
BR1_2729369138,5,True,1,0,0,15562,205,47,6.8,True,2,False,0,0,0,13742,195,36,6.8,False,26.673883333333333,1820,3,1,252,231,21
BR1_2725474244,12,False,0,1,0,20837,221,72,7.2,False,11,True,1,0,0,20792,233,68,7.2,True,28.8362,45,1,-1,293,301,-8
BR1_2731624472,8,True,0,1,0,17751,201,52,7.0,True,4,False,0,0,0,14801,186,48,6.6,False,27.002183333333335,2950,4,0,253,234,19
BR1_2695865537,8,True,0,0,0,16131,208,44,6.6,False,9,False,0,0,0,17562,215,40,6.4,True,27.169816666666666,-1431,-1,0,252,255,-3
BR1_2731655761,5,True,0,0,0,15763,200,52,6.6,True,6,False,1,0,0,15468,190,64,6.6,False,25.2802,295,-1,-1,252,254,-2
BR1_2730602544,7,True,1,0,0,16967,218,40,6.6,True,3,False,0,0,0,13950,188,48,6.8,False,26.526733333333333,3017,4,1,258,236,22
BR1_2728852580,5,True,0,0,0,16710,220,48,7.2,False,4,False,1,0,0,16344,211,64,7.2,True,29.497516666666666,366,1,-1,268,275,-7
BR1_2731757373,10,False,1,0,0,20250,244,52,7.2,False,10,True,0,0,0,20932,234,68,7.4,True,27.6741,-682,0,1,296,302,-6
BR1_2727438095,14,True,1,0,0,19956,182,44,6.8,False,14,False,0,0,0,20565,190,48,7.0,True,28.933783333333334,-609,0,1,226,238,-12
BR1_2731837563,7,True,0,0,0,16916,200,52,7.0,True,5,False,0,0,0,15069,181,44,6.8,False,25.04225,1847,2,0,252,225,27
BR1_2731372063,11,False,1,1,0,18708,160,72,6.6,True,12,True,0,0,0,18413,209,51,6.8,False,26.110466666666667,295,-1,1,232,260,-28
BR1_2731361305,7,True,1,1,0,20454,252,72,7.6,True,8,False,0,0,0,18498,219,64,7.2,False,29.068833333333334,1956,-1,1,324,283,41
BR1_2729030970,5,False,1,0,1,17221,234,52,7.0,True,3,True,0,0,0,15377,211,58,6.8,False,27.025983333333333,1844,2,1,286,269,17
BR1_2731687706,3,True,0,0,0,14419,202,65,6.8,False,12,False,1,1,0,19093,209,56,7.2,True,25.2872,-4674,-9,-1,267,265,2
BR1_2731666201,8,False,0,0,0,19271,257,60,7.6,False,4,True,1,1,0,18336,236,68,7.4,True,29.6057,935,4,-1,317,304,13
BR1_2715825700,7,True,0,0,0,17011,223,47,6.8,False,7,False,1,0,0,15859,180,52,6.4,True,26.208983333333332,1152,0,-1,270,232,38
BR1_2714098007,3,False,0,0,0,14705,190,52,6.8,False,12,True,1,1,0,19159,212,56,7.2,True,28.148883333333334,-4454,-9,-1,242,268,-26
BR1_2731840867,10,False,0,0,0,17630,194,52,6.8,False,8,True,0,1,0,16445,197,56,6.6,True,27.25855,1185,2,0,246,253,-7
BR1_2730774786,8,True,0,1,0,16390,187,40,6.6,False,8,False,0,0,0,17431,203,56,6.8,True,25.493016666666666,-1041,0,0,227,259,-32
BR1_2726996061,9,False,1,1,0,18967,251,52,7.8,True,4,True,0,0,0,16719,196,84,7.6,False,29.7244,2248,5,1,303,280,23
BR1_2726928876,7,True,0,1,0,18984,222,72,7.2,True,7,False,1,0,0,17631,227,36,7.0,False,28.014483333333335,1353,0,-1,294,263,31
BR1_2731387924,7,True,0,0,0,15895,199,48,6.4,False,15,False,0,0,1,22246,237,52,7.2,True,26.20635,-6351,-8,0,247,289,-42
BR1_2731088248,13,True,0,0,0,22591,257,64,7.4,True,7,False,1,0,0,18028,231,56,7.4,False,29.604966666666666,4563,6,-1,321,287,34
BR1_2731564262,8,False,1,0,0,18225,217,60,7.4,False,5,True,0,0,0,17698,222,52,7.4,True,28.486366666666665,527,3,1,277,274,3
BR1_2729723071,6,True,0,0,0,15631,172,52,7.0,True,4,False,1,0,0,14878,159,56,6.4,False,26.971516666666666,753,2,-1,224,215,9
BR1_2727911011,5,False,1,1,0,17448,243,56,7.6,True,4,True,0,0,0,16142,227,52,7.0,False,29.7839,1306,1,1,299,279,20
BR1_2731809750,12,True,0,0,0,19076,216,49,7.2,True,7,False,0,0,0,19462,225,62,7.2,False,28.66525,-386,5,0,265,287,-22
BR1_2731848656,8,False,0,1,0,19165,195,68,7.4,False,9,True,1,0,0,18557,197,52,7.4,True,29.458433333333332,608,-1,-1,263,249,14
BR1_2731693389,3,False,0,0,0,14731,206,51,7.0,True,3,True,1,1,0,15471,227,52,6.8,False,25.4967,-740,0,-1,257,279,-22
BR1_2730908940,5,True,0,1,0,17369,210,52,6.6,False,7,False,1,0,0,16373,194,60,6.8,True,26.50855,996,-2,-1,262,254,8
BR1_2730907409,9,False,0,0,0,18387,190,72,7.4,True,8,True,1,0,0,18321,213,68,7.2,False,28.591,66,1,-1,262,281,-19
BR1_2730902738,5,False,0,0,0,15382,208,43,7.0,False,4,True,1,1,0,16147,232,72,7.0,True,25.266416666666668,-765,1,-1,251,304,-53
BR1_2716442501,7,False,0,1,0,16636,191,40,6.4,False,10,True,0,0,0,18037,216,48,6.8,True,25.317333333333334,-1401,-3,0,231,264,-33
BR1_2731934824,3,False,0,0,0,17613,239,56,7.4,False,8,True,1,0,0,19609,274,52,7.4,True,29.598933333333335,-1996,-5,-1,295,326,-31
BR1_2721492764,5,False,0,0,0,17030,214,56,7.0,False,8,True,1,0,0,19133,240,64,7.6,True,29.471083333333333,-2103,-3,-1,270,304,-34
BR1_2721193340,5,False,0,0,0,16253,231,66,7.0,True,3,True,0,1,0,14748,183,54,7.2,False,26.533133333333332,1505,2,0,297,237,60
BR1_2730014862,10,False,0,0,0,19158,273,48,7.6,False,4,True,1,1,0,16849,226,58,7.2,True,29.681183333333333,2309,6,-1,321,284,37
BR1_2730792312,6,False,0,0,1,16713,219,61,7.4,False,8,True,1,1,0,19856,204,52,7.2,True,27.878533333333333,-3143,-2,-1,280,256,24
BR1_2730764688,7,True,1,0,0,17216,252,52,7.0,True,7,False,0,0,0,16152,205,48,6.8,False,27.463983333333335,1064,0,1,304,253,51
BR1_2731755753,4,False,0,0,0,14092,182,48,6.6,False,16,True,1,1,0,20680,225,60,7.2,True,25.831983333333334,-6588,-12,-1,230,285,-55
BR1_2731284725,6,True,0,0,0,16054,202,60,7.0,False,4,False,1,1,0,16507,218,68,7.0,True,27.328483333333335,-453,2,-1,262,286,-24
BR1_2731107448,6,True,0,0,0,18402,236,52,7.4,True,8,False,0,0,0,17474,220,51,7.2,False,29.534233333333333,928,-2,0,288,271,17
BR1_2731326202,12,False,0,0,0,18615,203,44,7.0,True,7,True,1,0,0,15511,167,48,6.6,False,25.972716666666667,3104,5,-1,247,215,32
BR1_2726277672,9,True,1,0,0,19501,255,56,7.2,True,5,False,0,0,0,15184,179,36,6.4,False,25.530066666666666,4317,4,1,311,215,96
BR1_2717427441,10,True,1,1,0,19741,209,57,6.8,True,3,False,0,0,0,15122,208,60,6.6,False,26.53945,4619,7,1,266,268,-2
BR1_2720362292,2,False,1,0,0,16337,222,80,7.2,False,7,True,0,0,0,18408,238,63,7.6,True,27.985566666666667,-2071,-5,1,302,301,1
BR1_2730870212,11,True,1,1,0,18632,189,72,7.0,True,6,False,0,0,0,15603,204,52,6.8,False,27.257516666666668,3029,5,1,261,256,5
BR1_2731841408,14,True,1,0,1,23075,220,54,7.4,True,9,False,0,0,0,17915,205,57,7.2,False,29.26465,5160,5,1,274,262,12
BR1_2726710619,5,True,0,0,0,15980,214,48,6.8,True,8,False,1,0,0,17477,232,60,7.0,False,25.512,-1497,-3,-1,262,292,-30
BR1_2726702048,7,True,0,0,0,19482,269,72,7.6,True,7,False,1,0,0,17365,203,68,6.8,False,29.935283333333334,2117,0,-1,341,271,70
BR1_2726586038,12,False,0,1,0,20537,223,52,7.4,False,12,True,0,0,0,21170,223,64,7.2,True,29.686333333333334,-633,0,0,275,287,-12
BR1_2727202610,2,True,1,0,0,14727,206,48,6.6,True,2,False,0,0,0,14063,220,48,6.8,False,26.812566666666665,664,0,1,254,268,-14
BR1_2725479104,8,False,1,0,0,17516,191,64,7.2,False,8,True,0,1,0,19993,237,52,7.4,True,28.931966666666668,-2477,0,1,255,289,-34
BR1_2731570566,9,True,1,0,0,18863,221,49,7.2,True,11,False,0,1,0,19938,219,50,7.4,False,28.206116666666667,-1075,-2,1,270,269,1
BR1_2727360020,7,True,1,0,0,17586,232,46,7.2,True,3,False,0,0,0,16430,219,61,6.8,False,29.444366666666667,1156,4,1,278,280,-2
BR1_2731714707,6,True,1,0,0,16722,213,64,7.2,False,3,False,0,0,0,14169,158,52,7.0,True,26.998066666666666,2553,3,1,277,210,67
BR1_2729142638,5,True,0,0,0,17603,262,64,7.4,False,6,False,1,0,0,18136,221,64,7.6,True,29.49795,-533,-1,-1,326,285,41
BR1_2729098796,6,False,1,1,0,18573,233,56,7.6,False,6,True,0,0,0,18035,217,52,7.0,True,29.683283333333332,538,0,1,289,269,20
BR1_2717586701,5,True,0,0,0,15921,202,47,6.6,False,7,False,1,0,0,16561,196,47,6.8,True,26.711666666666666,-640,-2,-1,249,243,6
BR1_2731868239,3,True,0,1,0,14971,216,56,7.0,False,5,False,1,0,0,16852,229,52,7.2,True,25.04755,-1881,-2,-1,272,281,-9
BR1_2731857290,9,False,1,0,0,19005,257,68,7.6,True,7,True,0,0,0,17660,247,48,7.4,False,27.753533333333333,1345,2,1,325,295,30
BR1_2731842586,11,True,1,1,0,19986,245,56,7.4,False,10,False,0,0,0,18547,222,40,7.2,True,28.928316666666667,1439,1,1,301,262,39
BR1_2720788183,7,False,1,0,0,16505,210,64,7.0,True,4,True,0,0,0,15364,163,68,6.6,False,27.138616666666667,1141,3,1,274,231,43
BR1_2727523113,5,False,0,0,0,16701,209,55,7.0,False,8,True,1,0,0,20302,239,64,7.4,True,28.83685,-3601,-3,-1,264,303,-39
BR1_2668050393,10,True,0,0,0,18497,187,52,7.0,True,14,False,1,0,0,22151,226,72,7.6,False,29.5312,-3654,-4,-1,239,298,-59
BR1_2668019599,13,True,1,0,1,19160,176,54,7.0,False,9,False,0,0,0,18991,222,42,7.0,True,29.946416666666668,169,4,1,230,264,-34
BR1_2731789921,7,True,1,0,0,15323,167,67,6.6,False,7,False,0,0,0,17086,200,40,6.8,True,26.863966666666666,-1763,0,1,234,240,-6
BR1_2731372739,10,False,0,1,0,19295,177,68,7.0,True,9,True,1,0,0,19111,217,60,7.4,False,28.360166666666668,184,1,-1,245,277,-32
BR1_2731371089,6,False,0,0,0,15691,197,32,6.8,False,6,True,1,0,0,15727,207,44,6.6,True,26.566316666666665,-36,0,-1,229,251,-22
BR1_2731358729,10,False,1,0,0,18572,211,52,7.2,True,10,True,0,1,0,19654,234,54,7.4,False,29.8947,-1082,0,1,263,288,-25
BR1_2711473217,11,True,0,1,0,18378,183,60,7.0,False,8,False,1,0,0,17153,190,66,7.0,True,26.312466666666666,1225,3,-1,243,256,-13
BR1_2731470465,11,True,1,1,0,19372,192,60,7.6,True,5,False,0,0,0,16794,245,56,7.2,False,29.396516666666667,2578,6,1,252,301,-49
BR1_2712509838,8,True,1,1,0,15888,166,48,6.8,False,8,False,0,0,0,16986,218,44,6.8,True,26.645416666666666,-1098,0,1,214,262,-48
BR1_2731561308,13,True,1,1,0,19734,210,64,7.6,True,6,False,0,0,0,15922,182,48,6.8,False,26.291083333333333,3812,7,1,274,230,44
BR1_2731531201,8,False,1,0,0,19525,276,55,7.6,True,7,True,0,0,0,17741,211,59,7.0,False,29.566266666666667,1784,1,1,331,270,61
BR1_2726967859,8,False,1,0,0,16971,177,60,6.6,False,9,True,0,0,0,17331,172,51,6.8,True,25.669016666666668,-360,-1,1,237,223,14
BR1_2718115571,6,True,0,0,0,16671,213,60,6.6,False,6,False,0,0,0,16694,212,60,6.8,True,27.244833333333332,-23,0,0,273,272,1
BR1_2714782890,11,True,0,0,0,18779,207,60,7.2,True,10,False,0,0,0,19792,243,55,7.2,False,29.847216666666668,-1013,1,0,267,298,-31
BR1_2713695635,4,True,1,1,0,15333,188,48,6.8,True,5,False,0,0,0,15137,217,40,7.0,False,25.678566666666665,196,-1,1,236,257,-21
BR1_2730138912,9,True,0,0,0,18896,225,60,7.2,False,7,False,1,1,0,19818,242,68,7.8,True,27.65395,-922,2,-1,285,310,-25
BR1_2723673986,12,True,0,0,0,19439,218,53,7.0,True,10,False,0,1,0,20687,260,42,7.2,False,28.783466666666666,-1248,2,0,271,302,-31
BR1_2723658383,10,True,0,0,0,18258,222,35,7.0,False,7,False,1,0,0,16179,211,56,6.8,True,27.071283333333334,2079,3,-1,257,267,-10
BR1_2723246872,8,True,0,0,0,17805,210,64,7.0,True,5,False,0,0,0,14875,176,48,6.6,False,27.463583333333332,2930,3,0,274,224,50
BR1_2730369314,8,False,0,0,0,17943,219,44,7.0,False,6,True,0,0,0,17770,228,56,7.0,True,28.04715,173,2,0,263,284,-21
BR1_2729144956,15,True,0,0,0,20252,223,47,7.0,True,7,False,0,0,0,15981,156,48,6.2,False,26.312866666666668,4271,8,0,270,204,66
BR1_2727081216,6,False,0,0,0,15964,176,72,7.0,True,4,True,1,1,0,14994,196,44,6.6,False,26.147483333333334,970,2,-1,248,240,8
BR1_2731196136,4,True,0,0,0,16552,224,56,7.0,True,5,False,0,0,0,17582,268,60,7.6,False,29.2383,-1030,-1,0,280,328,-48
BR1_2726170926,8,True,0,1,0,20301,259,56,7.4,False,8,False,1,0,0,18608,218,64,7.4,True,29.839816666666668,1693,0,-1,315,282,33
BR1_2726149345,2,False,0,1,0,16526,249,64,7.6,False,5,True,2,0,0,17774,261,60,7.6,True,27.90355,-1248,-3,-2,313,321,-8
BR1_2711024536,7,True,0,0,0,17482,234,56,7.8,False,7,False,0,1,0,18508,233,52,7.6,True,29.720283333333334,-1026,0,0,290,285,5
BR1_2729629130,9,True,0,0,0,16822,190,56,7.0,False,8,False,0,0,0,16165,157,48,6.6,True,26.997783333333334,657,1,0,246,205,41
BR1_2729367458,10,True,0,0,0,18325,220,56,7.4,False,7,False,1,0,0,16613,197,55,6.8,True,27.21105,1712,3,-1,276,252,24
BR1_2731549746,10,True,1,1,1,21050,232,64,7.6,False,7,False,0,0,0,18149,200,52,6.8,True,29.078316666666666,2901,3,1,296,252,44
BR1_2731503730,6,False,1,0,0,15769,184,56,6.6,False,8,True,0,0,0,17208,171,56,6.6,True,26.8398,-1439,-2,1,240,227,13
BR1_2672820912,4,True,0,0,0,15044,203,43,6.6,False,8,False,0,0,0,17959,208,52,7.0,True,26.6389,-2915,-4,0,246,260,-14
BR1_2672786761,8,True,1,1,0,17751,201,63,7.4,True,9,False,0,0,0,19474,272,68,7.6,False,28.706666666666667,-1723,-1,1,264,340,-76
BR1_2731774678,6,False,0,1,0,17914,216,68,7.2,True,9,True,1,0,0,18626,195,44,6.8,False,29.6841,-712,-3,-1,284,239,45
BR1_2731841774,10,True,0,0,0,17914,213,44,6.6,True,9,False,0,0,0,16285,158,52,6.4,False,25.320416666666667,1629,1,0,257,210,47
BR1_2731831026,6,False,1,0,0,16809,223,36,7.4,False,4,True,0,0,0,15959,212,60,7.6,True,29.575683333333334,850,2,1,259,272,-13
BR1_2730164277,6,False,0,0,0,16815,207,52,6.8,False,6,True,1,0,0,16978,223,58,7.0,True,27.426733333333335,-163,0,-1,259,281,-22
BR1_2730135873,13,True,0,0,0,17983,182,64,7.0,True,4,False,0,0,0,15185,179,52,6.6,False,25.643466666666665,2798,9,0,246,231,15
BR1_2717588494,3,False,1,1,0,14928,189,64,6.8,False,2,True,0,0,0,14562,222,56,6.8,True,27.322583333333334,366,1,1,253,278,-25
BR1_2715942760,12,False,1,0,0,19969,193,64,7.0,True,5,True,0,1,0,15121,154,48,6.4,False,25.623883333333332,4848,7,1,257,202,55
BR1_2729388063,7,True,1,1,0,18578,245,56,7.6,False,3,False,0,0,0,16440,230,65,7.2,True,29.31833333333333,2138,4,1,301,295,6
BR1_2731479886,2,False,0,1,0,13457,140,64,6.4,False,4,True,0,0,0,15556,212,44,7.0,True,27.387166666666666,-2099,-2,0,204,256,-52
BR1_2731442637,10,True,0,1,0,19095,235,44,7.4,True,11,False,1,0,0,20217,216,59,7.4,False,28.6935,-1122,-1,-1,279,275,4
BR1_2731169886,7,True,0,0,0,17156,201,44,6.8,False,10,False,0,1,0,19338,220,56,7.6,True,29.00715,-2182,-3,0,245,276,-31
BR1_2714867175,6,False,1,0,0,17586,233,64,7.2,True,5,True,0,1,0,16991,206,55,7.2,False,28.763316666666668,595,1,1,297,261,36
BR1_2729130448,12,True,0,0,0,20036,229,55,7.6,True,5,False,0,0,0,17041,232,47,7.0,False,28.0953,2995,7,0,284,279,5
BR1_2727031705,6,True,0,1,0,16173,189,47,7.0,True,5,False,0,0,0,14929,180,44,6.8,False,26.815133333333332,1244,1,0,236,224,12
BR1_2731149580,8,True,0,1,0,17647,194,84,7.8,False,9,False,1,0,0,18999,211,59,7.2,True,28.6279,-1352,-1,-1,278,270,8
BR1_2722595525,4,False,0,1,0,15296,189,55,6.8,False,4,True,1,0,0,14787,190,52,6.8,True,26.69098333333333,509,0,-1,244,242,2
BR1_2722257900,6,False,1,0,0,15170,161,52,6.6,True,8,True,0,0,0,17352,208,47,7.2,False,26.566266666666667,-2182,-2,1,213,255,-42
BR1_2709676441,8,True,0,1,0,20400,219,66,7.6,True,13,False,1,0,0,20481,263,68,7.6,False,28.396066666666666,-81,-5,-1,285,331,-46
BR1_2730793966,4,False,1,0,0,15378,175,56,6.6,False,11,True,0,0,0,19172,203,60,7.2,True,27.8701,-3794,-7,1,231,263,-32
BR1_2729301791,6,False,1,1,0,16246,200,56,7.0,True,5,True,0,0,0,15766,194,52,6.8,False,27.043566666666667,480,1,1,256,246,10
BR1_2731936599,5,False,0,0,0,15488,165,52,6.4,False,9,True,1,0,0,16707,196,54,7.0,True,26.497466666666668,-1219,-4,-1,217,250,-33
BR1_2731464414,4,True,1,0,0,15854,212,44,6.6,False,7,False,0,0,0,16441,242,52,7.0,True,26.6465,-587,-3,1,256,294,-38
BR1_2731040936,15,True,1,1,0,22316,255,60,7.6,True,2,False,0,0,0,14889,171,60,6.4,False,28.129266666666666,7427,13,1,315,231,84
BR1_2726085308,7,True,1,0,0,17056,218,64,7.0,True,6,False,0,1,0,15633,191,48,7.0,False,25.249216666666666,1423,1,1,282,239,43
BR1_2726051632,4,False,0,0,0,15796,208,42,7.2,False,8,True,1,0,0,17587,226,44,7.2,True,29.191416666666665,-1791,-4,-1,250,270,-20
BR1_2726033280,5,False,0,0,0,15612,210,50,6.6,False,8,True,1,0,0,17409,182,50,6.6,True,26.436366666666668,-1797,-3,-1,260,232,28
BR1_2725118292,7,True,1,0,0,18415,211,52,7.2,False,10,False,0,0,0,19254,241,51,7.2,True,29.45991666666667,-839,-3,1,263,292,-29
BR1_2725524373,11,True,1,0,0,19052,208,44,7.0,True,10,False,0,0,0,17117,159,52,6.8,False,26.497116666666667,1935,1,1,252,211,41
BR1_2727256584,4,False,0,0,0,15916,220,71,7.2,True,4,True,1,0,0,14482,178,48,6.6,False,27.196733333333334,1434,0,-1,291,226,65
BR1_2724577519,3,True,1,0,0,16475,227,56,7.0,False,6,False,0,1,0,17872,239,58,7.6,True,29.387283333333333,-1397,-3,1,283,297,-14
BR1_2731620523,4,False,0,1,0,15941,208,76,7.0,False,6,True,1,0,0,15839,189,48,6.4,True,26.327516666666668,102,-2,-1,284,237,47
BR1_2731597885,10,True,1,0,0,16940,183,47,6.8,True,5,False,0,0,0,16099,191,56,6.6,False,26.736883333333335,841,5,1,230,247,-17
BR1_2731511918,8,True,1,1,0,17798,207,52,6.8,True,13,False,0,0,1,22295,242,51,7.6,False,27.789916666666667,-4497,-5,1,259,293,-34
BR1_2730778463,6,True,1,0,0,17601,222,72,7.0,False,4,False,0,0,0,17434,249,68,7.6,True,27.740916666666667,167,2,1,294,317,-23
BR1_2730721591,9,True,1,1,0,19029,252,60,7.4,True,3,False,0,0,0,16747,230,76,7.4,False,27.687166666666666,2282,6,1,312,306,6
BR1_2731809512,6,True,0,1,0,17154,202,56,7.0,True,1,False,0,0,0,14027,205,64,6.4,False,25.953116666666666,3127,5,0,258,269,-11
BR1_2731348867,13,True,0,0,0,20659,210,57,7.4,True,9,False,0,1,0,16533,140,50,6.0,False,26.9521,4126,4,0,267,190,77
BR1_2731785896,14,False,0,1,0,20817,203,56,7.2,True,15,True,1,0,0,20540,192,64,7.0,False,29.7056,277,-1,-1,259,256,3
BR1_2731179193,5,False,0,0,0,15556,181,60,6.8,False,15,True,0,0,0,19701,228,40,7.2,True,26.336466666666666,-4145,-10,0,241,268,-27
BR1_2731773325,11,False,0,1,0,17118,158,60,6.8,True,10,True,0,0,0,17635,189,47,6.6,False,26.256166666666665,-517,1,0,218,236,-18
BR1_2730316132,7,True,1,0,0,17042,198,60,7.2,True,8,False,0,0,0,18506,240,52,7.4,False,28.52385,-1464,-1,1,258,292,-34
BR1_2729674794,3,False,0,0,0,15934,252,56,7.0,False,6,True,1,1,0,17964,238,68,7.4,True,28.79995,-2030,-3,-1,308,306,2
BR1_2730116151,9,False,0,0,0,18791,190,52,7.0,True,13,True,1,1,0,21097,214,72,7.8,False,27.630116666666666,-2306,-4,-1,242,286,-44
BR1_2730037542,14,True,1,1,1,22794,200,52,7.0,True,3,False,0,0,0,14299,171,60,6.8,False,29.768333333333334,8495,11,1,252,231,21
BR1_2730675878,12,True,1,0,0,18276,167,52,6.4,False,12,False,0,0,0,18073,189,53,7.0,True,26.755783333333333,203,0,1,219,242,-23
BR1_2718312657,10,False,0,0,0,18235,201,54,7.2,True,8,True,0,0,0,18633,220,48,7.4,False,29.76355,-398,2,0,255,268,-13
BR1_2730609314,12,True,0,0,0,18854,225,48,7.2,True,8,False,1,0,0,16866,169,60,6.6,False,25.1323,1988,4,-1,273,229,44
BR1_2729314000,1,False,1,0,0,14402,191,64,7.2,True,3,True,0,0,0,14377,199,48,6.8,False,25.867366666666666,25,-2,1,255,247,8
BR1_2731616367,4,False,1,0,0,16904,225,72,7.0,True,3,True,0,0,0,14926,197,48,6.4,False,26.638166666666667,1978,1,1,297,245,52
BR1_2731591830,5,False,0,0,0,16323,206,64,7.2,True,14,True,1,1,1,22341,202,68,7.8,False,27.7137,-6018,-9,-1,270,270,0
BR1_2726675229,8,True,1,0,0,18661,233,56,7.4,True,9,False,0,0,0,18583,259,60,7.4,False,29.7384,78,-1,1,289,319,-30
BR1_2726662570,5,False,1,0,0,17190,182,60,6.6,False,11,True,0,1,0,20499,253,68,7.2,True,28.420816666666667,-3309,-6,1,242,321,-79
BR1_2726044877,8,False,0,1,1,20076,236,67,7.6,False,8,True,1,0,0,18741,232,60,7.4,True,29.175016666666668,1335,0,-1,303,292,11
BR1_2731468146,7,False,0,0,0,17412,195,64,7.2,False,8,True,0,1,0,18584,224,50,7.4,True,28.034883333333333,-1172,-1,0,259,274,-15
BR1_2731694126,7,False,0,0,0,16833,198,40,6.4,False,13,True,0,0,0,19393,233,48,7.0,True,26.6049,-2560,-6,0,238,281,-43
BR1_2730080140,6,False,1,0,0,15949,217,52,7.0,False,7,True,0,0,0,16449,211,56,6.6,True,26.314316666666667,-500,-1,1,269,267,2
BR1_2731727513,7,False,1,0,0,17235,226,60,7.4,False,7,True,0,1,0,18959,238,60,7.0,True,29.36095,-1724,0,1,286,298,-12
BR1_2730731424,10,False,0,1,0,17887,177,40,7.0,True,6,True,1,0,0,16778,195,51,6.8,False,26.73965,1109,4,-1,217,246,-29
BR1_2730218789,2,False,1,1,0,16487,242,80,7.4,True,6,True,0,0,0,17125,210,52,7.4,False,29.913133333333334,-638,-4,1,322,262,60
BR1_2731914344,2,False,0,1,0,14920,212,64,7.2,False,7,True,1,0,0,16696,207,52,7.4,True,27.030866666666668,-1776,-5,-1,276,259,17
BR1_2686486500,3,False,0,0,0,16331,228,64,7.4,False,6,True,1,0,0,18460,242,68,7.8,True,29.578566666666667,-2129,-3,-1,292,310,-18
BR1_2686281551,9,False,0,0,0,19226,191,54,7.2,False,14,True,1,0,0,21451,231,50,7.6,True,29.072033333333334,-2225,-5,-1,245,281,-36
BR1_2686258814,6,False,1,0,0,16609,212,79,7.6,False,9,True,0,0,0,18163,212,68,7.6,True,27.728683333333333,-1554,-3,1,291,280,11
BR1_2685968558,6,True,0,0,0,17875,241,52,7.2,False,7,False,1,0,0,18569,234,68,7.8,True,28.1272,-694,-1,-1,293,302,-9
BR1_2729685955,5,True,0,0,0,15334,194,50,6.8,True,4,False,1,0,0,14875,172,60,6.8,False,27.070933333333333,459,1,-1,244,232,12
BR1_2731729546,4,False,0,1,0,14381,169,55,6.2,False,9,True,0,0,0,16631,154,44,6.4,True,25.43016666666667,-2250,-5,0,224,198,26
BR1_2731067061,7,False,1,1,0,16343,165,60,6.8,True,8,True,0,0,0,17522,206,56,6.8,False,27.219566666666665,-1179,-1,1,225,262,-37
BR1_2731036834,5,False,0,0,0,16247,197,64,7.0,False,8,True,1,0,0,19830,255,75,7.6,True,28.476566666666667,-3583,-3,-1,261,330,-69
BR1_2730192809,1,True,0,0,0,14204,217,58,6.4,True,8,False,1,0,0,17199,211,60,7.0,False,26.22215,-2995,-7,-1,275,271,4
BR1_2731914903,8,False,0,1,0,17701,215,68,7.2,False,14,True,1,0,0,20956,185,56,7.2,True,29.053716666666666,-3255,-6,-1,283,241,42
BR1_2730712696,1,False,0,1,0,15599,218,60,7.0,False,5,True,0,0,0,17333,234,56,7.0,True,27.74513333333333,-1734,-4,0,278,290,-12
BR1_2731295874,8,True,1,1,0,19358,232,48,7.4,True,4,False,0,0,0,17660,248,56,7.4,False,28.764516666666665,1698,4,1,280,304,-24
BR1_2726106211,8,True,0,0,0,17401,209,52,6.8,True,6,False,0,0,0,16647,217,44,6.8,False,25.709933333333332,754,2,0,261,261,0
BR1_2728939444,7,False,0,0,0,17031,196,54,7.2,True,9,True,1,1,0,19780,220,60,7.2,False,29.41111666666667,-2749,-2,-1,250,280,-30
BR1_2708576050,7,True,1,1,0,18068,218,66,7.6,True,7,False,0,0,0,16300,180,49,7.6,False,29.26585,1768,0,1,284,229,55
BR1_2729864150,9,True,1,1,0,18873,244,68,7.4,True,6,False,0,0,0,18098,246,43,7.4,False,28.779866666666667,775,3,1,312,289,23
BR1_2729829874,8,True,0,1,0,16383,191,40,6.8,True,5,False,0,0,0,15655,202,54,6.8,False,25.01545,728,3,0,231,256,-25
BR1_2731849962,12,False,0,0,0,17493,168,56,6.8,False,9,True,1,1,0,17580,184,60,6.8,True,27.29865,-87,3,-1,224,244,-20
BR1_2730365098,10,True,0,1,0,18175,214,60,7.2,True,5,False,1,0,0,14535,161,48,7.2,False,26.785133333333334,3640,5,-1,274,209,65
BR1_2729231499,8,True,0,1,0,18841,215,66,7.6,True,7,False,1,0,0,18219,267,36,7.2,False,29.31005,622,1,-1,281,303,-22
BR1_2710820544,9,True,1,0,0,17674,229,56,7.2,True,2,False,0,0,0,14101,192,59,7.0,False,27.311433333333333,3573,7,1,285,251,34
BR1_2730926952,6,False,1,0,0,16918,197,56,7.2,True,7,True,0,0,0,17396,228,64,7.4,False,27.686933333333332,-478,-1,1,253,292,-39
BR1_2730768127,2,False,0,0,0,14109,176,44,6.6,False,10,True,1,0,0,18512,234,56,7.0,True,26.92265,-4403,-8,-1,220,290,-70
BR1_2730678730,8,False,0,1,0,18877,235,68,7.4,True,8,True,1,0,1,20510,222,63,7.6,False,28.70975,-1633,0,-1,303,285,18
BR1_2727259567,5,False,1,0,0,16724,238,57,7.2,True,6,True,0,1,0,16686,197,54,7.0,False,27.408633333333334,38,-1,1,295,251,44
BR1_2731219015,5,False,0,0,0,15249,217,68,6.6,False,7,True,0,0,0,16684,191,56,6.8,True,27.437866666666668,-1435,-2,0,285,247,38
BR1_2731155292,12,False,1,1,0,20516,221,44,7.2,False,12,True,0,0,0,21072,240,56,7.2,True,29.56575,-556,0,1,265,296,-31
BR1_2731122517,6,False,1,1,0,17701,236,56,7.4,True,6,True,0,0,0,16803,236,44,7.0,False,28.78783333333333,898,0,1,292,280,12
BR1_2731100995,9,True,1,0,0,17281,202,55,6.6,True,6,False,0,0,0,16096,207,52,6.6,False,27.403166666666667,1185,3,1,257,259,-2
BR1_2731093856,7,False,1,0,0,16596,204,61,6.8,True,4,True,0,0,0,15249,203,46,6.4,False,26.929433333333332,1347,3,1,265,249,16
BR1_2731654362,7,True,0,0,0,15623,146,48,6.0,False,9,False,1,0,0,17254,197,60,6.4,True,27.295066666666667,-1631,-2,-1,194,257,-63
BR1_2731509026,9,False,1,0,0,18557,205,48,7.4,False,6,True,0,1,0,17889,223,64,7.0,True,27.680683333333334,668,3,1,253,287,-34
BR1_2731487046,7,True,1,1,0,19536,264,64,7.6,True,2,False,0,0,0,16376,223,64,7.0,False,29.010983333333332,3160,5,1,328,287,41
BR1_2729855197,6,False,0,1,0,15622,194,44,6.8,True,10,True,1,0,0,18005,200,62,6.8,False,26.9793,-2383,-4,-1,238,262,-24
BR1_2729701166,8,True,1,1,0,17447,206,56,7.0,False,12,False,0,0,0,19470,227,48,7.2,True,26.489266666666666,-2023,-4,1,262,275,-13
BR1_2727404063,10,True,0,1,0,18493,214,48,7.0,False,8,False,0,0,0,16540,182,44,6.8,True,25.97115,1953,2,0,262,226,36
BR1_2727334118,10,True,1,0,0,20076,248,48,7.2,True,3,False,0,1,0,15932,226,56,7.4,False,29.6095,4144,7,1,296,282,14
BR1_2727278177,13,True,0,0,0,20510,211,44,7.6,True,4,False,1,1,0,17421,240,52,7.2,False,29.032283333333332,3089,9,-1,255,292,-37
BR1_2730780877,4,False,0,0,0,17082,235,60,7.6,False,4,True,1,0,0,17897,270,64,7.4,True,27.894183333333334,-815,0,-1,295,334,-39
BR1_2730723999,4,False,1,0,0,16778,232,56,7.4,False,6,True,0,1,0,18130,238,79,7.4,True,29.279783333333334,-1352,-2,1,288,317,-29
BR1_2730685277,8,True,0,1,0,19210,265,76,7.6,True,4,False,1,0,0,18400,251,58,7.6,False,29.157383333333332,810,4,-1,341,309,32
BR1_2731492598,5,True,0,0,0,15320,171,56,6.6,False,9,False,1,0,0,18221,217,71,7.4,True,25.352133333333335,-2901,-4,-1,227,288,-61
BR1_2715423297,6,True,0,1,0,18255,233,54,7.4,False,9,False,1,0,0,19316,227,60,7.2,True,27.66155,-1061,-3,-1,287,287,0
BR1_2715377303,9,True,1,0,0,19725,227,60,7.6,True,10,False,0,0,0,19207,219,64,7.4,False,28.891666666666666,518,-1,1,287,283,4
BR1_2729484370,4,True,0,0,0,16804,244,60,7.2,True,12,False,1,1,0,19402,235,64,8.0,False,29.217183333333335,-2598,-8,-1,304,299,5
BR1_2729458205,4,True,1,1,0,17004,255,64,7.4,True,2,False,0,0,0,16095,246,44,7.4,False,29.859966666666665,909,2,1,319,290,29
BR1_2731017054,13,True,0,1,0,20914,215,48,7.2,False,6,False,0,0,0,17630,229,68,7.0,True,28.1718,3284,7,0,263,297,-34
BR1_2730958115,9,True,0,1,0,18915,208,48,6.6,False,11,False,1,0,0,20968,232,60,7.6,True,27.84101666666667,-2053,-2,-1,256,292,-36
BR1_2697141233,4,False,0,1,0,16197,180,68,7.2,False,13,True,0,0,0,19476,234,62,7.6,True,28.05785,-3279,-9,0,248,296,-48
BR1_2726395876,4,True,0,0,0,15381,211,40,6.6,True,5,False,0,0,0,15729,207,55,6.8,False,26.37923333333333,-348,-1,0,251,262,-11
BR1_2718474949,7,True,0,0,0,16339,209,36,6.6,False,7,False,1,0,0,16618,225,48,7.0,True,25.255516666666665,-279,0,-1,245,273,-28
BR1_2731031458,7,False,1,0,0,16188,199,60,6.6,False,9,True,0,1,0,18491,209,64,7.2,True,26.709933333333332,-2303,-2,1,259,273,-14
BR1_2731015074,8,True,0,0,0,17891,229,60,7.0,True,4,False,1,1,0,15816,198,64,7.0,False,25.257666666666665,2075,4,-1,289,262,27
BR1_2730991975,4,False,0,1,0,16698,211,64,7.2,True,7,True,1,0,0,16975,226,44,6.8,False,28.39915,-277,-3,-1,275,270,5
BR1_2731565299,8,True,1,0,0,18552,244,44,7.0,True,8,False,0,0,0,18255,214,51,7.2,False,29.514833333333332,297,0,1,288,265,23
BR1_2730779055,4,True,1,0,0,16101,204,52,6.8,False,10,False,0,1,0,19014,194,72,7.2,True,25.940366666666666,-2913,-6,1,256,266,-10
BR1_2730747387,7,True,0,0,0,19223,246,58,7.2,True,6,False,1,1,0,16398,197,58,7.2,False,28.490883333333333,2825,1,-1,304,255,49
BR1_2730585466,8,False,0,0,0,18661,220,72,7.4,True,9,True,1,1,0,19363,230,56,7.6,False,29.306783333333332,-702,-1,-1,292,286,6
BR1_2730260437,8,True,1,0,0,17311,213,68,7.2,True,7,False,0,0,0,16942,222,56,7.2,False,27.10795,369,1,1,281,278,3
BR1_2730546124,5,False,0,0,0,15900,229,46,6.8,True,8,True,1,0,0,16755,187,48,6.4,False,26.884233333333334,-855,-3,-1,275,235,40
BR1_2692047998,5,True,0,1,0,16426,203,55,6.8,False,7,False,1,0,0,16135,190,58,7.0,True,25.991966666666666,291,-2,-1,258,248,10
BR1_2701695399,8,False,0,1,0,19823,254,64,7.6,False,12,True,1,0,0,19234,199,64,7.4,True,29.198483333333332,589,-4,-1,318,263,55
BR1_2719508768,7,False,1,0,0,17119,195,60,7.0,False,6,True,0,0,0,19271,266,57,7.4,True,29.366383333333335,-2152,1,1,255,323,-68
BR1_2719003564,10,False,1,0,0,20232,257,80,8.0,False,6,True,0,0,0,17495,211,52,7.2,True,27.921166666666668,2737,4,1,337,263,74
BR1_2731337920,12,True,1,1,0,19914,186,84,7.4,True,5,False,0,0,0,16539,196,44,6.6,False,25.153883333333333,3375,7,1,270,240,30
BR1_2730571103,7,False,0,0,0,15979,192,60,7.0,False,8,True,0,0,0,16993,201,56,6.4,True,26.123166666666666,-1014,-1,0,252,257,-5
BR1_2730528820,9,False,0,0,0,18152,208,57,7.0,True,5,True,1,0,0,16006,221,42,6.6,False,26.34423333333333,2146,4,-1,265,263,2
BR1_2731235226,5,True,1,1,0,18338,261,80,7.6,True,2,False,0,0,0,16145,252,48,7.4,False,29.386866666666666,2193,3,1,341,300,41
BR1_2728533544,13,True,1,0,0,20667,233,72,7.6,True,4,False,0,0,0,17297,220,47,7.0,False,29.25915,3370,9,1,305,267,38
BR1_2726555882,11,False,1,1,0,20338,237,61,7.4,True,9,True,0,0,0,18413,193,72,7.0,False,27.908583333333333,1925,2,1,298,265,33
BR1_2731626836,10,True,0,0,0,17096,202,36,6.6,True,4,False,1,0,0,15244,189,64,6.6,False,27.19535,1852,6,-1,238,253,-15
BR1_2731519509,5,False,0,0,0,15146,175,60,6.4,False,10,True,1,0,0,18264,211,44,7.0,True,25.557783333333333,-3118,-5,-1,235,255,-20
BR1_2678093197,10,False,1,0,0,18111,173,56,6.8,True,8,True,0,1,0,16634,177,56,6.6,False,25.243366666666667,1477,2,1,229,233,-4
BR1_2731749386,8,False,1,0,0,17305,201,56,6.8,True,8,True,0,0,0,17107,193,52,6.6,False,26.238333333333333,198,0,1,257,245,12
BR1_2731697758,5,False,0,1,0,17667,246,60,7.2,True,8,True,1,0,0,18362,253,60,7.2,False,27.631316666666667,-695,-3,-1,306,313,-7
BR1_2731675718,2,False,0,0,0,16070,219,59,6.6,False,8,True,1,0,0,16623,203,60,7.0,True,26.36955,-553,-6,-1,278,263,15
BR1_2731825570,12,True,1,1,0,18720,184,72,7.2,True,6,False,0,0,0,16574,212,60,6.6,False,26.8904,2146,6,1,256,272,-16
BR1_2731766263,6,False,0,0,0,15357,164,44,6.2,False,8,True,1,0,0,17524,212,48,6.8,True,27.341116666666668,-2167,-2,-1,208,260,-52
BR1_2730189131,3,True,1,0,0,17700,244,60,7.6,True,0,False,0,0,0,15857,277,60,7.6,False,29.498833333333334,1843,3,1,304,337,-33
BR1_2705719198,6,True,0,0,0,16718,205,71,6.8,True,11,False,0,0,0,17759,189,50,7.0,False,25.760183333333334,-1041,-5,0,276,239,37
BR1_2689661406,4,False,0,0,0,13987,169,39,6.0,False,10,True,1,1,0,19323,231,60,7.2,True,25.474116666666667,-5336,-6,-1,208,291,-83
BR1_2689640731,14,False,0,0,0,20964,195,48,6.8,True,7,True,1,0,0,15539,180,52,6.6,False,26.22285,5425,7,-1,243,232,11
BR1_2689619552,8,False,0,0,0,18402,235,48,7.0,True,9,True,0,1,0,18632,207,44,7.0,False,28.646433333333334,-230,-1,0,283,251,32
BR1_2688764242,10,True,1,0,0,19243,242,60,7.4,True,4,False,0,0,0,15934,213,52,7.0,False,28.91345,3309,6,1,302,265,37
BR1_2688108596,2,False,0,0,0,13836,171,56,6.4,False,12,True,1,0,0,18149,204,72,7.0,True,26.0311,-4313,-10,-1,227,276,-49
BR1_2723827238,7,True,0,0,0,16533,196,68,7.0,True,7,False,0,1,0,15986,186,52,7.2,False,27.313866666666666,547,0,0,264,238,26
BR1_2731930845,11,False,1,0,0,18745,170,52,7.2,False,10,True,0,0,0,19992,193,80,7.6,True,29.602916666666665,-1247,1,1,222,273,-51
BR1_2731737514,6,True,1,0,0,16365,208,48,6.6,False,3,False,0,1,0,15733,214,60,7.0,True,25.102883333333335,632,3,1,256,274,-18
BR1_2730733586,7,True,1,0,0,16368,195,60,6.8,False,3,False,0,0,0,14643,229,32,6.8,True,26.090916666666665,1725,4,1,255,261,-6
BR1_2724315495,3,False,0,0,0,16304,260,52,7.4,False,4,True,1,1,0,17724,260,72,7.6,True,27.584116666666667,-1420,-1,-1,312,332,-20
BR1_2723364346,2,False,0,0,0,15818,204,68,7.2,False,7,True,1,0,0,18780,247,56,7.4,True,29.296983333333333,-2962,-5,-1,272,303,-31
BR1_2731242515,8,True,1,0,0,16678,219,64,7.0,True,1,False,0,1,0,13908,202,56,6.8,False,26.189616666666666,2770,7,1,283,258,25
BR1_2717034473,5,False,0,0,0,16503,185,48,7.0,False,9,True,1,0,0,18868,219,64,7.4,True,29.303283333333333,-2365,-4,-1,233,283,-50
BR1_2717017279,6,True,1,0,0,16270,235,60,7.0,True,4,False,0,0,0,14957,211,35,7.0,False,26.712283333333332,1313,2,1,295,246,49
BR1_2731283976,7,True,0,0,0,15958,205,50,6.2,False,6,False,1,1,0,16181,191,43,6.6,True,25.887733333333333,-223,1,-1,255,234,21
BR1_2731668844,6,False,0,1,0,15792,173,52,7.0,True,4,True,0,0,0,16024,192,52,6.8,False,25.034133333333333,-232,2,0,225,244,-19
BR1_2730655804,4,False,0,0,0,15183,191,44,6.8,False,8,True,1,0,0,16783,181,72,6.8,True,27.498383333333333,-1600,-4,-1,235,253,-18
BR1_2730529481,5,True,0,0,0,15889,192,70,6.8,False,7,False,1,0,0,16771,197,57,6.8,True,26.642666666666667,-882,-2,-1,262,254,8
BR1_2726251787,2,True,1,0,0,14799,199,48,6.8,False,7,False,0,1,0,17658,224,56,6.8,True,25.25005,-2859,-5,1,247,280,-33
BR1_2730200012,6,False,0,0,0,16334,206,48,7.0,False,9,True,0,1,0,19370,214,48,7.0,True,29.372866666666667,-3036,-3,0,254,262,-8
BR1_2699582330,13,True,0,0,0,18913,192,44,6.6,True,7,False,0,0,0,16015,173,48,6.4,False,27.235083333333332,2898,6,0,236,221,15
BR1_2699017024,7,False,0,0,0,17359,261,46,7.6,False,11,True,1,1,0,20272,232,60,7.2,True,28.906766666666666,-2913,-4,-1,307,292,15
BR1_2722586544,8,False,0,0,0,16913,169,40,7.0,False,11,True,0,1,0,20379,213,68,7.4,True,27.970666666666666,-3466,-3,0,209,281,-72
BR1_2730498289,9,True,0,1,0,18398,207,51,6.8,True,11,False,1,0,0,18435,208,52,6.8,False,27.15615,-37,-2,-1,258,260,-2
BR1_2730095101,11,True,0,1,0,18783,183,56,6.6,False,11,False,1,0,0,18892,192,51,7.2,True,27.014966666666666,-109,0,-1,239,243,-4
BR1_2717899088,9,False,1,1,0,17362,175,76,7.0,True,9,True,0,0,0,17022,166,52,6.4,False,25.107433333333333,340,0,1,251,218,33
BR1_2676123687,8,True,1,1,0,18579,241,60,7.2,True,4,False,0,0,0,15179,204,40,6.8,False,27.003266666666665,3400,4,1,301,244,57
BR1_2668629806,3,False,0,1,0,16930,237,68,7.2,False,10,True,1,0,0,19826,250,64,7.8,True,28.645133333333334,-2896,-7,-1,305,314,-9
BR1_2717322992,3,False,1,1,0,15147,225,52,6.6,True,10,True,0,0,0,19077,232,48,7.0,False,27.2837,-3930,-7,1,277,280,-3
BR1_2731759300,6,False,1,0,0,15687,175,60,6.6,True,5,True,0,0,0,14176,162,36,6.4,False,25.5165,1511,1,1,235,198,37
BR1_2726543582,6,False,0,0,0,16468,199,64,7.2,True,5,True,0,0,0,16703,222,56,6.8,False,26.749316666666665,-235,1,0,263,278,-15
BR1_2729246528,8,True,1,0,0,16470,193,40,6.4,False,12,False,0,0,0,19232,205,48,6.8,True,27.178966666666668,-2762,-4,1,233,253,-20
BR1_2731339765,4,True,0,1,0,15402,179,55,6.8,True,7,False,1,0,0,15814,143,48,6.8,False,26.076166666666666,-412,-3,-1,234,191,43
BR1_2728156555,10,False,1,0,0,19870,237,60,7.2,True,10,True,0,1,0,19229,225,56,7.0,False,28.697883333333333,641,0,1,297,281,16
BR1_2726068910,6,True,0,0,0,17600,231,56,7.2,False,7,False,1,0,0,18831,250,64,7.4,True,28.95405,-1231,-1,-1,287,314,-27
BR1_2730849158,12,True,1,1,0,19998,195,45,7.2,True,6,False,0,0,0,17532,193,64,6.8,False,27.6345,2466,6,1,240,257,-17
BR1_2729150144,6,True,1,0,0,18141,256,60,7.4,True,1,False,0,0,0,14275,197,52,6.8,False,27.7897,3866,5,1,316,249,67
BR1_2729126617,3,True,1,1,0,16264,215,60,7.2,False,7,False,0,0,0,18340,241,72,7.6,True,29.936216666666667,-2076,-4,1,275,313,-38
BR1_2725841542,5,False,1,0,0,16879,224,63,7.2,False,11,True,0,0,0,20361,237,68,7.6,True,28.027683333333332,-3482,-6,1,287,305,-18
BR1_2730286008,2,False,0,0,0,13794,176,52,6.6,False,4,True,0,1,0,16139,211,51,6.6,True,26.422,-2345,-2,0,228,262,-34
BR1_2730254304,8,True,0,0,0,16389,191,40,6.8,True,6,False,0,0,0,16874,217,72,7.0,False,25.928483333333332,-485,2,0,231,289,-58
BR1_2670368284,8,True,0,0,0,16347,199,52,7.0,True,4,False,1,0,0,13888,168,56,6.4,False,25.375766666666667,2459,4,-1,251,224,27
BR1_2669824210,10,True,0,0,0,18494,202,52,7.2,True,7,False,0,0,0,17446,234,48,7.4,False,27.8707,1048,3,0,254,282,-28
BR1_2731821538,1,False,0,0,0,13817,208,59,6.6,False,8,True,1,0,0,17210,240,52,7.0,True,25.519266666666667,-3393,-7,-1,267,292,-25
BR1_2731202846,12,False,0,1,0,19544,194,44,6.8,False,17,True,1,0,0,22788,235,72,7.4,True,28.12335,-3244,-5,-1,238,307,-69
BR1_2730877284,6,True,0,0,0,16918,228,64,7.2,True,4,False,0,0,0,15023,199,44,6.6,False,25.541966666666667,1895,2,0,292,243,49
BR1_2731908442,3,False,0,0,0,15882,192,62,7.2,False,10,True,0,1,0,20328,276,74,7.8,True,28.36275,-4446,-7,0,254,350,-96
BR1_2731069596,4,False,1,0,0,15137,196,60,6.8,False,3,True,0,0,0,14571,203,60,6.6,True,25.432666666666666,566,1,1,256,263,-7
BR1_2729022847,5,False,0,0,0,15177,216,48,6.8,False,3,True,0,0,0,15281,221,68,7.2,True,26.108066666666666,-104,2,0,264,289,-25
BR1_2731135171,10,True,0,1,0,19412,199,55,6.8,True,11,False,1,0,0,18469,195,51,6.6,False,25.0015,943,-1,-1,254,246,8
BR1_2731665101,4,True,1,0,0,14137,161,52,6.4,False,6,False,0,0,0,15484,178,48,6.2,True,26.444733333333332,-1347,-2,1,213,226,-13
BR1_2730712452,7,True,0,0,0,17075,209,64,7.4,True,6,False,0,0,0,15677,195,56,7.0,False,25.637483333333332,1398,1,0,273,251,22
BR1_2731641868,9,True,1,1,0,18323,225,48,7.8,True,5,False,0,0,0,16605,238,56,7.4,False,27.938766666666666,1718,4,1,273,294,-21
BR1_2731592432,5,False,0,1,0,16050,207,52,6.8,False,6,True,0,0,0,15819,192,52,6.8,True,26.474433333333334,231,-1,0,259,244,15
BR1_2731169894,12,True,1,0,0,20321,196,68,7.4,True,7,False,0,0,0,17958,229,60,7.2,False,29.960066666666666,2363,5,1,264,289,-25
BR1_2731122692,1,True,0,1,0,13510,184,56,6.6,False,6,False,1,0,0,16899,228,60,7.0,True,27.1258,-3389,-5,-1,240,288,-48
BR1_2710589679,15,True,0,0,0,19765,200,52,7.2,True,3,False,1,0,0,14811,150,48,6.4,False,26.395616666666665,4954,12,-1,252,198,54
BR1_2710571228,9,False,0,0,0,16962,146,48,6.4,True,11,True,0,0,0,18680,219,56,7.0,False,26.134366666666665,-1718,-2,0,194,275,-81
BR1_2731807372,5,True,1,0,0,17227,244,64,7.6,False,3,False,0,0,0,16840,232,64,7.4,True,29.455083333333334,387,2,1,308,296,12
BR1_2728041659,9,True,0,1,0,18104,189,56,7.2,True,9,False,1,0,0,17979,198,47,6.6,False,29.39,125,0,-1,245,245,0
BR1_2728280673,4,False,1,0,0,16289,220,68,7.0,True,13,True,0,1,0,19775,224,56,7.6,False,28.525083333333335,-3486,-9,1,288,280,8
BR1_2731318332,9,True,1,1,0,18923,229,64,7.8,True,2,False,0,0,0,15004,212,59,7.0,False,27.692466666666668,3919,7,1,293,271,22
BR1_2730205330,8,True,0,0,0,15745,183,47,6.4,False,10,False,0,0,0,17799,202,48,6.4,True,25.06595,-2054,-2,0,230,250,-20
BR1_2728071645,9,False,1,0,0,17317,213,44,6.6,False,13,True,0,0,0,18759,182,56,6.8,True,25.70456666666667,-1442,-4,1,257,238,19
BR1_2728309706,10,True,1,0,0,18108,189,56,6.8,True,9,False,0,0,0,17054,200,48,6.8,False,27.055416666666666,1054,1,1,245,248,-3
BR1_2726040242,7,False,0,0,0,15678,188,52,6.8,False,5,True,1,0,0,16884,209,60,7.0,True,25.624433333333332,-1206,2,-1,240,269,-29
BR1_2731939435,10,True,0,0,0,17070,187,51,6.8,True,5,False,0,0,0,15691,191,56,6.8,False,27.09648333333333,1379,5,0,238,247,-9
BR1_2731913608,4,True,1,1,0,16295,198,52,7.2,True,1,False,0,0,0,14731,211,60,7.2,False,28.50485,1564,3,1,250,271,-21
BR1_2731561088,6,False,0,0,0,15299,182,54,7.2,False,7,True,0,0,0,16990,206,61,7.0,True,26.970533333333332,-1691,-1,0,236,267,-31
BR1_2731601442,3,False,0,0,0,15822,185,56,7.2,False,10,True,1,0,0,19523,245,64,7.2,True,28.119066666666665,-3701,-7,-1,241,309,-68
BR1_2724625754,5,True,0,1,0,16614,218,83,7.0,True,6,False,1,0,0,15896,196,55,6.8,False,25.815416666666668,718,-1,-1,301,251,50
BR1_2723114210,11,True,1,0,0,18308,213,72,7.2,True,2,False,0,0,0,13486,164,48,6.2,False,26.452916666666667,4822,9,1,285,212,73
BR1_2731735421,10,False,1,1,0,18626,210,56,7.2,True,7,True,0,0,0,18111,202,56,7.4,False,28.522366666666667,515,3,1,266,258,8
BR1_2725130868,5,False,0,0,0,15824,225,52,6.8,True,6,True,1,0,0,16568,235,56,6.8,False,26.97298333333333,-744,-1,-1,277,291,-14
BR1_2725732464,7,False,1,0,0,18944,261,68,7.6,True,6,True,0,1,0,17868,224,60,7.4,False,29.6527,1076,1,1,329,284,45
BR1_2725653609,5,True,1,1,0,16540,216,48,6.6,True,2,False,0,0,0,14255,179,52,6.8,False,25.29768333333333,2285,3,1,264,231,33
BR1_2729381978,6,False,0,0,0,15525,156,58,6.4,False,6,True,1,1,0,16840,190,54,7.2,True,25.064983333333334,-1315,0,-1,214,244,-30
BR1_2727428951,6,False,0,0,0,15730,199,48,6.8,False,6,True,1,0,0,17381,213,64,6.8,True,25.18775,-1651,0,-1,247,277,-30
BR1_2731283024,14,True,1,0,0,20633,248,48,7.0,True,1,False,0,1,0,13941,186,68,6.8,False,25.653916666666667,6692,13,1,296,254,42
BR1_2729336656,12,True,0,0,0,20227,216,68,7.8,True,5,False,1,0,0,16956,216,47,7.0,False,28.6052,3271,7,-1,284,263,21
BR1_2728736395,1,False,1,1,0,13337,150,48,6.8,True,7,True,0,0,0,18505,229,72,7.2,False,28.9261,-5168,-6,1,198,301,-103
BR1_2730864093,3,False,1,0,0,14406,216,50,7.0,False,6,True,0,1,0,17111,222,55,7.0,True,25.731233333333332,-2705,-3,1,266,277,-11
BR1_2730433134,5,False,0,1,0,15934,192,56,7.0,True,6,True,1,0,0,16512,225,64,7.0,False,25.24875,-578,-1,-1,248,289,-41
BR1_2705958802,7,True,0,0,0,17801,252,64,7.4,True,10,False,1,1,0,20374,252,60,7.4,False,29.624883333333333,-2573,-3,-1,316,312,4
BR1_2730339572,7,False,0,0,0,17545,212,44,7.4,False,17,True,0,0,0,24182,292,68,8.0,True,27.6714,-6637,-10,0,256,360,-104
BR1_2730269808,7,True,1,0,0,18594,237,48,7.6,False,6,False,0,0,0,17973,238,64,7.4,True,29.386916666666668,621,1,1,285,302,-17
BR1_2731340649,6,True,1,0,0,16928,239,56,7.2,True,3,False,0,0,0,15210,199,60,7.0,False,25.323533333333334,1718,3,1,295,259,36
BR1_2731136420,5,True,1,1,0,16961,213,64,7.0,True,6,False,0,0,0,16844,177,60,7.4,False,29.756283333333332,117,-1,1,277,237,40
BR1_2730810232,7,False,0,0,0,18904,247,56,7.4,True,6,True,0,1,0,17745,224,65,7.2,False,29.741016666666667,1159,1,0,303,289,14
BR1_2728863110,10,True,0,0,0,19346,208,47,7.4,True,8,False,1,0,0,18308,236,58,7.4,False,29.651133333333334,1038,2,-1,255,294,-39
BR1_2728835171,4,True,1,0,0,16552,226,60,7.4,True,9,False,0,0,0,19321,252,71,7.6,False,29.624633333333332,-2769,-5,1,286,323,-37
BR1_2728811811,4,False,0,0,0,16568,236,48,7.0,False,8,True,1,1,0,18877,253,64,7.4,True,28.129466666666666,-2309,-4,-1,284,317,-33
BR1_2731911672,6,False,1,0,0,15924,188,50,6.6,False,11,True,0,0,0,18696,208,64,7.2,True,25.625716666666666,-2772,-5,1,238,272,-34
BR1_2729885268,8,True,0,1,0,18287,183,52,7.0,False,12,False,1,0,0,21069,229,64,7.4,True,29.927933333333332,-2782,-4,-1,235,293,-58
BR1_2713786395,8,True,0,0,0,17552,201,56,7.0,False,11,False,1,0,0,19408,200,52,6.8,True,25.166116666666667,-1856,-3,-1,257,252,5
BR1_2713666749,9,True,0,0,0,19387,252,51,7.4,False,6,False,1,1,0,17647,210,65,7.4,True,29.078583333333334,1740,3,-1,303,275,28
BR1_2731343824,10,False,1,0,0,17467,165,52,6.6,True,5,True,0,0,0,15235,198,40,6.4,False,27.4812,2232,5,1,217,238,-21
BR1_2729469772,11,True,1,0,1,18886,200,48,7.2,True,3,False,0,1,0,13506,131,56,6.0,False,26.813116666666666,5380,8,1,248,187,61
BR1_2729452043,10,True,1,0,0,19559,240,44,7.0,True,5,False,0,0,0,16420,206,60,7.2,False,27.728016666666665,3139,5,1,284,266,18
BR1_2727797649,10,False,1,0,0,18318,202,56,6.4,True,7,True,0,1,0,16191,178,48,6.6,False,25.1655,2127,3,1,258,226,32
BR1_2731791016,6,True,0,0,0,15946,180,44,6.6,True,6,False,0,0,0,15704,188,56,6.8,False,25.4109,242,0,0,224,244,-20
BR1_2688928981,7,True,0,0,0,17593,222,48,7.2,False,10,False,1,1,0,19315,207,72,7.8,True,28.2799,-1722,-3,-1,270,279,-9
BR1_2688312854,10,False,1,0,0,18541,175,52,6.6,True,3,True,0,0,0,14499,178,58,6.4,False,26.98235,4042,7,1,227,236,-9
BR1_2688299494,11,False,1,0,0,20218,231,44,7.4,True,10,True,0,0,0,18479,218,60,7.2,False,29.566333333333333,1739,1,1,275,278,-3
BR1_2688011263,6,False,0,1,0,17394,201,64,7.2,True,8,True,1,0,0,18849,220,68,7.2,False,29.656366666666667,-1455,-2,-1,265,288,-23
BR1_2721885201,8,False,0,0,0,19255,246,48,7.4,False,8,True,1,0,0,18132,242,55,7.2,True,28.1059,1123,0,-1,294,297,-3
BR1_2729715842,9,False,0,0,0,17032,148,52,6.4,False,9,True,1,0,0,17771,223,52,6.8,True,26.2595,-739,0,-1,200,275,-75
BR1_2729697246,11,True,1,1,1,19949,209,48,6.8,True,4,False,0,0,0,15264,193,55,6.2,False,26.532666666666668,4685,7,1,257,248,9
BR1_2729548414,10,True,0,1,0,18819,224,60,7.2,False,7,False,1,0,0,17752,213,68,7.6,True,28.8268,1067,3,-1,284,281,3
BR1_2718393030,8,False,1,1,0,18284,213,56,7.0,True,7,True,0,0,0,17984,212,68,7.2,False,28.061933333333332,300,1,1,269,280,-11
BR1_2729502438,4,True,0,0,0,16901,233,52,7.0,False,7,False,1,0,0,18818,211,80,7.8,True,29.57155,-1917,-3,-1,285,291,-6
BR1_2731491292,6,False,0,1,0,16076,185,48,6.8,False,6,True,1,0,0,17620,234,64,7.0,True,26.584866666666667,-1544,0,-1,233,298,-65
BR1_2731475568,8,False,0,1,0,19537,232,68,7.6,True,8,True,1,0,0,19348,233,44,7.4,False,27.536933333333334,189,0,-1,300,277,23
BR1_2731849834,15,True,0,1,0,22123,205,64,7.4,True,12,False,1,0,0,20669,205,56,7.4,False,29.884966666666667,1454,3,-1,269,261,8
BR1_2731788604,6,True,1,0,0,17817,229,60,7.0,True,5,False,0,0,0,15303,200,64,6.8,False,26.0129,2514,1,1,289,264,25
BR1_2731723295,3,False,0,0,0,14411,206,52,6.2,False,10,True,1,0,0,18899,221,52,7.2,True,26.098166666666668,-4488,-7,-1,258,273,-15
BR1_2731762969,1,False,0,0,0,15282,209,60,7.2,False,5,True,1,1,0,17765,222,56,7.6,True,28.133066666666668,-2483,-4,-1,269,278,-9
BR1_2731741845,8,True,0,1,0,17814,206,72,7.4,True,4,False,0,0,0,14350,179,48,7.0,False,27.449866666666665,3464,4,0,278,227,51
BR1_2703810258,8,True,1,0,0,18248,253,56,7.2,True,7,False,0,0,0,17091,224,60,7.4,False,29.073883333333335,1157,1,1,309,284,25
BR1_2703801587,7,True,1,1,1,19232,223,48,7.6,False,2,False,0,0,0,15159,206,60,7.2,True,29.60865,4073,5,1,271,266,5
BR1_2730223109,10,False,1,0,0,19984,245,76,7.6,True,6,True,0,0,0,17136,211,60,7.2,False,27.640783333333335,2848,4,1,321,271,50
BR1_2729459119,4,False,0,1,0,17589,237,64,7.4,False,10,True,1,0,0,20115,251,52,7.6,True,27.946883333333332,-2526,-6,-1,301,303,-2
BR1_2729413779,6,False,1,0,0,17757,229,52,7.4,True,4,True,0,0,0,16889,231,52,7.0,False,29.6422,868,2,1,281,283,-2
BR1_2729390828,3,True,1,1,0,17394,237,84,7.6,True,4,False,0,0,0,16864,218,64,7.4,False,27.51465,530,-1,1,321,282,39
BR1_2731633990,6,False,1,0,0,15743,187,52,6.4,True,8,True,0,0,0,17148,226,48,6.6,False,25.9676,-1405,-2,1,239,274,-35
BR1_2726823077,5,True,0,1,0,17903,267,52,7.6,True,2,False,1,0,0,15856,241,70,7.0,False,28.459633333333333,2047,3,-1,319,311,8
BR1_2731523464,6,False,1,0,0,17539,183,68,7.0,False,16,True,0,1,0,23068,259,47,7.4,True,27.838716666666667,-5529,-10,1,251,306,-55
BR1_2731382056,10,False,0,0,0,20125,211,56,7.2,True,16,True,0,0,1,23222,254,64,7.6,False,28.614533333333334,-3097,-6,0,267,318,-51
BR1_2730991159,4,False,0,1,0,15099,208,60,7.0,False,3,True,1,0,0,15955,227,72,6.8,True,26.9447,-856,1,-1,268,299,-31
BR1_2731867726,10,False,0,0,0,19558,185,44,6.6,False,13,True,1,0,0,20631,197,55,7.4,True,28.090466666666668,-1073,-3,-1,229,252,-23
BR1_2726609401,11,True,0,0,0,17681,201,36,6.6,False,11,False,1,0,0,17415,170,44,6.2,True,25.079283333333333,266,0,-1,237,214,23
BR1_2731609999,6,True,1,0,0,16334,220,56,7.0,True,5,False,0,0,0,15245,208,48,7.0,False,26.60935,1089,1,1,276,256,20
BR1_2726221939,3,False,0,1,0,15488,212,60,7.0,False,6,True,1,0,0,16841,212,52,6.6,True,26.617533333333334,-1353,-3,-1,272,264,8
BR1_2731509200,7,False,1,0,0,15988,192,64,6.6,False,11,True,0,0,0,18191,196,56,6.8,True,27.055233333333334,-2203,-4,1,256,252,4
BR1_2731373950,7,True,0,0,0,17970,203,52,6.8,False,7,False,1,1,0,17469,193,64,7.2,True,29.655633333333334,501,0,-1,255,257,-2
BR1_2730349171,9,True,0,0,0,17208,188,45,6.6,False,9,False,0,0,0,17159,186,50,6.6,True,27.12615,49,0,0,233,236,-3
BR1_2676224000,7,False,0,1,0,19143,262,76,8.0,False,4,True,1,0,0,17020,260,40,7.2,True,27.5511,2123,3,-1,338,300,38
BR1_2669744303,7,False,0,0,0,16860,193,35,7.4,False,7,True,1,1,0,18483,226,60,7.6,True,29.473266666666667,-1623,0,-1,228,286,-58
BR1_2724791198,10,True,0,0,1,18388,199,52,6.8,False,12,False,0,0,0,21535,258,56,7.2,True,29.596,-3147,-2,0,251,314,-63
BR1_2712527494,9,True,0,0,0,19523,231,51,7.4,False,6,False,1,0,0,17856,233,80,7.4,True,29.08985,1667,3,-1,282,313,-31
BR1_2711579955,5,False,0,0,0,15336,195,48,6.6,False,6,True,1,1,0,17080,188,68,7.0,True,27.380466666666667,-1744,-1,-1,243,256,-13
BR1_2725842542,7,False,0,1,0,18444,229,52,7.6,False,11,True,1,0,0,20549,239,76,7.8,True,27.5426,-2105,-4,-1,281,315,-34
BR1_2730392168,5,False,0,0,0,15917,178,48,6.6,False,11,True,0,0,0,20376,215,48,7.0,True,28.70325,-4459,-6,0,226,263,-37
BR1_2730319015,9,True,1,0,0,16936,173,60,7.0,True,5,False,0,0,0,15371,214,52,7.0,False,25.104833333333332,1565,4,1,233,266,-33
BR1_2730284823,11,True,1,0,0,20187,247,60,7.4,True,3,False,0,0,0,13615,172,40,6.8,False,27.623783333333332,6572,8,1,307,212,95
BR1_2716673202,13,True,1,1,0,20535,234,44,7.6,False,9,False,0,0,0,18323,244,64,7.4,True,29.308116666666667,2212,4,1,278,308,-30
BR1_2731352662,10,False,0,0,0,17619,200,55,7.4,True,5,True,0,1,0,16625,188,53,7.0,False,27.988416666666666,994,5,0,255,241,14
BR1_2731849250,10,True,0,0,0,20220,230,48,7.6,True,7,False,0,1,0,18766,227,52,7.2,False,29.259966666666667,1454,3,0,278,279,-1
BR1_2731695866,5,True,0,0,0,15845,182,40,6.2,False,11,False,0,1,0,18686,220,48,6.8,True,25.46425,-2841,-6,0,222,268,-46
BR1_2726430739,18,True,0,1,0,21375,173,48,6.8,True,8,False,0,0,0,15838,147,46,6.4,False,26.6406,5537,10,0,221,193,28
BR1_2731798037,14,True,1,1,1,21108,199,48,7.2,True,8,False,0,0,0,18254,188,64,7.0,False,29.391816666666667,2854,6,1,247,252,-5
BR1_2730934213,9,True,0,0,0,18795,232,56,7.2,True,7,False,0,0,0,16377,198,52,6.6,False,28.309616666666667,2418,2,0,288,250,38
BR1_2728461881,8,True,1,0,0,17757,150,52,7.2,False,11,False,0,0,0,20006,244,64,7.8,True,28.242533333333334,-2249,-3,1,202,308,-106
BR1_2728348824,6,False,1,0,0,18051,236,64,7.0,True,3,True,0,0,0,15039,175,49,7.0,False,28.552266666666668,3012,3,1,300,224,76
BR1_2727937332,0,False,1,1,0,13952,181,60,7.0,False,5,True,0,0,0,17585,263,59,7.8,True,29.040316666666666,-3633,-5,1,241,322,-81
BR1_2729495842,7,True,0,0,0,16821,170,40,6.6,False,4,False,0,0,0,14888,194,55,6.6,True,25.570516666666666,1933,3,0,210,249,-39
BR1_2689174994,9,False,0,0,0,18848,223,56,7.2,True,12,True,0,1,0,20513,247,44,7.4,False,29.030416666666667,-1665,-3,0,279,291,-12
BR1_2689153423,11,True,1,0,0,19938,233,72,7.8,True,7,False,0,1,0,18324,226,56,7.2,False,28.091983333333335,1614,4,1,305,282,23
BR1_2727670259,10,False,0,1,0,19114,236,80,7.8,True,9,True,1,0,0,19066,241,64,7.6,False,27.91285,48,1,-1,316,305,11
BR1_2724906606,11,True,1,0,0,19264,219,76,7.8,True,5,False,0,1,0,18059,222,60,7.2,False,28.454933333333333,1205,6,1,295,282,13
BR1_2723338731,6,True,1,1,0,16968,254,46,6.8,True,5,False,0,0,0,15293,213,51,7.0,False,26.68401666666667,1675,1,1,300,264,36
BR1_2713438118,2,False,0,1,0,15733,245,56,7.2,False,5,True,1,0,0,17569,240,52,7.6,True,29.336233333333332,-1836,-3,-1,301,292,9
BR1_2722864625,4,True,1,1,0,17494,243,60,7.6,True,5,False,0,0,0,17889,254,49,7.6,False,29.018666666666668,-395,-1,1,303,303,0
BR1_2717874355,12,True,0,1,1,22142,249,54,7.6,True,10,False,1,0,0,18420,175,63,6.8,False,28.318416666666668,3722,2,-1,303,238,65
BR1_2717196895,8,False,0,0,0,15564,165,36,6.0,False,11,True,1,1,0,18338,184,69,7.2,True,25.723833333333335,-2774,-3,-1,201,253,-52
BR1_2730692354,10,False,1,1,0,18019,210,52,7.0,True,6,True,0,0,0,16567,216,59,6.6,False,25.629166666666666,1452,4,1,262,275,-13
BR1_2729011756,6,True,1,1,0,15189,166,52,6.6,True,7,False,0,0,0,18678,225,76,7.2,False,27.1275,-3489,-1,1,218,301,-83
BR1_2731649438,6,False,1,1,0,17283,228,56,7.2,True,10,True,0,0,0,19736,232,40,7.4,False,28.407233333333334,-2453,-4,1,284,272,12
BR1_2731255323,12,True,0,0,0,20873,225,55,7.4,True,13,False,1,1,0,19987,228,50,7.6,False,29.29665,886,-1,-1,280,278,2
BR1_2731226397,3,False,0,0,0,15095,196,48,6.8,False,10,True,1,0,1,20105,212,60,7.2,True,25.91735,-5010,-7,-1,244,272,-28
BR1_2718620516,7,False,1,0,0,16976,243,60,7.4,True,2,True,0,1,0,14303,192,52,7.0,False,27.373283333333333,2673,5,1,303,244,59
BR1_2718597093,12,True,1,0,0,20029,240,65,7.8,False,5,False,0,0,0,17001,195,66,7.2,True,29.069333333333333,3028,7,1,305,261,44
BR1_2729054970,6,False,1,0,0,16440,210,60,7.4,False,9,True,0,1,0,18121,200,56,7.4,True,29.550166666666666,-1681,-3,1,270,256,14
BR1_2728994256,7,True,1,1,0,16113,188,64,7.0,False,5,False,0,0,0,14988,200,48,6.8,True,25.318616666666667,1125,2,1,252,248,4
BR1_2728929595,7,True,1,1,0,17984,226,52,7.4,False,5,False,0,0,0,16000,208,28,6.8,True,28.4696,1984,2,1,278,236,42
BR1_2731555955,0,False,0,1,0,13821,231,52,6.8,False,4,True,1,0,0,16067,199,56,6.8,True,26.978933333333334,-2246,-4,-1,283,255,28
BR1_2731599684,10,True,0,1,0,20939,213,73,7.6,True,8,False,0,0,0,17939,195,34,7.0,False,29.0035,3000,2,0,286,229,57
BR1_2730702609,5,False,0,0,1,18862,258,52,7.4,False,4,True,1,0,0,17654,265,76,7.4,True,29.2193,1208,1,-1,310,341,-31
BR1_2730676736,17,True,0,0,0,21433,214,40,7.0,True,8,False,1,1,0,18201,184,44,7.2,False,27.548583333333333,3232,9,-1,254,228,26
BR1_2727525744,6,True,1,0,0,16333,205,59,7.0,True,3,False,0,0,0,14863,203,57,6.6,False,25.817066666666665,1470,3,1,264,260,4
BR1_2731072037,16,False,1,1,0,21266,223,60,7.6,False,5,True,0,0,0,18134,243,56,7.2,True,29.345283333333334,3132,11,1,283,299,-16
BR1_2731048312,9,True,0,1,0,16798,188,48,6.8,False,5,False,1,0,0,16205,161,56,6.4,True,27.281633333333332,593,4,-1,236,217,19
BR1_2728958547,8,True,1,1,0,19430,235,56,7.2,True,5,False,0,0,0,16906,239,56,7.0,False,28.362916666666667,2524,3,1,291,295,-4
BR1_2728422379,4,False,0,0,0,14522,186,56,6.6,False,11,True,1,1,0,18122,180,64,6.6,True,26.463383333333333,-3600,-7,-1,242,244,-2
BR1_2730766520,9,True,0,0,0,19620,230,61,7.4,True,8,False,1,1,0,18828,220,66,7.0,False,27.560066666666668,792,1,-1,291,286,5
BR1_2730736950,10,False,0,1,0,20601,255,52,7.8,False,9,True,1,0,0,19002,204,64,7.4,True,28.804683333333333,1599,1,-1,307,268,39
BR1_2731113641,13,False,0,0,0,19897,173,51,7.4,True,9,True,1,0,0,19211,206,60,7.0,False,28.12435,686,4,-1,224,266,-42
BR1_2731093652,8,True,0,0,0,18322,259,48,7.4,False,7,False,1,0,0,17977,214,60,7.6,True,29.402966666666668,345,1,-1,307,274,33
BR1_2731080559,6,False,1,0,0,16117,214,68,6.8,True,7,True,0,0,0,16308,192,56,7.0,False,26.551966666666665,-191,-1,1,282,248,34
BR1_2699737237,10,False,1,0,0,19244,237,60,7.6,True,6,True,0,0,0,17864,223,48,6.8,False,29.53005,1380,4,1,297,271,26
BR1_2715227318,13,True,1,1,0,21073,235,68,7.2,True,5,False,0,0,0,17261,234,56,7.4,False,29.42285,3812,8,1,303,290,13
BR1_2711973288,19,True,1,0,0,21324,195,60,7.4,True,7,False,0,0,0,15879,135,51,6.0,False,27.29756666666667,5445,12,1,255,186,69
BR1_2725122196,6,False,1,1,1,19890,234,88,7.4,True,12,True,0,0,0,19510,210,36,7.4,False,28.851916666666668,380,-6,1,322,246,76
BR1_2709925528,6,False,1,0,0,16016,204,52,7.2,True,6,True,0,1,0,17254,194,48,7.0,False,28.500283333333332,-1238,0,1,256,242,14
BR1_2729830711,10,False,1,0,0,17428,186,52,6.8,True,8,True,0,0,0,17091,209,56,7.0,False,27.139233333333333,337,2,1,238,265,-27
BR1_2728957293,16,True,0,1,0,21570,230,60,7.4,True,4,False,0,0,0,17566,258,44,7.2,False,29.284766666666666,4004,12,0,290,302,-12
BR1_2731782150,9,True,0,0,0,17443,206,59,7.0,True,6,False,1,0,0,14863,150,51,6.4,False,26.14375,2580,3,-1,265,201,64
BR1_2730498221,10,True,1,0,0,18491,188,48,6.8,False,8,False,0,1,0,19018,205,60,7.2,True,29.1272,-527,2,1,236,265,-29
BR1_2730485378,4,False,1,1,0,17121,175,68,7.2,False,12,True,0,0,0,19369,200,52,7.6,True,29.81983333333333,-2248,-8,1,243,252,-9
BR1_2731727634,12,False,0,1,0,20399,218,72,7.4,True,10,True,1,0,0,18358,197,48,7.4,False,27.8728,2041,2,-1,290,245,45
BR1_2730333763,6,False,1,0,0,18236,220,76,7.2,False,16,True,0,1,0,21616,221,44,7.6,True,27.68845,-3380,-10,1,296,265,31
BR1_2731808294,4,True,0,0,0,14952,184,60,7.0,False,7,False,1,0,0,16428,215,44,6.8,True,25.721416666666666,-1476,-3,-1,244,259,-15
BR1_2730809490,12,True,0,0,0,18639,177,44,6.6,True,6,False,0,0,0,15240,202,36,6.4,False,26.067633333333333,3399,6,0,221,238,-17
BR1_2730785869,11,True,0,1,1,20218,210,44,6.8,False,7,False,1,0,0,16435,181,52,6.8,True,26.458733333333335,3783,4,-1,254,233,21
BR1_2719739885,10,False,0,0,0,17156,187,44,6.8,True,6,True,0,0,0,15654,182,48,6.8,False,26.220583333333334,1502,4,0,231,230,1
BR1_2719703276,8,True,0,1,0,17095,232,50,7.0,True,6,False,1,0,0,15195,183,48,6.6,False,27.171083333333332,1900,2,-1,282,231,51
BR1_2719682653,3,False,1,1,0,14628,193,56,6.6,False,10,True,0,0,0,17847,236,46,7.2,True,25.30585,-3219,-7,1,249,282,-33
BR1_2729868697,5,True,0,0,0,16629,235,64,7.0,True,0,False,1,0,0,13195,202,60,6.6,False,25.5531,3434,5,-1,299,262,37
BR1_2729793891,8,False,1,0,0,18748,209,56,7.0,False,11,True,0,1,0,20520,256,48,7.8,True,28.6734,-1772,-3,1,265,304,-39
BR1_2729787193,11,True,1,0,0,19642,223,52,6.8,True,6,False,0,0,0,16130,166,44,6.4,False,27.431566666666665,3512,5,1,275,210,65
BR1_2725060862,10,False,0,0,0,18339,231,56,7.4,False,6,True,1,0,0,16138,184,56,6.8,True,26.2385,2201,4,-1,287,240,47
BR1_2730256508,7,True,1,0,0,17427,222,54,7.0,True,5,False,0,0,0,15692,176,42,6.4,False,26.8205,1735,2,1,276,218,58
BR1_2707093783,7,True,1,1,0,18639,247,72,7.8,True,7,False,0,0,0,18061,213,55,7.6,False,28.927716666666665,578,0,1,319,268,51
BR1_2726969939,7,False,0,1,0,17115,200,48,6.6,True,9,True,0,0,0,17362,171,60,6.8,False,27.165733333333332,-247,-2,0,248,231,17
BR1_2731562418,9,False,0,0,0,17034,191,52,6.6,False,7,True,1,0,0,16738,227,49,6.6,True,25.827466666666666,296,2,-1,243,276,-33
BR1_2731221323,15,True,1,0,0,21476,224,72,7.4,False,6,False,0,0,0,17519,239,51,7.2,True,28.0344,3957,9,1,296,290,6
BR1_2731806380,8,False,0,0,0,17428,203,56,7.0,True,6,True,0,1,0,17077,221,56,7.0,False,25.83865,351,2,0,259,277,-18
BR1_2724526537,5,False,1,0,0,17775,233,68,7.6,True,4,True,0,0,0,17252,231,68,7.2,False,29.051433333333332,523,1,1,301,299,2
BR1_2689574291,8,True,0,0,0,16481,216,40,7.0,False,10,False,1,0,0,17693,210,52,6.8,True,26.032866666666667,-1212,-2,-1,256,262,-6
BR1_2709769728,4,True,0,0,0,15157,212,40,6.8,False,1,False,0,0,0,14902,218,60,6.8,True,25.3091,255,3,0,252,278,-26
BR1_2731767844,5,True,0,0,0,17668,286,54,7.8,True,7,False,1,0,0,17213,216,65,7.4,False,28.615916666666667,455,-2,-1,340,281,59
BR1_2731717375,8,True,1,0,0,17840,195,59,7.0,True,4,False,0,0,0,15525,235,48,6.8,False,27.0614,2315,4,1,254,283,-29
BR1_2717098285,4,False,0,0,0,14610,176,47,6.4,False,10,True,1,1,0,18481,209,44,6.8,True,26.6073,-3871,-6,-1,223,253,-30
BR1_2717092701,13,True,1,0,0,20718,230,52,7.6,False,12,False,0,0,0,20451,231,64,7.4,True,27.592816666666668,267,1,1,282,295,-13
BR1_2731210659,10,True,1,0,0,18575,220,48,7.0,True,8,False,0,0,0,16812,177,44,6.6,False,26.809516666666667,1763,2,1,268,221,47
BR1_2730253661,10,False,0,0,0,18628,211,40,6.8,True,6,True,0,0,0,14947,168,44,6.4,False,27.181633333333334,3681,4,0,251,212,39
BR1_2730402653,6,False,0,0,0,16079,202,48,6.8,False,6,True,1,0,0,16065,186,45,6.4,True,26.155833333333334,14,0,-1,250,231,19
BR1_2729756178,10,False,1,0,0,19565,212,57,7.2,True,7,True,0,1,0,18114,229,54,7.0,False,27.734033333333333,1451,3,1,269,283,-14
BR1_2731784287,4,True,0,0,0,14878,193,48,6.4,True,3,False,0,0,0,14780,204,56,6.6,False,27.143316666666667,98,1,0,241,260,-19
BR1_2731109205,3,False,0,1,0,16618,226,63,7.6,True,7,True,1,0,0,17581,230,64,7.4,False,28.60475,-963,-4,-1,289,294,-5
BR1_2731089815,4,False,0,0,0,14882,195,50,6.6,False,9,True,1,0,0,18273,218,54,7.0,True,25.0431,-3391,-5,-1,245,272,-27
BR1_2731939771,13,True,1,1,0,20986,218,68,7.6,True,6,False,0,0,0,17330,207,56,7.2,False,28.54535,3656,7,1,286,263,23
BR1_2724681560,9,True,0,1,0,19393,237,60,7.6,False,6,False,1,0,0,17851,250,52,7.4,True,27.874616666666668,1542,3,-1,297,302,-5
BR1_2724669453,11,True,0,0,0,18307,204,60,6.8,False,9,False,0,0,0,18035,203,49,6.6,True,26.3791,272,2,0,264,252,12
BR1_2731739352,9,False,1,0,0,19455,225,72,7.6,True,7,True,0,1,0,17555,189,36,7.2,False,29.168033333333334,1900,2,1,297,225,72
BR1_2700041142,12,True,0,1,0,20934,219,60,7.4,True,10,False,0,0,0,18592,214,44,7.0,False,28.034483333333334,2342,2,0,279,258,21
BR1_2697291726,9,False,0,0,0,19074,202,52,7.0,True,8,True,0,0,0,17787,214,48,7.0,False,29.703716666666665,1287,1,0,254,262,-8
BR1_2723189367,11,True,0,0,0,21523,251,62,7.6,True,10,False,0,0,0,18562,218,52,7.0,False,29.76565,2961,1,0,313,270,43
BR1_2723156798,5,False,1,0,0,16655,226,50,7.2,False,8,True,0,1,0,18990,224,64,7.6,True,29.1449,-2335,-3,1,276,288,-12
BR1_2731701582,5,False,0,0,0,15004,191,44,6.6,False,10,True,1,0,0,18704,192,52,7.0,True,27.122983333333334,-3700,-5,-1,235,244,-9
BR1_2731647067,7,True,1,1,0,17674,198,58,6.8,True,7,False,0,0,0,17088,222,44,6.4,False,25.846333333333334,586,0,1,256,266,-10
BR1_2731844958,10,True,1,0,0,17223,211,51,6.8,True,5,False,0,0,0,17327,228,60,6.8,False,26.754616666666667,-104,5,1,262,288,-26
BR1_2701204467,4,False,0,0,0,15326,195,50,6.8,False,10,True,1,0,0,17643,182,60,7.2,True,26.46225,-2317,-6,-1,245,242,3
BR1_2694441062,3,True,1,1,0,17083,262,72,7.4,True,2,False,0,0,0,15869,250,56,7.6,False,27.721433333333334,1214,1,1,334,306,28
BR1_2729901988,8,True,0,0,0,18649,202,48,7.0,False,11,False,1,1,0,19709,231,71,7.6,True,28.141883333333332,-1060,-3,-1,250,302,-52
BR1_2729535023,7,False,1,0,0,16788,205,60,7.0,False,8,True,0,0,0,18057,242,48,7.0,True,27.008466666666667,-1269,-1,1,265,290,-25
BR1_2726600496,9,True,1,1,0,19463,216,84,7.6,True,4,False,0,0,0,17064,260,64,7.4,False,28.2673,2399,5,1,300,324,-24
BR1_2726480806,8,False,1,1,0,17921,186,72,7.6,True,9,True,0,0,0,18697,227,52,7.0,False,28.403933333333335,-776,-1,1,258,279,-21
BR1_2731502573,4,False,0,1,0,17574,253,60,7.6,False,8,True,1,0,0,19177,277,60,7.6,True,27.678716666666666,-1603,-4,-1,313,337,-24
BR1_2731481828,9,True,0,1,0,17529,200,48,6.8,True,5,False,0,0,0,16202,210,47,6.8,False,25.8244,1327,4,0,248,257,-9
BR1_2731694806,6,False,0,0,0,15029,178,60,6.4,False,8,True,1,1,0,18357,242,80,7.2,True,25.57185,-3328,-2,-1,238,322,-84
BR1_2730233963,7,False,0,0,0,17031,205,40,6.6,False,9,True,0,0,0,17555,204,56,6.8,True,26.189333333333334,-524,-2,0,245,260,-15
BR1_2729723560,5,True,0,0,0,17362,230,52,7.4,False,12,False,0,0,0,19504,188,47,7.2,True,29.372866666666667,-2142,-7,0,282,235,47
BR1_2702044272,10,True,1,0,0,19547,229,56,7.0,True,4,False,0,0,0,14775,162,56,6.6,False,26.113766666666667,4772,6,1,285,218,67
BR1_2730490067,3,False,0,0,0,16561,234,70,7.2,False,8,True,1,0,0,19013,250,58,7.4,True,28.2038,-2452,-5,-1,304,308,-4
BR1_2730323368,2,False,0,0,0,15513,217,52,6.8,False,8,True,1,1,0,19454,274,59,7.4,True,28.804266666666667,-3941,-6,-1,269,333,-64
BR1_2730056273,5,False,1,0,0,16440,221,59,7.0,True,2,True,0,1,0,14652,219,44,6.6,False,27.080466666666666,1788,3,1,280,263,17
BR1_2730028853,6,True,1,0,0,16176,226,52,6.6,True,0,False,0,0,0,12766,197,44,6.6,False,25.5982,3410,6,1,278,241,37
BR1_2721486625,4,False,0,1,0,16649,213,60,7.2,False,9,True,0,0,0,18000,197,52,7.4,True,29.12515,-1351,-5,0,273,249,24
BR1_2721483517,7,True,1,1,0,17547,198,68,7.0,True,3,False,0,0,0,14774,213,48,7.0,False,25.819583333333334,2773,4,1,266,261,5
BR1_2730791700,5,True,0,0,1,19489,224,60,7.4,True,11,False,1,1,0,20515,205,72,7.8,False,29.72833333333333,-1026,-6,-1,284,277,7
BR1_2730755996,4,False,1,1,0,16440,220,60,7.2,False,6,True,0,0,0,19028,268,56,7.6,True,28.137666666666668,-2588,-2,1,280,324,-44
BR1_2730732475,8,False,0,0,0,16838,179,58,6.8,False,10,True,1,1,0,17900,220,60,7.0,True,27.141083333333334,-1062,-2,-1,237,280,-43
BR1_2730365753,3,False,0,1,0,16506,211,68,7.2,False,9,True,1,0,0,19385,247,48,7.6,True,28.809983333333335,-2879,-6,-1,279,295,-16
BR1_2731466457,6,False,1,0,0,17408,245,57,7.4,False,7,True,0,1,0,18383,194,62,7.4,True,28.929166666666667,-975,-1,1,302,256,46
BR1_2731451884,13,False,1,0,0,20406,246,52,7.4,True,9,True,0,1,0,18405,211,60,7.4,False,27.64595,2001,4,1,298,271,27
BR1_2729616508,8,True,1,0,0,16297,198,54,6.8,True,5,False,0,1,0,15248,185,53,6.8,False,25.4429,1049,3,1,252,238,14
BR1_2731816189,3,False,0,0,0,15819,210,60,7.0,False,13,True,0,1,0,21574,249,52,7.8,True,28.587083333333332,-5755,-10,0,270,301,-31
BR1_2731693443,7,False,1,0,0,17890,219,58,7.4,False,5,True,0,1,0,18208,244,56,7.2,True,29.771566666666665,-318,2,1,277,300,-23
BR1_2730614549,3,False,0,1,0,16295,216,66,7.6,True,2,True,1,0,0,16967,292,69,7.6,False,29.244883333333334,-672,1,-1,282,361,-79
BR1_2731095512,8,False,0,1,0,17157,208,48,7.0,False,12,True,1,0,0,18710,225,48,7.0,True,26.196566666666666,-1553,-4,-1,256,273,-17
BR1_2729043666,5,True,0,0,0,15531,206,47,6.6,True,6,False,1,0,0,15125,129,48,6.0,False,25.7067,406,-1,-1,253,177,76
BR1_2728183884,19,False,0,1,1,23854,205,54,7.8,True,12,True,1,0,0,20334,238,61,7.2,False,29.41,3520,7,-1,259,299,-40
BR1_2727810275,6,False,0,1,0,17860,218,84,7.4,True,10,True,0,0,0,18599,238,47,7.0,False,27.860283333333335,-739,-4,0,302,285,17
BR1_2731098911,13,True,1,1,0,21172,190,76,7.2,True,6,False,0,0,0,18016,241,36,7.0,False,28.96805,3156,7,1,266,277,-11
BR1_2692653922,6,False,0,0,0,16059,197,41,7.0,False,14,True,0,0,0,22546,267,46,7.8,True,27.576516666666667,-6487,-8,0,238,313,-75
BR1_2731675983,6,False,1,0,0,17909,267,48,7.4,True,3,True,0,0,0,15578,222,44,7.0,False,29.647183333333334,2331,3,1,315,266,49
BR1_2723529741,2,False,0,0,0,13802,170,60,6.2,False,11,True,1,0,0,18343,222,56,7.2,True,26.2148,-4541,-9,-1,230,278,-48
BR1_2730119797,11,True,0,0,0,20034,250,52,7.6,False,8,False,1,0,0,18163,206,48,7.0,True,29.046766666666667,1871,3,-1,302,254,48
BR1_2725701725,12,True,1,0,0,19297,195,56,7.4,True,8,False,0,0,0,18829,244,64,7.0,False,28.7243,468,4,1,251,308,-57
BR1_2725679614,4,True,1,0,0,15328,165,59,6.8,False,8,False,0,0,0,16569,228,60,6.8,True,26.2759,-1241,-4,1,224,288,-64
BR1_2731826976,10,True,1,0,0,17344,193,64,7.0,True,3,False,0,0,0,14408,202,48,6.6,False,27.08375,2936,7,1,257,250,7
BR1_2731852185,12,False,1,0,0,19572,218,56,7.4,True,4,True,0,1,0,16293,212,48,7.2,False,28.1539,3279,8,1,274,260,14
BR1_2731834358,13,True,1,0,0,20175,207,48,6.8,False,14,False,0,0,0,21323,208,66,7.4,True,28.841483333333333,-1148,-1,1,255,274,-19
BR1_2715783854,3,False,0,0,0,14088,200,32,6.6,False,7,True,1,0,0,17641,248,60,7.0,True,25.517266666666668,-3553,-4,-1,232,308,-76
BR1_2731745094,9,True,0,0,0,20006,246,60,7.6,True,3,False,1,1,0,16049,252,55,7.4,False,28.546583333333334,3957,6,-1,306,307,-1
BR1_2730548507,6,True,0,0,0,17153,211,50,6.8,False,16,False,1,1,0,23889,254,75,7.6,True,27.8857,-6736,-10,-1,261,329,-68
BR1_2719599192,7,True,1,0,0,15990,165,52,6.6,False,8,False,0,0,0,16154,178,60,6.8,True,27.3221,-164,-1,1,217,238,-21
BR1_2718019977,4,False,0,0,0,15565,202,56,6.6,False,3,True,1,0,0,14423,219,48,6.6,True,26.168816666666668,1142,1,-1,258,267,-9
BR1_2728898196,6,True,1,0,0,17205,225,60,7.2,False,7,False,0,0,0,17901,220,72,7.0,True,25.74341666666667,-696,-1,1,285,292,-7
BR1_2723001671,10,True,0,1,0,19884,252,68,7.2,False,6,False,1,0,0,17250,217,48,7.0,True,28.242383333333333,2634,4,-1,320,265,55
BR1_2713342565,2,False,1,1,0,15011,222,68,7.0,False,2,True,0,0,0,14664,236,52,6.6,True,26.160433333333334,347,0,1,290,288,2
BR1_2712656783,5,False,0,0,0,16088,210,50,6.6,True,5,True,1,0,0,16072,200,50,6.8,False,25.660833333333333,16,0,-1,260,250,10
BR1_2730983945,6,True,0,0,0,17803,216,60,7.4,False,9,False,1,1,0,20911,266,76,7.6,True,28.62425,-3108,-3,-1,276,342,-66
BR1_2730764097,9,False,1,0,0,19016,202,44,7.0,True,15,True,0,1,0,21878,214,48,7.4,False,29.176216666666665,-2862,-6,1,246,262,-16
BR1_2690510700,7,False,0,1,0,16490,208,40,7.0,True,5,True,0,0,0,15585,211,64,6.8,False,27.16946666666667,905,2,0,248,275,-27
BR1_2689625981,5,False,0,1,0,16760,223,52,7.2,False,6,True,0,0,0,17604,223,56,7.2,True,28.947166666666668,-844,-1,0,275,279,-4
BR1_2729512071,6,False,1,1,0,17184,193,64,7.4,False,10,True,0,0,0,19017,214,40,7.4,True,27.9962,-1833,-4,1,257,254,3
BR1_2728594436,8,True,0,0,0,18960,259,57,7.6,True,3,False,0,0,0,16816,244,58,7.4,False,28.543116666666666,2144,5,0,316,302,14
BR1_2686570197,14,True,1,0,0,21819,225,56,7.6,True,6,False,0,0,0,16848,195,52,7.6,False,27.932933333333335,4971,8,1,281,247,34
BR1_2686561335,4,False,1,0,0,16794,253,48,7.4,False,6,True,0,1,1,19050,230,71,7.4,True,28.433783333333334,-2256,-2,1,301,301,0
BR1_2686494739,12,True,0,0,0,19294,227,68,7.4,False,8,False,1,0,0,17758,213,48,7.0,True,25.904533333333333,1536,4,-1,295,261,34
BR1_2731934840,10,False,0,1,0,19970,206,58,7.0,False,10,True,1,0,0,19533,223,52,7.2,True,29.568283333333333,437,0,-1,264,275,-11
BR1_2719830065,16,True,0,1,0,22107,249,60,7.8,True,7,False,1,0,0,17579,185,60,7.0,False,29.622833333333332,4528,9,-1,309,245,64
BR1_2719799352,6,True,1,0,0,16346,200,64,7.2,True,2,False,0,1,0,14074,201,52,6.6,False,25.034033333333333,2272,4,1,264,253,11
BR1_2711248124,7,True,1,0,0,16596,204,51,6.8,True,3,False,0,0,0,14824,227,56,6.6,False,27.196516666666668,1772,4,1,255,283,-28
BR1_2711219509,8,True,0,1,0,18179,217,52,7.2,False,12,False,1,0,0,21040,216,68,7.4,True,27.741433333333333,-2861,-4,-1,269,284,-15
BR1_2729077810,8,False,0,0,0,17382,212,52,7.2,False,11,True,0,0,0,19762,252,56,7.6,True,29.915533333333332,-2380,-3,0,264,308,-44
BR1_2729813516,9,True,1,1,0,17564,176,64,7.0,True,4,False,0,0,0,15050,190,44,6.8,False,27.253583333333335,2514,5,1,240,234,6
BR1_2729804860,3,True,0,1,0,16424,256,56,7.2,True,5,False,0,0,0,17406,252,60,7.4,False,28.780216666666668,-982,-2,0,312,312,0
BR1_2731927158,5,False,0,0,0,16070,214,52,7.0,False,7,True,0,0,0,16726,207,56,7.2,True,26.81276666666667,-656,-2,0,266,263,3
BR1_2731517937,1,False,1,1,0,13079,183,48,6.2,False,10,True,0,0,0,20000,241,52,7.6,True,25.092616666666668,-6921,-9,1,231,293,-62
BR1_2731464835,14,True,0,0,0,20181,228,55,7.6,False,4,False,0,0,0,17500,259,55,7.2,True,29.443583333333333,2681,10,0,283,314,-31
BR1_2731171166,11,False,0,0,0,16727,182,45,7.0,True,8,True,0,0,0,16219,198,38,6.6,False,25.794833333333333,508,3,0,227,236,-9
BR1_2730452098,8,True,0,1,1,18589,194,60,6.6,False,9,False,1,0,0,16509,185,60,6.8,True,25.5602,2080,-1,-1,254,245,9
BR1_2727426526,5,True,0,1,0,18104,251,64,7.4,False,12,False,1,0,0,21053,254,68,7.6,True,28.708266666666667,-2949,-7,-1,315,322,-7
BR1_2724575029,9,False,0,0,0,16898,163,43,6.6,False,6,True,1,1,0,17689,203,48,6.6,True,25.13415,-791,3,-1,206,251,-45
BR1_2724066758,10,True,1,0,0,19347,224,52,7.0,True,3,False,0,0,0,13923,172,56,6.4,False,25.172916666666666,5424,7,1,276,228,48
BR1_2725270571,6,True,0,1,0,18387,260,55,7.4,False,5,False,1,0,0,16968,206,52,7.2,True,29.782816666666665,1419,1,-1,315,258,57
BR1_2725259829,6,True,0,1,0,17223,223,57,7.4,False,4,False,0,0,0,17148,238,74,7.8,True,28.624166666666667,75,2,0,280,312,-32
BR1_2729516222,6,False,1,1,0,17446,194,52,7.2,True,6,True,0,0,0,17848,253,56,7.4,False,27.766233333333332,-402,0,1,246,309,-63
BR1_2725813491,10,False,1,0,0,19841,228,74,7.6,True,7,True,0,0,0,18278,237,56,6.8,False,29.048966666666665,1563,3,1,302,293,9
BR1_2724473961,7,True,0,1,0,19957,265,71,7.6,True,11,False,1,0,0,20066,278,56,7.6,False,28.666083333333333,-109,-4,-1,336,334,2
BR1_2731150718,13,True,1,0,0,18964,211,60,7.0,True,2,False,0,0,0,13536,191,49,6.2,False,26.4769,5428,11,1,271,240,31
BR1_2730518618,4,False,1,0,0,17403,212,72,7.2,False,6,True,0,1,0,16754,204,48,7.0,True,28.016283333333334,649,-2,1,284,252,32
BR1_2724228917,3,True,0,0,0,14688,188,48,6.6,False,8,False,1,0,0,16518,193,48,6.8,True,26.60885,-1830,-5,-1,236,241,-5
BR1_2724217207,6,True,1,0,0,14947,152,60,6.8,False,8,False,0,1,0,18465,204,48,7.0,True,27.432866666666666,-3518,-2,1,212,252,-40
BR1_2721451833,9,False,1,0,0,17959,236,60,7.2,True,8,True,0,1,0,17854,210,60,6.8,False,25.535083333333333,105,1,1,296,270,26
BR1_2721440916,12,True,1,0,0,19430,189,48,6.6,True,13,False,0,1,0,18935,171,36,6.4,False,26.814683333333335,495,-1,1,237,207,30
BR1_2721397301,9,False,0,0,0,18560,227,48,6.8,True,7,True,0,1,0,17586,191,48,6.8,False,25.52665,974,2,0,275,239,36
BR1_2712418018,8,True,0,0,0,18083,250,52,7.0,True,5,False,0,0,0,15775,198,54,7.0,False,26.74645,2308,3,0,302,252,50
BR1_2730022346,7,False,0,0,0,17368,228,55,7.0,False,6,True,0,0,0,17296,212,60,7.0,True,26.669816666666666,72,1,0,283,272,11
BR1_2729074020,7,True,1,0,0,19355,257,76,7.4,True,2,False,0,1,0,16350,267,56,7.6,False,29.784366666666667,3005,5,1,333,323,10
BR1_2731713128,6,False,1,1,0,18076,227,60,7.4,True,8,True,0,0,0,18617,265,36,7.2,False,29.818783333333332,-541,-2,1,287,301,-14
BR1_2730384349,9,False,1,0,0,18764,259,52,7.2,False,8,True,0,0,0,18710,242,60,7.2,True,27.62548333333333,54,1,1,311,302,9
BR1_2731140805,3,False,0,0,0,15580,234,68,7.0,True,3,True,0,0,0,15299,211,72,7.0,False,26.19645,281,0,0,302,283,19
BR1_2730105907,8,True,0,1,0,18874,199,77,7.4,True,9,False,0,0,0,18469,211,54,7.4,False,29.637833333333333,405,-1,0,276,265,11
BR1_2674179209,7,False,0,0,0,18193,225,68,7.4,False,11,True,1,1,0,21507,255,60,7.6,True,29.69975,-3314,-4,-1,293,315,-22
BR1_2731377646,14,False,1,1,0,20286,232,56,7.6,False,11,True,0,0,0,19270,195,52,7.0,True,28.61025,1016,3,1,288,247,41
BR1_2731653181,12,False,0,0,0,20091,241,43,7.4,True,10,True,0,0,0,19004,207,60,7.2,False,28.106883333333332,1087,2,0,284,267,17
BR1_2730666046,16,True,1,0,0,19986,195,40,6.6,False,11,False,0,1,0,17657,174,48,6.8,True,26.022916666666667,2329,5,1,235,222,13
BR1_2730228107,12,True,0,1,0,18461,200,60,7.0,True,8,False,1,0,0,16263,165,60,7.0,False,25.650816666666667,2198,4,-1,260,225,35
BR1_2730199446,7,False,1,0,0,16018,199,48,6.4,False,9,True,0,1,0,17965,201,50,6.8,True,26.5821,-1947,-2,1,247,251,-4
BR1_2725937291,9,False,0,0,0,19931,216,48,7.2,False,13,True,1,1,0,19921,197,47,7.0,True,28.782666666666668,10,-4,-1,264,244,20
BR1_2725925701,9,True,0,0,0,16861,169,44,6.2,False,14,False,1,0,0,19597,180,44,6.6,True,25.91658333333333,-2736,-5,-1,213,224,-11
BR1_2728332428,9,True,1,0,0,17828,206,64,7.4,True,9,False,0,0,0,18501,225,49,7.4,False,27.60785,-673,0,1,270,274,-4
BR1_2728315223,3,False,0,1,0,16420,219,52,7.2,False,7,True,0,0,0,18646,225,59,7.4,True,28.38785,-2226,-4,0,271,284,-13
BR1_2714228861,10,True,1,0,0,19059,214,44,7.2,True,6,False,0,0,0,16706,179,57,7.2,False,29.070116666666667,2353,4,1,258,236,22
BR1_2731815814,8,True,0,0,0,16484,180,40,6.6,True,10,False,1,0,0,18025,213,56,7.0,False,26.852883333333335,-1541,-2,-1,220,269,-49
BR1_2731782976,8,True,1,0,0,17664,190,64,6.8,True,10,False,0,1,1,19344,211,60,7.2,False,27.058916666666665,-1680,-2,1,254,271,-17
BR1_2729383000,11,True,0,1,0,18525,202,50,7.2,True,7,False,0,0,0,16270,200,48,6.4,False,25.649116666666668,2255,4,0,252,248,4
BR1_2728323156,11,True,0,0,0,20152,241,64,7.6,True,7,False,1,0,0,17362,219,64,7.4,False,27.58255,2790,4,-1,305,283,22
BR1_2731025006,4,False,0,0,1,14575,195,42,7.0,False,5,True,1,1,0,18115,223,74,7.2,True,25.87398333333333,-3540,-1,-1,237,297,-60
BR1_2730525412,6,True,0,1,0,15662,185,60,6.8,True,4,False,1,0,0,15859,200,52,6.8,False,27.243916666666667,-197,2,-1,245,252,-7
BR1_2731852756,12,True,0,0,0,17884,176,40,6.8,True,6,False,1,0,0,16145,186,56,6.8,False,25.9232,1739,6,-1,216,242,-26
BR1_2731247794,9,False,0,1,0,19912,233,52,7.8,True,5,True,1,0,0,17129,220,49,7.4,False,29.896083333333333,2783,4,-1,285,269,16
BR1_2731175467,13,False,1,0,0,20154,204,64,7.2,True,5,True,0,0,0,16683,181,60,6.8,False,28.169866666666667,3471,8,1,268,241,27
BR1_2730725593,11,True,0,0,0,18159,170,52,6.6,False,11,False,1,1,0,19356,197,68,6.6,True,26.7704,-1197,0,-1,222,265,-43
BR1_2731837899,3,True,0,0,0,14892,198,44,6.8,False,5,False,0,0,0,16502,226,55,7.0,True,26.9178,-1610,-2,0,242,281,-39
BR1_2731803517,10,True,0,0,0,19471,205,56,7.0,False,7,False,1,0,0,18236,185,52,6.8,True,27.756216666666667,1235,3,-1,261,237,24
BR1_2731781863,9,False,0,1,0,17664,191,48,6.8,False,8,True,0,0,0,15981,194,56,6.6,True,26.297233333333335,1683,1,0,239,250,-11
BR1_2731728259,9,True,0,0,0,17395,210,44,6.6,True,5,False,0,0,0,15459,177,44,6.4,False,26.191866666666666,1936,4,0,254,221,33
BR1_2731308571,6,True,1,0,0,15408,170,56,6.4,True,6,False,0,0,0,16049,207,52,7.0,False,25.47345,-641,0,1,226,259,-33
BR1_2731859742,7,True,1,0,0,17259,214,56,7.0,True,9,False,0,1,0,17691,188,60,7.2,False,26.687383333333333,-432,-2,1,270,248,22
BR1_2730642465,9,True,1,1,0,18213,203,42,7.0,True,7,False,0,0,0,17764,195,42,6.6,False,28.749566666666666,449,2,1,245,237,8
BR1_2731935043,7,True,0,1,1,19934,241,72,7.4,True,5,False,1,0,0,17772,238,62,7.6,False,29.7562,2162,2,-1,313,300,13
BR1_2731917107,9,True,1,0,0,18555,235,48,7.2,True,0,False,0,0,0,14175,197,64,6.4,False,27.108866666666668,4380,9,1,283,261,22
BR1_2731185171,12,True,1,0,0,18943,220,44,6.6,True,11,False,0,1,0,16772,165,44,6.4,False,26.30465,2171,1,1,264,209,55
BR1_2731702448,12,False,0,1,0,19667,209,48,7.4,True,10,True,0,0,0,19944,224,48,7.2,False,28.978733333333334,-277,2,0,257,272,-15
BR1_2731470985,5,False,0,1,0,16025,197,61,6.6,True,10,True,0,0,0,18645,229,54,7.2,False,26.98305,-2620,-5,0,258,283,-25
BR1_2728933767,5,False,0,0,0,15488,197,54,7.0,True,7,True,0,0,0,16827,213,54,6.8,False,27.40035,-1339,-2,0,251,267,-16
BR1_2727481650,7,True,0,1,0,17520,187,56,7.0,False,7,False,1,0,0,17995,227,72,7.2,True,29.716416666666667,-475,0,-1,243,299,-56
BR1_2726822733,5,True,1,1,0,18287,246,50,7.4,False,6,False,0,0,0,17787,247,62,7.2,True,29.718516666666666,500,-1,1,296,309,-13
BR1_2730338386,7,False,0,1,0,17550,210,60,7.2,True,9,True,1,0,0,19017,240,76,7.4,False,29.205166666666667,-1467,-2,-1,270,316,-46
BR1_2725485020,5,False,0,0,0,17536,222,64,7.2,False,14,True,1,0,0,21221,224,64,7.6,True,27.513716666666667,-3685,-9,-1,286,288,-2
BR1_2725399803,8,True,1,0,0,18243,258,62,7.6,True,0,False,0,0,0,13333,199,48,6.6,False,26.313416666666665,4910,8,1,320,247,73
BR1_2730532607,9,False,0,0,0,19910,272,56,7.6,True,6,True,0,1,0,18711,213,55,7.2,False,28.97795,1199,3,0,328,268,60
BR1_2730479266,10,True,0,0,0,17718,178,61,7.2,True,8,False,1,1,0,17141,204,52,7.2,False,25.7152,577,2,-1,239,256,-17
BR1_2730469102,2,True,1,0,0,15949,251,52,7.2,True,8,False,0,1,0,17603,213,60,7.4,False,28.67065,-1654,-6,1,303,273,30
BR1_2730455899,6,True,0,1,0,17755,197,60,6.6,True,9,False,1,0,0,18311,200,68,7.0,False,26.0728,-556,-3,-1,257,268,-11
BR1_2728179877,5,False,0,1,0,17145,209,47,7.0,True,8,True,1,0,0,18348,220,52,7.2,False,28.570783333333335,-1203,-3,-1,256,272,-16
BR1_2728172515,5,False,0,0,0,15625,175,52,7.0,False,9,True,1,0,0,19394,225,68,7.4,True,28.6381,-3769,-4,-1,227,293,-66
BR1_2728164244,2,False,0,0,0,13164,147,43,6.0,False,14,True,1,0,0,19809,210,56,7.2,True,26.58095,-6645,-12,-1,190,266,-76
BR1_2731613719,7,True,0,0,0,15599,206,56,6.8,False,3,False,0,0,0,15242,221,64,7.0,True,25.1227,357,4,0,262,285,-23
BR1_2731075250,4,False,1,0,0,14744,177,59,6.6,False,10,True,0,0,0,17954,215,48,7.0,True,27.33865,-3210,-6,1,236,263,-27
BR1_2730483411,4,True,0,0,0,15558,207,56,6.8,True,0,False,1,0,0,12227,172,48,6.8,False,27.24975,3331,4,-1,263,220,43
BR1_2726250134,5,True,0,0,0,15503,213,52,6.8,True,7,False,0,1,0,16953,227,52,6.8,False,27.441333333333333,-1450,-2,0,265,279,-14
BR1_2726184389,5,True,0,0,0,18172,270,56,7.4,True,3,False,0,1,0,16049,229,64,7.2,False,29.3029,2123,2,0,326,293,33
BR1_2731622435,7,True,0,0,0,19455,237,64,7.4,False,8,False,0,1,0,18584,236,52,7.2,True,28.539283333333334,871,-1,0,301,288,13
BR1_2731598694,8,False,0,0,0,17772,200,42,6.8,False,8,True,1,0,0,17186,187,72,6.8,True,26.178683333333332,586,0,-1,242,259,-17
BR1_2731930269,12,True,1,0,0,19681,220,56,7.0,True,6,False,0,1,0,16389,183,68,6.4,False,26.100883333333332,3292,6,1,276,251,25
BR1_2731916988,4,False,0,0,0,14742,197,54,6.6,True,6,True,0,0,0,16687,233,56,7.0,False,25.64085,-1945,-2,0,251,289,-38
BR1_2731912048,6,False,0,0,0,17246,192,51,7.0,False,8,True,1,0,0,19128,225,60,6.8,True,28.53075,-1882,-2,-1,243,285,-42
BR1_2731907276,7,True,0,0,0,16771,195,48,7.0,False,6,False,1,0,0,16170,191,59,6.8,True,26.553733333333334,601,1,-1,243,250,-7
BR1_2731089086,10,True,1,0,0,16947,160,52,6.4,True,7,False,0,1,0,16566,165,56,7.0,False,25.552066666666665,381,3,1,212,221,-9
BR1_2730731247,11,True,0,0,0,17817,170,44,6.6,False,11,False,1,0,0,17595,214,43,7.2,True,25.745833333333334,222,0,-1,214,257,-43
BR1_2731732908,8,True,1,0,0,17816,214,54,7.0,False,9,False,0,0,0,18069,219,50,7.4,True,29.644183333333334,-253,-1,1,268,269,-1
BR1_2731077766,11,True,0,0,0,21061,266,63,7.6,True,3,False,1,0,0,15773,203,68,7.2,False,29.147166666666667,5288,8,-1,329,271,58
BR1_2729880391,8,True,1,0,0,18610,244,52,7.0,True,3,False,0,0,0,14516,203,52,6.6,False,26.809683333333332,4094,5,1,296,255,41
BR1_2729726207,10,True,1,0,0,18390,226,56,7.0,True,5,False,0,1,0,14985,187,48,6.4,False,25.676333333333332,3405,5,1,282,235,47
BR1_2731816657,9,False,0,1,0,19187,216,60,7.4,False,9,True,1,0,0,18065,192,48,7.0,True,29.807183333333334,1122,0,-1,276,240,36
BR1_2731453755,6,False,1,0,0,16371,202,46,7.2,False,9,True,0,1,0,18800,231,74,7.6,True,27.855583333333332,-2429,-3,1,248,305,-57
BR1_2718721737,3,False,0,0,0,16036,240,48,7.2,False,8,True,1,1,0,17804,206,63,7.4,True,28.403883333333333,-1768,-5,-1,288,269,19
BR1_2718703010,8,True,1,0,0,17623,198,44,6.8,False,12,False,0,0,0,20135,223,64,7.4,True,28.13305,-2512,-4,1,242,287,-45
BR1_2731235800,9,True,1,0,0,17265,190,44,7.0,False,10,False,0,1,0,19428,223,60,7.2,True,29.5984,-2163,-1,1,234,283,-49
BR1_2717508970,11,False,0,0,0,20272,261,67,7.8,True,3,True,1,1,0,15435,185,52,6.8,False,29.851283333333335,4837,8,-1,328,237,91
BR1_2680857530,8,True,1,1,0,19033,212,72,7.6,True,7,False,0,0,0,17503,217,40,7.2,False,29.371766666666666,1530,1,1,284,257,27
BR1_2728690918,8,False,1,0,0,17887,203,68,7.6,True,4,True,0,1,0,15349,191,64,7.0,False,27.193483333333333,2538,4,1,271,255,16
BR1_2717642347,8,True,1,0,0,18887,258,56,7.8,False,3,False,0,1,0,16844,236,70,7.8,True,28.400333333333332,2043,5,1,314,306,8
BR1_2725115780,7,True,0,0,0,18139,221,60,7.0,True,8,False,0,0,0,15787,183,48,7.0,False,27.486766666666668,2352,-1,0,281,231,50
BR1_2726352240,3,True,0,0,0,14631,185,56,6.6,False,3,False,0,0,0,16124,238,76,7.4,True,26.19845,-1493,0,0,241,314,-73
BR1_2710800889,7,True,1,1,0,17296,234,56,6.8,True,4,False,0,0,0,14421,160,59,6.2,False,26.522966666666665,2875,3,1,290,219,71
BR1_2724573912,9,True,0,0,0,17955,231,48,7.0,False,5,False,0,0,0,15981,208,52,6.6,True,26.913133333333334,1974,4,0,279,260,19
BR1_2724487350,2,True,0,1,0,17024,255,52,7.6,True,2,False,1,0,0,15894,239,64,7.4,False,29.145733333333332,1130,0,-1,307,303,4
BR1_2728791646,6,True,0,0,0,16639,180,52,6.4,False,9,False,1,0,1,18888,182,67,7.0,True,25.9936,-2249,-3,-1,232,249,-17
BR1_2729026636,17,True,1,0,0,21449,203,46,7.0,True,11,False,0,0,0,17899,160,51,6.6,False,26.031683333333334,3550,6,1,249,211,38
BR1_2707060768,9,False,0,0,0,19348,243,60,7.0,True,13,True,1,1,0,20363,226,52,7.0,False,29.1606,-1015,-4,-1,303,278,25
BR1_2730678731,10,True,0,1,0,20223,227,56,7.4,True,7,False,0,0,0,17915,255,44,7.4,False,27.60086666666667,2308,3,0,283,299,-16
BR1_2724904433,6,False,0,0,0,17668,231,48,7.4,False,7,True,1,1,0,18474,247,43,7.2,True,28.404516666666666,-806,-1,-1,279,290,-11
BR1_2724875473,15,True,1,0,0,19413,218,40,7.0,True,7,False,0,1,0,16411,176,56,6.8,False,27.0482,3002,8,1,258,232,26
BR1_2730964652,10,False,0,0,0,19535,237,56,7.6,True,4,True,0,0,0,16963,207,63,7.2,False,29.826516666666667,2572,6,0,293,270,23
BR1_2724395041,8,False,0,0,0,17915,208,68,7.2,False,8,True,1,1,1,20801,237,72,7.6,True,29.42145,-2886,0,-1,276,309,-33
BR1_2723832375,12,False,0,0,0,20325,253,44,7.6,False,6,True,1,0,0,16673,222,56,6.8,True,27.588533333333334,3652,6,-1,297,278,19
BR1_2723713713,7,False,1,0,0,17605,192,61,7.4,False,9,True,0,0,0,18139,204,64,7.0,True,28.129133333333332,-534,-2,1,253,268,-15
BR1_2723510226,6,False,0,0,0,16144,238,48,7.0,False,5,True,1,1,0,15715,194,52,6.6,True,27.319583333333334,429,1,-1,286,246,40
BR1_2723484887,7,True,0,0,0,16428,209,44,7.2,True,6,False,1,0,0,15650,176,68,6.8,False,26.26615,778,1,-1,253,244,9
BR1_2730931710,2,False,1,0,0,15374,232,68,7.2,False,12,True,0,0,0,19886,219,72,7.6,True,28.8717,-4512,-10,1,300,291,9
BR1_2730919244,11,True,0,0,0,17664,186,51,6.6,False,7,False,1,0,0,17548,199,44,6.6,True,25.1442,116,4,-1,237,243,-6
BR1_2731830691,5,True,0,1,0,15869,191,59,6.8,False,6,False,1,0,0,15339,175,52,6.8,True,25.077516666666668,530,-1,-1,250,227,23
BR1_2714983017,9,True,0,0,0,18879,219,54,7.2,True,5,False,0,0,0,15640,196,33,6.8,False,29.491333333333333,3239,4,0,273,229,44
BR1_2728740524,7,False,1,0,0,16196,177,46,6.6,False,9,True,0,1,0,18033,227,64,7.0,True,26.345633333333332,-1837,-2,1,223,291,-68
BR1_2731758264,8,False,0,0,0,18213,244,48,7.2,True,7,True,0,1,0,17925,217,70,7.0,False,28.061366666666668,288,1,0,292,287,5
BR1_2731315264,1,False,0,0,0,12936,184,48,6.4,False,7,True,1,0,0,17177,223,68,7.2,True,26.8344,-4241,-6,-1,232,291,-59
BR1_2707539150,5,False,0,1,0,17343,208,54,7.2,False,10,True,1,0,0,19238,254,61,7.2,True,28.210533333333334,-1895,-5,-1,262,315,-53
BR1_2707302060,15,False,0,0,0,20437,194,60,6.8,True,9,True,1,0,0,16497,178,52,6.6,False,26.6943,3940,6,-1,254,230,24
BR1_2726496561,6,True,1,0,0,14120,118,48,6.4,False,7,False,0,0,0,16185,166,63,6.8,True,26.172033333333335,-2065,-1,1,166,229,-63
BR1_2731741979,9,True,1,0,0,18399,205,64,7.2,True,4,False,0,0,0,16794,223,52,7.2,False,28.412516666666665,1605,5,1,269,275,-6
BR1_2716297257,9,True,1,1,0,18783,229,56,7.4,False,8,False,0,0,0,18288,217,63,7.2,True,28.4925,495,1,1,285,280,5
BR1_2724814579,9,True,1,1,0,17324,185,71,6.8,False,6,False,0,0,0,15812,196,44,6.8,True,27.14075,1512,3,1,256,240,16
BR1_2724794362,12,False,1,0,0,20090,245,60,7.4,True,6,True,0,0,0,15444,189,56,6.8,False,26.565266666666666,4646,6,1,305,245,60
BR1_2724780924,7,True,1,1,0,19000,219,74,7.2,True,8,False,0,0,0,18303,263,61,7.6,False,29.842433333333332,697,-1,1,293,324,-31
BR1_2729679293,5,True,0,0,0,15918,187,48,6.8,False,6,False,1,1,0,17761,215,64,7.2,True,29.680883333333334,-1843,-1,-1,235,279,-44
BR1_2730733071,7,True,0,0,0,15584,173,36,6.4,False,12,False,1,1,0,18248,169,64,6.4,True,25.808416666666666,-2664,-5,-1,209,233,-24
BR1_2730700862,3,False,0,0,0,14817,207,72,7.0,False,3,True,0,1,0,15757,222,56,7.2,True,26.4669,-940,0,0,279,278,1
BR1_2731375030,9,True,1,0,0,19016,236,56,7.0,True,9,False,0,0,0,18963,235,52,7.4,False,29.501666666666665,53,0,1,292,287,5
BR1_2727108366,10,True,0,0,0,20234,224,52,7.0,False,7,False,0,1,0,17278,199,52,7.4,True,29.996316666666665,2956,3,0,276,251,25
BR1_2731662411,3,False,0,0,0,15075,191,56,6.8,False,7,True,1,0,0,16015,225,56,6.6,True,27.15823333333333,-940,-4,-1,247,281,-34
BR1_2730196971,4,True,0,1,0,16692,218,72,6.8,False,4,False,1,0,0,15274,202,56,6.6,True,25.732216666666666,1418,0,-1,290,258,32
BR1_2731700873,7,False,1,0,0,15787,172,48,6.6,True,8,True,0,0,0,16679,191,52,7.0,False,27.234733333333335,-892,-1,1,220,243,-23
BR1_2728365775,6,False,0,0,0,17973,225,60,7.2,False,12,True,0,1,0,21311,236,56,7.6,True,28.069883333333333,-3338,-6,0,285,292,-7
BR1_2727804024,8,False,1,1,0,17995,209,60,7.2,False,5,True,0,0,0,16695,229,60,7.2,True,29.25735,1300,3,1,269,289,-20
BR1_2727508364,1,False,0,1,0,13898,184,68,6.8,False,5,True,1,0,0,16673,243,76,7.2,True,26.5983,-2775,-4,-1,252,319,-67
BR1_2731293200,5,True,0,0,0,15937,209,55,7.0,False,2,False,0,0,0,14872,233,55,7.0,True,26.53035,1065,3,0,264,288,-24
BR1_2730848282,11,True,1,0,0,18211,195,64,6.4,True,5,False,0,1,0,15891,189,60,6.6,False,26.884733333333333,2320,6,1,259,249,10
BR1_2722150967,6,False,1,1,0,17253,224,51,7.0,True,4,True,0,0,0,14867,200,65,7.0,False,26.20195,2386,2,1,275,265,10
BR1_2730089675,7,True,0,0,0,17150,199,60,7.0,True,3,False,0,0,0,13430,191,20,6.2,False,25.4044,3720,4,0,259,211,48
BR1_2730066529,10,False,0,0,0,19361,222,60,7.6,True,8,True,1,0,0,18205,229,60,7.4,False,27.529116666666667,1156,2,-1,282,289,-7
BR1_2731723842,5,True,0,1,0,17685,258,47,7.4,True,8,False,1,0,0,17983,223,64,7.4,False,29.329383333333332,-298,-3,-1,305,287,18
BR1_2731699728,1,False,0,1,0,14398,199,44,6.6,False,12,True,1,0,0,18404,245,52,7.2,True,25.7805,-4006,-11,-1,243,297,-54
BR1_2721340364,8,True,1,0,0,17607,185,52,7.0,False,8,False,0,0,0,19593,267,50,7.6,True,28.953016666666667,-1986,0,1,237,317,-80
BR1_2720404676,11,False,0,1,0,18539,200,52,7.0,True,13,True,1,0,0,19652,182,52,6.6,False,26.176483333333334,-1113,-2,-1,252,234,18
BR1_2730450327,3,True,0,0,0,15253,210,64,7.0,False,4,False,1,1,0,15158,189,52,6.6,True,26.471433333333334,95,-1,-1,274,241,33
BR1_2726687985,6,False,0,0,0,15314,177,45,6.4,True,13,True,1,1,0,20264,229,68,7.2,False,27.036483333333333,-4950,-7,-1,222,297,-75
BR1_2725690611,8,True,1,1,0,20131,245,52,7.4,True,5,False,0,0,0,17450,239,64,7.4,False,28.163616666666666,2681,3,1,297,303,-6
BR1_2725661666,9,False,0,0,0,18581,246,52,7.4,True,5,True,0,0,0,17313,224,68,7.6,False,28.91075,1268,4,0,298,292,6
BR1_2725448369,10,True,1,0,0,18630,218,60,6.8,True,3,False,0,1,0,14473,198,44,6.6,False,27.15125,4157,7,1,278,242,36
BR1_2725407368,10,True,0,0,0,18683,273,50,7.6,False,8,False,1,1,0,19371,229,70,7.6,True,27.993,-688,2,-1,323,299,24
BR1_2731198818,11,False,1,0,0,18847,226,56,7.0,False,10,True,0,0,0,19492,229,62,7.2,True,29.339816666666668,-645,1,1,282,291,-9
BR1_2731247133,5,False,0,0,0,17777,204,58,7.2,False,14,True,0,0,0,20925,210,62,7.4,True,27.61245,-3148,-9,0,262,272,-10
BR1_2731202613,8,False,1,1,0,17594,204,60,7.2,True,9,True,0,0,0,19082,219,52,7.4,False,27.506716666666666,-1488,-1,1,264,271,-7
BR1_2727637134,5,False,1,0,0,17121,231,56,7.2,False,13,True,0,0,0,21141,233,60,7.6,True,28.025733333333335,-4020,-8,1,287,293,-6
BR1_2725265075,11,True,1,0,0,18664,205,52,6.8,True,3,False,0,0,0,14387,182,60,6.4,False,26.5948,4277,8,1,257,242,15
BR1_2724685393,6,True,1,0,0,16851,225,36,7.0,False,11,False,0,0,0,20046,245,63,7.6,True,29.997,-3195,-5,1,261,308,-47
BR1_2724174817,7,True,0,1,0,17219,183,56,7.0,False,10,False,1,0,0,20151,243,68,7.4,True,29.376,-2932,-3,-1,239,311,-72
BR1_2731683712,12,True,0,0,0,19108,223,43,7.2,False,6,False,0,1,0,18672,235,51,7.4,True,28.478933333333334,436,6,0,266,286,-20
BR1_2731656677,17,True,1,0,0,24075,256,60,7.8,True,7,False,0,0,0,18200,240,48,7.2,False,28.328466666666667,5875,10,1,316,288,28
BR1_2731635621,11,True,0,1,0,21051,219,73,7.8,True,7,False,0,0,0,17775,211,50,7.2,False,29.996683333333333,3276,4,0,292,261,31
BR1_2729873309,7,False,1,0,0,18178,214,52,7.2,False,12,True,0,1,0,20931,232,72,7.8,True,28.384283333333332,-2753,-5,1,266,304,-38
BR1_2729845197,6,True,0,0,0,18563,213,52,6.8,True,10,False,1,1,0,19204,220,60,7.4,False,28.113433333333333,-641,-4,-1,265,280,-15
BR1_2731849038,6,False,1,0,0,15473,196,44,6.6,False,9,True,0,1,0,19038,224,52,7.2,True,25.610316666666666,-3565,-3,1,240,276,-36
BR1_2731592073,7,False,0,0,0,16206,165,52,6.4,False,9,True,0,0,0,17661,184,48,6.6,True,26.125016666666667,-1455,-2,0,217,232,-15
BR1_2729883705,2,False,0,0,0,13721,164,57,6.6,False,9,True,1,1,0,18105,235,67,7.2,True,26.401333333333334,-4384,-7,-1,221,302,-81
BR1_2729873512,6,False,0,0,0,17714,229,64,7.2,False,6,True,1,0,0,17501,232,52,7.2,True,28.2049,213,0,-1,293,284,9
BR1_2714954988,8,False,0,0,0,17962,200,60,7.6,True,9,True,1,1,0,19497,247,54,7.2,False,28.26465,-1535,-1,-1,260,301,-41
BR1_2731241542,6,False,0,0,0,15620,180,44,6.6,False,10,True,1,0,0,18342,204,72,7.0,True,25.013933333333334,-2722,-4,-1,224,276,-52
BR1_2730721199,7,True,0,1,0,15804,189,44,6.8,False,6,False,1,0,0,16143,186,51,7.0,True,26.4996,-339,1,-1,233,237,-4
BR1_2721206536,5,True,1,0,0,17149,237,56,7.2,True,3,False,0,0,0,16186,232,72,7.2,False,28.1279,963,2,1,293,304,-11
BR1_2723078941,7,False,1,0,0,17264,232,56,7.6,False,9,True,0,1,0,19676,229,76,7.6,True,29.587516666666666,-2412,-2,1,288,305,-17
BR1_2715888621,5,False,1,0,0,16816,243,56,7.2,False,6,True,0,1,0,18251,234,68,7.2,True,27.61616666666667,-1435,-1,1,299,302,-3
BR1_2731718552,5,False,1,0,0,15962,206,60,7.0,True,7,True,0,0,0,15968,152,62,7.0,False,27.294583333333332,-6,-2,1,266,214,52
BR1_2731694742,4,False,0,1,1,16772,201,68,7.0,True,7,True,1,0,0,16333,200,35,6.6,False,26.4307,439,-3,-1,269,235,34
BR1_2731666566,8,True,0,1,0,17883,212,56,7.0,False,4,False,0,0,0,15105,189,60,6.6,True,26.656166666666667,2778,4,0,268,249,19
BR1_2730239482,10,False,1,0,0,19738,228,67,7.2,True,7,True,0,1,0,19142,250,60,7.6,False,29.637266666666665,596,3,1,295,310,-15
BR1_2730051667,9,False,0,0,0,19170,235,60,7.2,False,9,True,1,1,0,18540,231,60,7.6,True,28.831033333333334,630,0,-1,295,291,4
BR1_2729257402,8,False,1,0,0,18353,209,71,7.2,False,10,True,0,0,1,21033,241,68,7.8,True,27.943766666666665,-2680,-2,1,280,309,-29
BR1_2715022490,1,False,0,1,0,14584,195,55,6.4,True,7,True,0,0,0,17321,250,40,6.8,False,27.144983333333332,-2737,-6,0,250,290,-40
BR1_2721164649,3,False,0,0,0,15323,195,52,7.2,False,5,True,1,0,0,16250,223,48,7.4,True,27.774233333333335,-927,-2,-1,247,271,-24
BR1_2698352962,2,False,1,0,0,15146,250,48,6.6,False,8,True,0,1,0,17105,207,44,6.4,True,26.962033333333334,-1959,-6,1,298,251,47
BR1_2687039736,12,False,1,0,0,18973,188,52,7.2,False,10,True,0,0,0,19114,221,56,7.4,True,28.731283333333334,-141,2,1,240,277,-37
BR1_2730429563,6,True,0,0,0,15798,198,52,6.6,True,6,False,0,0,0,15657,198,48,6.8,False,26.531766666666666,141,0,0,250,246,4
BR1_2731691384,8,True,0,1,0,19374,249,80,7.6,True,3,False,1,0,0,16202,225,55,7.0,False,28.489166666666666,3172,5,-1,329,280,49
BR1_2710824215,4,True,0,0,0,15623,217,80,7.0,False,4,False,1,1,0,16687,243,50,7.2,True,25.584683333333334,-1064,0,-1,297,293,4
BR1_2731808573,9,False,0,0,0,16980,215,56,7.0,True,5,True,1,0,0,14978,197,60,6.6,False,26.22155,2002,4,-1,271,257,14
BR1_2729706955,10,True,0,1,0,18751,202,44,6.8,False,3,False,1,0,0,15343,233,48,6.4,True,27.097033333333332,3408,7,-1,246,281,-35
BR1_2729686650,8,False,0,1,0,19061,199,60,7.2,False,8,True,1,0,0,17937,224,59,7.4,True,27.576066666666666,1124,0,-1,259,283,-24
BR1_2729656904,3,False,0,0,0,14851,193,53,6.8,True,6,True,0,0,0,17167,233,50,7.2,False,25.751733333333334,-2316,-3,0,246,283,-37
BR1_2731606672,8,False,0,0,0,18239,240,56,7.0,True,5,True,0,1,0,16080,218,64,7.0,False,26.573666666666668,2159,3,0,296,282,14
BR1_2731340310,9,False,1,1,0,17148,200,68,7.0,True,4,True,0,0,0,15322,218,48,6.6,False,26.81811666666667,1826,5,1,268,266,2
BR1_2731718616,12,True,1,0,0,20486,240,64,7.4,True,6,False,0,1,0,18171,207,64,7.2,False,28.03665,2315,6,1,304,271,33
BR1_2721222818,6,True,1,0,0,17735,240,56,7.4,True,10,False,0,0,0,18083,224,47,6.8,False,28.422666666666668,-348,-4,1,296,271,25
BR1_2719496125,5,False,1,0,0,17333,253,68,7.6,False,5,True,0,0,0,17595,239,47,7.4,True,27.9876,-262,0,1,321,286,35
BR1_2730828221,10,False,1,0,0,19082,190,64,7.0,False,9,True,0,1,0,18101,194,56,7.0,True,28.770733333333332,981,1,1,254,250,4
BR1_2731468027,12,False,1,0,0,19270,192,64,6.8,True,10,True,0,0,0,17615,185,48,6.6,False,25.33025,1655,2,1,256,233,23
BR1_2731205611,15,True,1,0,0,21408,214,63,7.2,True,6,False,0,1,0,18360,215,52,6.8,False,28.743583333333333,3048,9,1,277,267,10
BR1_2727848393,4,False,0,0,0,15134,222,46,6.8,False,5,True,0,0,0,16396,234,54,7.4,True,26.487216666666665,-1262,-1,0,268,288,-20
BR1_2725213663,6,False,0,0,0,17048,215,64,7.2,False,11,True,1,1,1,21195,219,52,7.6,True,27.78175,-4147,-5,-1,279,271,8
BR1_2723665787,9,True,1,0,0,17847,229,52,7.4,True,2,False,0,0,0,14255,169,51,6.4,False,26.81845,3592,7,1,281,220,61
BR1_2731546208,4,True,0,0,0,15337,217,39,6.8,True,6,False,1,1,0,16106,190,60,7.0,False,26.25695,-769,-2,-1,256,250,6
BR1_2730556767,6,True,0,1,0,17333,226,62,7.0,True,9,False,1,0,0,18551,248,46,7.2,False,29.809416666666667,-1218,-3,-1,288,294,-6
BR1_2725839115,9,False,1,0,0,18439,192,56,7.0,True,9,True,0,0,0,18607,237,52,7.2,False,28.89675,-168,0,1,248,289,-41
BR1_2722757107,8,True,1,1,0,18037,221,60,7.6,True,9,False,0,0,0,19331,269,48,7.6,False,28.730983333333334,-1294,-1,1,281,317,-36
BR1_2718261911,10,False,0,0,0,20270,246,62,7.6,True,12,True,0,0,0,21613,214,52,7.4,False,28.17075,-1343,-2,0,308,266,42
BR1_2718125624,13,True,0,1,0,22186,245,68,7.8,True,8,False,1,0,0,18113,234,40,7.0,False,29.815566666666665,4073,5,-1,313,274,39
BR1_2731516983,7,False,1,0,1,17304,159,40,6.8,False,12,True,0,0,0,19852,190,56,7.4,True,27.6231,-2548,-5,1,199,246,-47
BR1_2731003486,6,True,0,0,0,17988,225,52,7.0,True,7,False,0,0,0,16645,170,62,7.2,False,27.673116666666665,1343,-1,0,277,232,45
BR1_2706756578,11,False,1,0,0,19333,200,80,7.4,False,6,True,0,1,0,17650,233,67,7.4,True,29.83085,1683,5,1,280,300,-20
BR1_2704974565,3,True,0,0,0,15610,197,68,7.0,False,6,False,0,0,0,16261,198,52,6.8,True,26.179966666666665,-651,-3,0,265,250,15
BR1_2704451684,10,False,0,1,0,19432,243,54,7.4,True,5,True,1,0,0,16046,201,56,6.8,False,28.601133333333333,3386,5,-1,297,257,40
BR1_2730648361,6,False,0,0,0,15166,184,48,7.0,True,9,True,0,0,0,16699,191,60,6.6,False,26.538416666666667,-1533,-3,0,232,251,-19
BR1_2730181772,10,True,1,1,0,19169,271,64,7.8,True,1,False,0,0,0,15457,237,52,7.4,False,29.572383333333335,3712,9,1,335,289,46
BR1_2729620891,6,False,0,1,0,17861,217,48,6.8,False,9,True,1,0,0,18754,187,60,7.0,True,29.516983333333332,-893,-3,-1,265,247,18
BR1_2706152929,4,False,0,0,0,15730,231,46,7.4,False,5,True,0,1,0,18072,256,48,7.6,True,29.555866666666667,-2342,-1,0,277,304,-27
BR1_2705150174,6,False,0,1,0,16592,191,48,6.8,True,8,True,0,0,0,16984,188,56,6.8,False,26.1112,-392,-2,0,239,244,-5
BR1_2731668848,9,True,0,0,0,16027,164,34,6.4,False,5,False,0,0,0,15372,188,46,6.6,True,26.963566666666665,655,4,0,198,234,-36
BR1_2707728217,7,True,0,0,0,18068,235,40,7.6,False,7,False,1,1,0,18371,224,60,7.4,True,28.631866666666667,-303,0,-1,275,284,-9
BR1_2700882611,7,True,1,0,0,16174,176,57,6.6,False,4,False,0,1,0,15643,201,46,6.8,True,26.829166666666666,531,3,1,233,247,-14
BR1_2699905384,10,True,0,1,0,17781,190,76,7.2,True,6,False,0,0,0,14896,189,43,6.8,False,25.179716666666668,2885,4,0,266,232,34
BR1_2697810545,10,False,1,1,0,19680,220,72,7.6,True,7,True,0,0,0,16815,232,18,6.6,False,28.2929,2865,3,1,292,250,42
BR1_2697798182,7,False,1,0,0,17472,211,79,7.8,False,2,True,0,0,0,15614,247,52,7.4,True,28.2388,1858,5,1,290,299,-9
BR1_2693666198,8,False,1,0,0,17117,230,48,6.6,False,7,True,0,1,0,17386,189,60,6.8,True,27.450383333333335,-269,1,1,278,249,29
BR1_2726988992,6,True,1,0,0,18061,221,63,7.4,True,2,False,0,1,0,16883,258,68,7.2,False,29.035783333333335,1178,4,1,284,326,-42
BR1_2726081176,6,False,1,0,0,17487,232,61,7.4,True,5,True,0,1,0,16439,183,58,7.2,False,29.458266666666667,1048,1,1,293,241,52
BR1_2721662668,3,True,0,1,0,13934,187,40,6.8,False,8,False,1,0,0,17687,208,72,7.0,True,27.394116666666665,-3753,-5,-1,227,280,-53
BR1_2731055711,11,True,0,0,0,17464,158,44,6.2,False,13,False,1,1,0,20548,229,60,7.0,True,26.532433333333334,-3084,-2,-1,202,289,-87
BR1_2731651723,11,False,1,0,0,19182,205,64,6.8,False,8,True,0,0,0,16976,207,44,6.6,True,25.6702,2206,3,1,269,251,18
BR1_2731744607,17,True,1,0,0,20807,231,72,7.6,True,6,False,0,0,0,15588,181,24,6.6,False,28.675666666666668,5219,11,1,303,205,98
BR1_2730766370,7,False,0,0,0,16052,191,36,6.2,False,8,True,0,0,0,16365,210,52,6.4,True,27.102316666666667,-313,-1,0,227,262,-35
BR1_2730734840,9,True,0,0,0,18655,225,48,7.0,True,3,False,0,0,0,14016,190,44,6.8,False,25.369616666666666,4639,6,0,273,234,39
BR1_2727787853,11,True,0,1,0,20752,221,60,7.2,True,9,False,1,0,0,19117,218,57,7.6,False,28.240333333333332,1635,2,-1,281,275,6
BR1_2727742726,13,True,1,0,0,19804,209,52,6.8,False,7,False,0,0,0,15986,169,42,6.6,True,26.545566666666666,3818,6,1,261,211,50
BR1_2731776480,3,True,0,1,0,14322,178,44,6.6,False,7,False,1,0,0,16786,232,48,7.0,True,25.216166666666666,-2464,-4,-1,222,280,-58
BR1_2728139343,11,False,0,1,0,20353,213,63,7.4,True,8,True,0,0,0,18534,232,56,7.2,False,28.19135,1819,3,0,276,288,-12
BR1_2731468566,16,True,0,1,0,21327,207,50,7.4,False,8,False,1,0,0,18196,222,40,7.0,True,28.64485,3131,8,-1,257,262,-5
BR1_2727971155,13,True,0,0,0,20845,252,63,7.8,True,6,False,0,0,0,16792,220,60,7.4,False,29.902466666666665,4053,7,0,315,280,35
BR1_2731744098,9,True,0,0,0,16394,176,40,6.6,False,7,False,0,0,0,16291,199,52,6.8,True,25.7834,103,2,0,216,251,-35
BR1_2731715966,7,False,1,0,0,15607,193,52,6.8,False,6,True,0,1,0,17462,211,56,7.0,True,25.075383333333335,-1855,1,1,245,267,-22
BR1_2723715132,9,True,1,0,0,16565,198,36,6.6,True,2,False,0,0,0,13503,197,47,6.6,False,27.143633333333334,3062,7,1,234,244,-10
BR1_2723661947,12,True,0,0,0,20826,220,68,7.2,False,5,False,0,0,0,17016,199,56,6.8,True,29.44995,3810,7,0,288,255,33
BR1_2723638659,10,True,0,1,0,20798,236,56,7.4,True,7,False,1,0,0,17206,194,64,7.0,False,29.707133333333335,3592,3,-1,292,258,34
BR1_2729924105,7,True,0,1,0,18246,208,62,7.2,True,10,False,0,0,0,17804,232,40,6.8,False,25.90825,442,-3,0,270,272,-2
BR1_2712504737,10,True,1,1,0,17714,175,51,6.8,True,4,False,0,0,0,14224,184,36,6.4,False,26.60765,3490,6,1,226,220,6
BR1_2729800818,8,True,0,0,0,17993,195,56,7.0,False,3,False,0,0,0,16621,217,60,7.4,True,27.931933333333333,1372,5,0,251,277,-26
BR1_2729616122,6,True,1,1,1,18208,218,52,7.0,True,8,False,0,0,0,16474,159,44,6.4,False,27.0726,1734,-2,1,270,203,67
BR1_2729559750,3,False,0,0,0,14810,193,60,6.8,False,8,True,1,0,0,17638,232,52,7.0,True,27.183833333333332,-2828,-5,-1,253,284,-31
BR1_2731611338,8,False,0,0,0,17258,205,52,7.4,False,12,True,1,1,0,19928,231,56,7.6,True,28.8444,-2670,-4,-1,257,287,-30
BR1_2731586886,6,True,1,0,0,17534,247,84,7.6,True,3,False,0,1,0,17167,230,68,7.2,False,29.475733333333334,367,3,1,331,298,33
BR1_2723312166,7,True,0,1,0,18182,219,48,7.2,True,8,False,0,0,0,18847,235,56,7.2,False,28.989233333333335,-665,-1,0,267,291,-24
BR1_2731599221,9,True,1,0,0,18151,217,52,7.2,False,13,False,0,1,1,22229,209,64,7.8,True,27.7957,-4078,-4,1,269,273,-4
BR1_2731221485,5,True,1,0,0,15066,188,60,6.6,True,4,False,0,0,0,14720,190,44,6.6,False,26.221166666666665,346,1,1,248,234,14
BR1_2685745434,6,False,0,0,0,16824,188,48,7.0,True,12,True,0,1,0,19670,193,48,7.4,False,29.287516666666665,-2846,-6,0,236,241,-5
BR1_2730343429,7,True,0,1,0,18202,222,48,7.2,False,10,False,1,0,0,19676,223,68,7.4,True,28.109266666666667,-1474,-3,-1,270,291,-21
BR1_2728583870,7,False,0,0,0,16367,191,56,7.0,False,10,True,0,0,0,17958,219,40,6.8,True,26.82571666666667,-1591,-3,0,247,259,-12
BR1_2731458791,9,True,0,1,0,20079,232,52,7.2,False,8,False,1,0,0,17699,197,54,7.2,True,29.54965,2380,1,-1,284,251,33
BR1_2731280215,3,True,0,1,0,17009,236,81,7.6,False,8,False,1,0,0,18860,261,58,7.8,True,27.77725,-1851,-5,-1,317,319,-2
BR1_2729719830,9,True,0,0,0,18004,183,52,6.6,True,1,False,1,0,0,13673,205,52,6.4,False,25.5302,4331,8,-1,235,257,-22
BR1_2731725226,9,True,0,0,0,16929,197,48,6.8,False,2,False,1,0,0,13675,181,44,6.4,True,27.215716666666665,3254,7,-1,245,225,20
BR1_2713125993,5,True,0,0,0,15057,157,48,6.2,False,10,False,0,0,0,17063,202,36,6.6,True,26.69645,-2006,-5,0,205,238,-33
BR1_2727272661,5,False,0,1,0,16822,254,51,7.0,False,7,True,1,0,0,15772,202,40,6.6,True,26.905183333333333,1050,-2,-1,305,242,63
BR1_2725105605,5,False,0,0,0,16620,248,71,7.4,False,5,True,1,0,0,15906,222,60,6.8,True,25.620966666666668,714,0,-1,319,282,37
BR1_2731696717,8,True,1,0,0,18413,211,60,7.2,True,9,False,0,1,0,19648,242,58,7.6,False,29.35183333333333,-1235,-1,1,271,300,-29
BR1_2731510726,6,True,1,0,0,15620,204,52,6.4,False,10,False,0,0,0,18718,241,52,6.6,True,26.023683333333334,-3098,-4,1,256,293,-37
BR1_2730365798,3,True,1,0,0,15625,226,52,6.8,False,1,False,0,1,0,14987,252,52,7.0,True,26.7637,638,2,1,278,304,-26
BR1_2729742203,5,False,1,0,0,17525,232,60,7.6,True,7,True,0,1,0,19209,279,64,7.8,False,29.398766666666667,-1684,-2,1,292,343,-51
BR1_2731635288,11,True,0,0,0,18630,221,48,6.8,True,6,False,0,0,0,15125,180,60,6.6,False,26.57045,3505,5,0,269,240,29
BR1_2716681492,9,True,1,0,0,20076,280,60,7.8,True,6,False,0,0,0,17915,250,44,7.2,False,29.4669,2161,3,1,340,294,46
BR1_2731825168,3,False,1,0,0,15592,215,32,7.0,False,13,True,0,1,0,20334,236,52,7.4,True,28.5573,-4742,-10,1,247,288,-41
BR1_2731746490,8,True,0,0,0,18603,191,58,7.2,True,8,False,1,0,0,19878,253,53,7.6,False,29.107583333333334,-1275,0,-1,249,306,-57
BR1_2729609774,5,False,0,1,0,17362,217,72,7.2,False,13,True,1,0,1,22876,248,64,8.0,True,28.244783333333334,-5514,-8,-1,289,312,-23
BR1_2731847942,8,False,1,1,0,18265,196,52,7.2,True,8,True,0,0,0,19353,237,68,7.4,False,28.112366666666667,-1088,0,1,248,305,-57
BR1_2725126289,6,True,1,0,0,16733,213,52,6.8,False,6,False,0,0,0,16059,221,43,6.6,True,26.619966666666667,674,0,1,265,264,1
BR1_2729229129,11,False,0,0,0,19429,215,64,7.4,False,10,True,0,1,1,21748,276,60,7.8,True,29.8626,-2319,1,0,279,336,-57
BR1_2730211993,6,True,0,0,0,17687,222,64,6.8,True,8,False,1,0,0,16687,199,58,6.8,False,25.795816666666667,1000,-2,-1,286,257,29
BR1_2728410777,13,True,0,0,0,21244,221,68,7.6,True,9,False,1,0,0,18753,194,72,7.2,False,29.387083333333333,2491,4,-1,289,266,23
BR1_2731468301,10,False,0,0,0,17468,175,60,6.8,False,8,True,1,1,0,16811,199,36,6.8,True,27.02391666666667,657,2,-1,235,235,0
BR1_2714468006,13,False,0,0,0,20633,215,64,7.8,True,4,True,0,1,0,17737,242,64,7.0,False,29.97585,2896,9,0,279,306,-27
BR1_2714165186,5,False,0,1,0,16216,204,72,7.0,False,7,True,0,0,0,17202,225,40,6.8,True,27.450633333333332,-986,-2,0,276,265,11
BR1_2729175024,9,True,1,1,1,20297,259,56,7.4,True,4,False,0,0,0,16126,210,59,7.4,False,27.613266666666668,4171,5,1,315,269,46
BR1_2731807892,6,False,0,0,0,17098,221,56,7.0,False,5,True,0,1,0,19050,249,60,7.2,True,27.507433333333335,-1952,1,0,277,309,-32
BR1_2731736590,3,False,0,0,0,15278,202,44,7.0,False,9,True,1,0,0,19298,263,72,7.4,True,28.359766666666665,-4020,-6,-1,246,335,-89
BR1_2731705650,7,True,0,0,0,17281,210,48,7.0,False,9,False,1,0,1,20398,293,67,7.8,True,28.504616666666667,-3117,-2,-1,258,360,-102
BR1_2731922334,7,True,1,0,0,18029,230,52,7.4,False,9,False,0,1,0,19266,239,66,7.2,True,28.196516666666668,-1237,-2,1,282,305,-23
BR1_2731905687,11,False,0,1,0,19009,218,44,6.6,True,10,True,1,0,0,19344,207,60,7.2,False,25.701283333333333,-335,1,-1,262,267,-5
BR1_2727454778,9,False,0,0,0,20255,235,42,7.0,False,21,True,1,0,0,22705,210,49,7.0,True,29.54906666666667,-2450,-12,-1,277,259,18
BR1_2711912312,9,True,0,0,0,18714,193,68,7.0,False,8,False,1,1,0,17717,197,68,6.8,True,26.17225,997,1,-1,261,265,-4
BR1_2700430453,10,False,0,0,0,19776,228,60,7.2,False,14,True,0,0,0,21689,263,44,7.8,True,28.0708,-1913,-4,0,288,307,-19
BR1_2727511425,8,True,0,0,0,17554,200,52,6.6,True,4,False,0,0,0,16155,227,64,6.8,False,25.172066666666666,1399,4,0,252,291,-39
BR1_2727414459,6,True,0,0,0,16196,205,46,6.6,False,6,False,0,0,0,16532,227,43,6.8,True,27.42556666666667,-336,0,0,251,270,-19
BR1_2731555549,5,False,0,0,0,16148,203,68,6.8,True,5,True,1,0,0,16124,193,64,7.0,False,25.316016666666666,24,0,-1,271,257,14
BR1_2724778053,7,True,1,1,0,19770,247,72,7.6,True,3,False,0,0,0,17008,236,64,7.4,False,28.25255,2762,4,1,319,300,19
BR1_2731819237,7,False,0,0,0,16167,190,39,6.4,False,10,True,1,0,0,17895,218,52,6.8,True,26.603016666666665,-1728,-3,-1,229,270,-41
BR1_2731793967,3,False,0,0,0,15884,202,44,6.8,False,10,True,0,1,0,20414,239,57,7.6,True,28.556616666666667,-4530,-7,0,246,296,-50
BR1_2730971628,6,False,0,1,0,16622,212,52,7.2,True,4,True,1,0,0,16274,218,56,6.8,False,26.4524,348,2,-1,264,274,-10
BR1_2731827612,12,True,0,1,0,19576,193,64,7.0,True,12,False,1,0,0,20223,225,55,7.2,False,28.594333333333335,-647,0,-1,257,280,-23
BR1_2728035545,6,True,1,0,0,18034,245,56,7.0,True,6,False,0,0,0,16255,221,55,7.0,False,26.877666666666666,1779,0,1,301,276,25
BR1_2727604669,3,False,0,0,0,15762,218,71,6.8,False,6,True,0,0,0,17420,235,64,7.0,True,27.00711666666667,-1658,-3,0,289,299,-10
BR1_2728059347,7,True,0,0,0,16130,195,43,6.6,True,6,False,0,0,0,16254,211,47,6.6,False,25.282166666666665,-124,1,0,238,258,-20
BR1_2718408171,9,True,1,0,0,18390,228,55,7.2,True,7,False,0,0,0,16643,202,55,6.8,False,26.639566666666667,1747,2,1,283,257,26
BR1_2731516805,2,True,1,1,0,16540,259,68,7.4,True,2,False,0,0,0,16295,260,60,7.4,False,29.205483333333333,245,0,1,327,320,7
BR1_2731508012,3,False,0,0,0,15582,222,72,6.8,False,8,True,0,0,0,18815,239,58,7.2,True,25.650733333333335,-3233,-5,0,294,297,-3
BR1_2731642741,14,True,0,0,0,18533,194,64,6.8,True,8,False,0,0,0,17041,194,64,6.8,False,26.95553333333333,1492,6,0,258,258,0
BR1_2731572292,10,True,0,0,0,20392,259,40,7.6,True,4,False,1,0,0,17586,254,80,7.6,False,28.494816666666665,2806,6,-1,299,334,-35
BR1_2731556388,3,False,1,1,0,16731,263,59,7.0,False,11,True,0,0,0,20400,262,52,7.6,True,28.723016666666666,-3669,-8,1,322,314,8
BR1_2731725103,6,True,0,1,0,18091,275,56,7.4,True,3,False,1,0,0,17093,238,92,7.4,False,29.607833333333332,998,3,-1,331,330,1
BR1_2731197983,3,False,0,0,0,15816,241,63,7.0,False,7,True,0,0,0,16405,202,40,6.8,True,26.065066666666667,-589,-4,0,304,242,62
BR1_2729562475,11,True,1,0,0,19275,237,56,7.6,True,6,False,0,0,0,18334,242,64,7.2,False,29.76655,941,5,1,293,306,-13
BR1_2731626879,8,False,0,1,0,19183,239,59,7.2,False,6,True,0,0,0,17322,243,56,7.0,True,28.512,1861,2,0,298,299,-1
BR1_2730043836,5,False,1,0,0,17972,262,80,7.4,True,6,True,0,1,0,18895,298,64,7.6,False,28.523566666666667,-923,-1,1,342,362,-20
BR1_2731781303,5,False,0,0,0,15591,198,46,6.8,True,9,True,1,0,1,18950,223,60,6.6,False,25.82235,-3359,-4,-1,244,283,-39
BR1_2731739830,6,False,0,0,0,17039,223,48,7.2,False,11,True,1,0,0,20691,238,60,7.6,True,28.0793,-3652,-5,-1,271,298,-27
BR1_2729278072,2,False,1,0,0,16528,236,63,7.4,False,8,True,0,0,0,19363,246,72,7.8,True,29.119583333333335,-2835,-6,1,299,318,-19
BR1_2731769803,7,True,0,0,0,15247,193,12,6.0,False,12,False,1,0,0,18181,180,57,7.0,True,26.348,-2934,-5,-1,205,237,-32
BR1_2718451985,6,True,0,0,0,16589,221,44,7.0,True,8,False,1,0,0,17020,220,44,6.6,False,27.453,-431,-2,-1,265,264,1
BR1_2727210504,8,False,1,1,0,19921,228,80,7.6,True,6,True,0,0,0,18597,244,60,7.6,False,28.910916666666665,1324,2,1,308,304,4
BR1_2729190717,3,False,1,1,0,15459,222,55,6.8,False,5,True,0,0,0,16423,239,52,7.2,True,25.466466666666665,-964,-2,1,277,291,-14
BR1_2729189356,7,True,0,0,0,17382,228,56,6.6,False,4,False,0,0,0,15759,214,68,6.8,True,26.142983333333333,1623,3,0,284,282,2
BR1_2729117593,6,False,1,0,0,17980,217,56,7.4,False,6,True,0,1,0,18422,225,64,7.2,True,27.902216666666668,-442,0,1,273,289,-16
BR1_2730040550,11,True,1,1,0,19325,223,64,6.6,True,6,False,0,0,0,16715,204,60,6.6,False,25.411183333333334,2610,5,1,287,264,23
BR1_2727763744,8,True,0,1,0,17786,199,51,6.4,True,10,False,1,0,0,17764,175,64,6.8,False,25.4352,22,-2,-1,250,239,11
BR1_2730998733,9,False,0,0,0,17810,212,52,6.8,False,8,True,0,1,0,18011,208,76,7.0,True,25.9933,-201,1,0,264,284,-20
BR1_2730778112,8,True,1,0,0,19165,242,60,7.6,True,10,False,0,0,0,19172,221,63,7.2,False,27.535,-7,-2,1,302,284,18
BR1_2731643099,3,True,0,0,0,14507,204,42,6.2,False,6,False,1,0,0,15967,227,33,6.8,True,25.95695,-1460,-3,-1,246,260,-14
BR1_2731096326,7,True,0,1,0,16710,187,56,7.0,True,6,False,1,0,0,15943,200,60,7.0,False,25.641716666666667,767,1,-1,243,260,-17
BR1_2730245513,5,True,0,0,0,17007,233,59,7.0,True,6,False,1,0,0,18206,246,72,7.2,False,27.8373,-1199,-1,-1,292,318,-26
BR1_2731676988,7,True,0,0,0,16795,212,45,6.6,False,4,False,0,0,0,14919,201,48,6.8,True,25.080116666666665,1876,3,0,257,249,8
BR1_2730000349,9,False,0,0,0,17829,205,52,6.8,True,8,True,0,0,0,16623,201,40,6.6,False,26.489383333333333,1206,1,0,257,241,16
BR1_2719603364,5,True,0,0,0,15905,217,51,6.8,False,5,False,0,0,0,15522,217,56,6.8,True,27.1983,383,0,0,268,273,-5
BR1_2730811287,6,True,0,1,0,18243,260,48,7.4,True,0,False,0,0,0,15012,241,68,7.4,False,28.526666666666667,3231,6,0,308,309,-1
BR1_2730787814,5,True,0,0,0,15492,180,48,6.6,True,4,False,0,0,0,14998,169,64,6.8,False,25.1734,494,1,0,228,233,-5
BR1_2729240206,12,True,0,1,0,19476,206,49,6.8,True,5,False,0,0,0,15471,192,38,6.4,False,26.438933333333335,4005,7,0,255,230,25
BR1_2731748424,8,True,0,0,0,16765,213,64,7.2,True,5,False,1,1,0,16731,229,60,7.2,False,27.21115,34,3,-1,277,289,-12
BR1_2731720610,17,True,0,0,0,22293,211,43,7.4,True,13,False,1,1,0,21230,241,56,7.2,False,27.76475,1063,4,-1,254,297,-43
BR1_2731699337,10,True,1,0,0,17544,228,54,7.2,True,3,False,0,0,0,16083,251,57,7.0,False,27.19225,1461,7,1,282,308,-26
BR1_2729484901,6,True,0,1,0,19371,235,68,7.6,False,11,False,0,0,0,19944,244,74,7.4,True,27.75895,-573,-5,0,303,318,-15
BR1_2728913481,8,True,1,0,0,20222,274,72,7.6,False,7,False,0,1,0,19809,271,60,7.4,True,29.012383333333332,413,1,1,346,331,15
BR1_2725987583,11,True,0,0,0,20167,240,58,7.8,True,5,False,1,0,0,16334,220,56,7.2,False,29.563533333333332,3833,6,-1,298,276,22
BR1_2731506696,13,True,1,0,0,20730,260,48,7.6,True,7,False,0,1,0,18848,247,68,7.4,False,29.633216666666666,1882,6,1,308,315,-7
BR1_2710170644,3,True,0,0,0,16572,252,60,7.4,False,5,False,1,0,0,17548,255,64,7.4,True,28.426083333333334,-976,-2,-1,312,319,-7
BR1_2731124027,5,False,0,0,0,16334,229,48,7.0,True,4,True,0,1,0,15527,204,58,6.8,False,25.575733333333332,807,1,0,277,262,15
BR1_2731575927,6,False,0,0,0,15843,210,52,6.6,True,11,True,1,1,0,19194,235,56,7.0,False,25.97145,-3351,-5,-1,262,291,-29
BR1_2731477434,9,False,0,1,0,17939,215,56,6.8,False,9,True,1,0,0,17364,209,52,7.0,True,25.769716666666667,575,0,-1,271,261,10
BR1_2729680010,7,False,1,0,0,18838,273,52,7.6,True,4,True,0,0,0,16048,236,60,7.2,False,27.85621666666667,2790,3,1,325,296,29
BR1_2729644957,7,False,0,1,0,18654,261,59,7.6,True,7,True,1,0,0,18676,271,63,7.6,False,28.505316666666666,-22,0,-1,320,334,-14
BR1_2729604248,11,False,0,0,0,20077,221,40,6.8,False,10,True,0,0,0,18354,223,44,7.0,True,28.965,1723,1,0,261,267,-6
BR1_2720131162,10,False,1,1,1,21933,266,68,8.2,True,5,True,0,0,0,17262,224,48,7.2,False,29.834333333333333,4671,5,1,334,272,62
BR1_2711238242,7,False,0,0,0,16555,182,47,6.2,False,8,True,1,0,0,17811,203,68,6.8,True,26.092283333333334,-1256,-1,-1,229,271,-42
BR1_2723946912,10,True,0,0,0,19771,238,32,7.2,False,7,False,0,0,0,18861,234,56,6.8,True,28.130866666666666,910,3,0,270,290,-20
BR1_2731642743,8,False,0,0,1,20128,251,60,7.4,False,15,True,1,0,0,20954,219,68,7.6,True,29.655466666666666,-826,-7,-1,311,287,24
BR1_2729431291,10,False,0,0,1,18959,248,81,7.8,False,8,True,0,1,0,20325,216,56,7.4,True,29.38575,-1366,2,0,329,272,57
BR1_2729308371,4,False,1,0,0,16566,244,52,7.4,False,10,True,0,1,0,19341,225,56,7.8,True,28.21365,-2775,-6,1,296,281,15
BR1_2728340250,3,False,1,0,1,17469,234,76,7.4,False,11,True,0,1,0,21275,269,60,7.4,True,28.18985,-3806,-8,1,310,329,-19
BR1_2731754535,8,False,0,0,0,18304,228,52,7.2,True,10,True,0,0,0,19291,216,56,7.2,False,28.6695,-987,-2,0,280,272,8
BR1_2731807689,4,False,0,0,0,15354,218,48,6.8,False,6,True,1,1,0,16326,221,55,7.0,True,25.91945,-972,-2,-1,266,276,-10
BR1_2731791325,6,False,0,0,0,16466,184,56,7.0,False,9,True,1,0,0,17755,212,60,6.8,True,25.473333333333333,-1289,-3,-1,240,272,-32
BR1_2731766752,8,False,0,1,0,19282,227,71,7.4,True,11,True,0,0,0,21159,277,36,7.6,False,29.741983333333334,-1877,-3,0,298,313,-15
BR1_2731236454,5,False,0,0,0,14904,181,46,6.6,False,4,True,1,1,0,15851,193,64,6.8,True,25.92645,-947,1,-1,227,257,-30
BR1_2730780347,8,False,0,0,0,17732,208,64,7.0,False,9,True,1,0,0,18892,241,68,7.2,True,28.893483333333332,-1160,-1,-1,272,309,-37
BR1_2731886086,9,True,0,0,0,17350,180,52,6.6,False,11,False,1,0,0,19001,234,48,6.8,True,25.433783333333334,-1651,-2,-1,232,282,-50
BR1_2729998004,8,True,1,0,0,17188,221,68,7.4,True,7,False,0,0,0,16770,218,43,6.6,False,26.115083333333335,418,1,1,289,261,28
BR1_2731591771,9,False,0,0,0,17207,189,64,6.8,False,6,True,1,0,1,18374,246,43,7.0,True,25.49825,-1167,3,-1,253,289,-36
BR1_2731161324,9,False,1,0,0,18433,224,68,7.4,False,11,True,0,0,0,21238,243,60,7.4,True,27.586916666666667,-2805,-2,1,292,303,-11
BR1_2731873536,8,True,0,0,0,17302,192,48,6.4,False,5,False,1,0,0,15533,207,60,7.0,True,26.489816666666666,1769,3,-1,240,267,-27
BR1_2731853889,11,True,0,1,0,19199,188,48,7.0,False,6,False,1,0,0,16492,174,68,6.6,True,25.029183333333332,2707,5,-1,236,242,-6
BR1_2731844605,6,False,1,1,0,17516,252,48,7.6,True,5,True,0,0,0,17256,254,60,7.4,False,27.655583333333333,260,1,1,300,314,-14
BR1_2729585707,12,True,1,0,0,19108,188,52,7.0,True,12,False,0,0,0,20286,230,48,7.4,False,28.5622,-1178,0,1,240,278,-38
BR1_2731947243,7,True,0,1,2,20318,258,48,7.2,True,5,False,1,0,0,17623,216,56,7.0,False,28.4962,2695,2,-1,306,272,34
BR1_2721972814,7,True,0,0,0,19029,227,65,7.4,False,7,False,1,0,0,18699,233,44,7.0,True,28.003733333333333,330,0,-1,292,277,15
BR1_2721928259,12,True,0,0,0,19260,207,59,6.8,True,10,False,0,0,0,18149,226,40,6.4,False,26.974216666666667,1111,2,0,266,266,0
BR1_2731465201,4,False,0,0,0,16890,258,56,7.4,False,3,True,1,1,0,17688,285,48,7.6,True,28.1437,-798,1,-1,314,333,-19
BR1_2720049179,7,False,1,0,0,16302,208,44,6.8,False,8,True,0,0,0,17921,233,44,7.0,True,25.244066666666665,-1619,-1,1,252,277,-25
BR1_2731055102,7,False,1,0,0,16022,190,48,6.8,True,6,True,0,1,0,16455,201,55,7.0,False,25.60075,-433,1,1,238,256,-18
BR1_2731659595,5,True,1,0,0,17155,231,60,7.0,False,9,False,0,0,0,19854,245,52,7.0,True,28.200566666666667,-2699,-4,1,291,297,-6
BR1_2731638598,3,False,0,0,0,14559,187,47,6.2,False,8,True,1,0,1,18552,217,52,7.0,True,27.1036,-3993,-5,-1,234,269,-35
BR1_2730681289,8,False,0,1,1,19948,252,73,7.6,False,9,True,0,0,0,19884,249,50,7.6,True,28.19625,64,-1,0,325,299,26
BR1_2731693188,4,False,0,0,0,17447,238,56,7.2,False,7,True,1,1,0,19428,249,68,7.8,True,29.0981,-1981,-3,-1,294,317,-23
BR1_2731649957,5,False,0,1,0,15503,203,44,6.8,False,10,True,1,0,0,17609,201,57,6.6,True,26.992733333333334,-2106,-5,-1,247,258,-11
BR1_2715004673,5,True,1,1,0,16794,249,60,7.2,True,1,False,0,0,0,14267,215,64,7.0,False,26.566083333333335,2527,4,1,309,279,30
BR1_2731805331,11,False,1,1,0,20140,264,67,7.6,True,5,True,0,0,0,17833,190,60,7.2,False,27.880283333333335,2307,6,1,331,250,81
BR1_2730025647,13,True,1,0,0,20051,239,56,7.0,True,4,False,0,1,0,16707,218,64,7.2,False,26.825916666666668,3344,9,1,295,282,13
BR1_2731615759,4,True,0,1,0,17375,264,76,6.8,True,7,False,1,0,0,16956,227,48,7.0,False,25.343766666666667,419,-3,-1,340,275,65
BR1_2725103554,11,True,1,1,0,20509,226,72,7.0,True,8,False,0,0,0,18937,233,56,7.6,False,29.799833333333332,1572,3,1,298,289,9
BR1_2723423735,7,True,1,0,0,17230,217,55,6.8,True,5,False,0,1,0,15971,224,43,6.8,False,26.206433333333333,1259,2,1,272,267,5
BR1_2723412608,11,True,1,0,0,19267,262,57,7.4,False,6,False,0,1,0,17557,239,45,7.2,True,29.66245,1710,5,1,319,284,35
BR1_2731150653,8,False,0,1,0,16832,178,51,6.6,True,7,True,1,0,0,16863,222,50,6.6,False,26.5786,-31,1,-1,229,272,-43
BR1_2731443099,9,True,0,0,0,18984,217,56,7.0,True,4,False,0,0,0,15208,193,36,6.4,False,26.559866666666668,3776,5,0,273,229,44
BR1_2731415335,11,False,0,0,0,20006,244,50,7.6,False,14,True,0,1,1,22220,212,64,7.6,True,29.849233333333334,-2214,-3,0,294,276,18
BR1_2731408326,11,True,0,1,1,21742,197,46,7.0,False,13,False,1,0,0,20462,231,66,7.8,True,28.437166666666666,1280,-2,-1,243,297,-54
BR1_2722956867,8,False,0,0,0,17873,180,60,6.6,False,12,True,1,0,0,19279,230,56,7.2,True,29.603783333333332,-1406,-4,-1,240,286,-46
BR1_2717618022,7,False,0,1,0,16981,209,52,7.0,False,8,True,1,0,1,19286,221,56,7.0,True,29.534866666666666,-2305,-1,-1,261,277,-16
BR1_2731868058,7,True,0,0,0,16345,219,48,6.8,True,6,False,0,0,0,16731,193,56,7.0,False,26.06705,-386,1,0,267,249,18
BR1_2731843082,10,False,0,1,0,19044,247,74,7.8,False,7,True,1,0,0,19425,240,69,7.2,True,29.16145,-381,3,-1,321,309,12
BR1_2728619356,12,True,0,0,0,17710,201,44,6.8,True,3,False,1,0,0,14401,192,58,6.4,False,25.6509,3309,9,-1,245,250,-5
BR1_2731838511,10,True,1,1,0,19724,221,72,7.4,True,6,False,0,0,0,17905,220,52,7.0,False,28.5653,1819,4,1,293,272,21
BR1_2731707505,11,False,1,0,0,21059,280,58,7.6,True,14,True,0,0,0,21488,223,60,7.8,False,27.67975,-429,-3,1,338,283,55
BR1_2731511372,8,False,1,0,0,17602,244,52,6.8,True,7,True,0,0,0,16022,186,56,7.0,False,27.09915,1580,1,1,296,242,54
BR1_2731328307,7,True,1,0,0,18220,259,76,7.8,False,4,False,0,1,0,16999,214,68,7.2,True,29.6861,1221,3,1,335,282,53
BR1_2730838540,8,True,1,0,0,17226,174,52,7.2,True,6,False,0,1,0,16308,184,73,7.0,False,25.737166666666667,918,2,1,226,257,-31
BR1_2731946425,11,True,1,1,0,18927,217,52,7.2,True,4,False,0,0,0,16027,227,60,6.8,False,25.020083333333332,2900,7,1,269,287,-18
BR1_2731939111,4,False,0,0,0,15915,218,72,7.0,False,4,True,1,1,0,16537,249,68,7.0,True,27.074716666666667,-622,0,-1,290,317,-27
BR1_2731925880,9,True,0,1,0,21006,238,64,7.4,True,2,False,0,0,0,15545,214,64,7.0,False,28.030816666666666,5461,7,0,302,278,24
BR1_2730514752,17,True,0,0,0,20191,188,52,7.2,True,5,False,0,0,0,15375,217,40,6.4,False,25.6487,4816,12,0,240,257,-17
BR1_2731395216,6,True,0,0,0,17631,241,60,7.2,True,5,False,0,0,0,16502,217,68,7.2,False,28.56375,1129,1,0,301,285,16
BR1_2730185545,4,True,0,0,0,17834,235,80,7.2,False,4,False,1,1,0,17947,244,52,7.4,True,28.34665,-113,0,-1,315,296,19
BR1_2730084153,4,False,0,0,0,16920,217,68,7.2,False,9,True,1,1,0,19683,247,71,7.8,True,29.128916666666665,-2763,-5,-1,285,318,-33
BR1_2730606468,9,True,1,0,0,19502,254,60,7.6,False,6,False,0,1,0,18247,247,60,7.4,True,28.7062,1255,3,1,314,307,7
BR1_2729351498,11,False,0,0,0,18704,221,52,7.0,True,8,True,0,0,0,17004,197,43,6.4,False,26.959733333333332,1700,3,0,273,240,33
BR1_2727556856,8,True,1,1,0,18294,214,68,7.0,True,6,False,0,0,0,16747,204,52,7.0,False,26.767233333333333,1547,2,1,282,256,26
BR1_2726389154,4,False,0,1,0,15595,206,56,6.8,False,5,True,1,0,0,16852,188,72,7.4,True,26.246933333333335,-1257,-1,-1,262,260,2
BR1_2731131272,3,False,0,0,0,16997,254,56,7.2,False,5,True,1,1,0,17377,236,68,7.4,True,27.7269,-380,-2,-1,310,304,6
BR1_2731112222,4,True,0,0,0,15664,258,59,7.0,True,2,False,0,1,0,14329,211,52,6.6,False,26.323366666666665,1335,2,0,317,263,54
BR1_2723395257,9,False,0,0,0,17913,192,48,6.6,True,6,True,1,0,0,15978,209,43,6.6,False,26.827116666666665,1935,3,-1,240,252,-12
BR1_2731355888,2,True,0,0,0,14749,204,60,6.8,True,4,False,1,0,0,16886,235,72,7.0,False,26.862666666666666,-2137,-2,-1,264,307,-43
BR1_2731117523,12,False,0,1,0,19749,187,68,7.2,True,8,True,1,0,0,15175,177,44,6.4,False,25.128316666666667,4574,4,-1,255,221,34
BR1_2731076275,6,False,0,0,0,16206,186,54,6.8,False,10,True,0,1,0,18826,251,52,6.8,True,25.034066666666668,-2620,-4,0,240,303,-63
BR1_2730408494,8,False,1,1,0,18464,226,58,7.0,False,5,True,0,0,0,18519,255,64,7.4,True,29.800233333333335,-55,3,1,284,319,-35
BR1_2729174859,6,False,1,0,0,16137,200,60,7.0,True,7,True,0,0,0,16489,199,44,6.6,False,25.359266666666667,-352,-1,1,260,243,17
BR1_2731328448,12,True,1,1,0,21098,208,56,7.4,True,9,False,0,0,0,19956,274,52,7.4,False,29.366716666666665,1142,3,1,264,326,-62
BR1_2731842885,8,True,0,0,0,19206,259,52,7.4,False,8,False,0,0,0,19537,249,52,7.4,True,29.97445,-331,0,0,311,301,10
BR1_2731835107,12,False,0,0,0,19137,185,44,6.6,True,7,True,1,0,0,16186,201,44,6.4,False,25.921916666666668,2951,5,-1,229,245,-16
BR1_2731815351,7,True,0,1,0,19116,249,60,7.6,False,9,False,1,0,0,19036,224,62,7.4,True,28.508133333333333,80,-2,-1,309,286,23
BR1_2731895692,3,False,0,1,0,17067,257,64,7.4,True,4,True,0,0,0,16868,232,64,7.8,False,29.630883333333333,199,-1,0,321,296,25
BR1_2728817375,10,False,0,1,0,18027,186,44,6.6,False,12,True,0,0,0,18401,194,48,7.0,True,25.3407,-374,-2,0,230,242,-12
BR1_2731925490,9,False,0,0,0,19323,208,52,7.0,False,13,True,0,0,0,18525,169,52,7.2,True,25.79315,798,-4,0,260,221,39
BR1_2731701682,14,True,1,1,0,20240,219,56,7.6,True,6,False,0,0,0,18537,225,48,7.2,False,28.495033333333332,1703,8,1,275,273,2
BR1_2731671591,10,False,0,1,0,18039,223,40,7.0,False,6,True,0,0,0,15695,193,48,6.8,True,26.867116666666668,2344,4,0,263,241,22
BR1_2731193219,9,True,1,0,0,17277,215,52,6.6,True,4,False,0,1,0,15487,228,36,6.8,False,26.922516666666667,1790,5,1,267,264,3
BR1_2731223200,10,True,0,0,0,19186,244,48,7.0,False,11,False,0,0,0,20142,265,56,7.6,True,27.656883333333333,-956,-1,0,292,321,-29
BR1_2730262700,5,False,0,1,0,15453,193,61,6.8,False,6,True,1,0,0,16404,216,69,7.2,True,26.23805,-951,-1,-1,254,285,-31
BR1_2731303162,9,True,0,0,0,17772,200,64,7.4,True,6,False,0,0,0,17198,255,56,7.0,False,27.325066666666668,574,3,0,264,311,-47
BR1_2724261327,3,True,0,0,0,15314,238,48,6.8,False,8,False,0,1,0,17709,219,62,7.0,True,26.37885,-2395,-5,0,286,281,5
BR1_2721049882,6,True,0,1,0,17366,243,60,6.8,True,7,False,0,0,0,17167,217,30,6.6,False,25.880583333333334,199,-1,0,303,247,56
BR1_2731542284,7,True,1,0,0,18676,237,51,7.6,False,7,False,0,1,0,19423,263,84,7.4,True,29.3954,-747,0,1,288,347,-59
BR1_2730763417,10,False,0,0,0,16967,139,40,6.2,False,13,True,0,0,0,18960,206,48,6.8,True,25.623933333333333,-1993,-3,0,179,254,-75
BR1_2731758972,11,True,1,1,0,17123,176,49,6.8,False,10,False,0,0,0,18431,208,46,6.8,True,26.142566666666667,-1308,1,1,225,254,-29
BR1_2731244349,5,False,0,0,0,15735,212,60,6.8,False,6,True,1,0,0,17206,234,63,7.0,True,26.66845,-1471,-1,-1,272,297,-25
BR1_2714535370,12,False,0,0,0,21091,237,52,7.2,True,9,True,1,1,0,18467,243,64,7.0,False,25.796433333333333,2624,3,-1,289,307,-18
BR1_2731821566,5,False,0,0,0,16048,235,44,6.4,True,6,True,1,1,0,15607,194,52,6.8,False,25.598133333333333,441,-1,-1,279,246,33
BR1_2731708979,5,True,0,1,0,17752,261,68,7.6,True,4,False,1,0,0,17325,266,60,7.6,False,29.0588,427,1,-1,329,326,3
BR1_2728337764,9,True,0,1,0,19696,232,48,7.4,True,11,False,0,0,0,20008,226,56,7.6,False,29.682916666666667,-312,-2,0,280,282,-2
BR1_2726477418,10,False,0,1,0,20692,247,76,7.4,False,17,True,1,0,0,21966,249,52,7.4,True,27.692066666666665,-1274,-7,-1,323,301,22
BR1_2731945498,5,False,0,1,0,18029,238,52,7.4,False,9,True,1,0,0,19227,263,47,7.2,True,29.41375,-1198,-4,-1,290,310,-20
BR1_2731231860,5,False,0,1,0,17821,241,80,7.8,True,4,True,1,0,0,17675,276,58,7.6,False,29.55775,146,1,-1,321,334,-13
BR1_2731204891,5,False,0,0,0,15868,224,56,6.8,False,8,True,1,0,0,18744,232,63,7.2,True,25.496233333333333,-2876,-3,-1,280,295,-15
BR1_2731264961,7,False,0,0,0,18811,272,56,7.6,False,4,True,1,0,0,17586,244,60,7.4,True,29.173733333333335,1225,3,-1,328,304,24
BR1_2731213908,14,True,0,0,0,21200,244,68,7.8,False,8,False,1,0,0,18638,219,46,7.0,True,29.616633333333333,2562,6,-1,312,265,47
BR1_2729970100,3,False,1,0,0,16132,229,60,7.0,False,6,True,0,0,0,16184,196,72,7.2,True,26.685033333333333,-52,-3,1,289,268,21
BR1_2729881709,4,False,0,1,0,15881,225,44,6.8,False,7,True,1,0,0,17249,236,48,7.0,True,26.807666666666666,-1368,-3,-1,269,284,-15
BR1_2720374249,6,True,0,1,0,18769,258,56,7.6,False,9,False,0,0,0,18684,254,64,7.6,True,29.054683333333333,85,-3,0,314,318,-4
BR1_2721663841,10,False,0,1,0,17873,212,47,6.6,True,12,True,0,0,0,19245,236,52,6.6,False,26.7643,-1372,-2,0,259,288,-29
BR1_2721621723,15,False,1,0,0,21114,233,56,7.4,True,8,True,0,0,0,17872,226,52,7.0,False,29.551083333333334,3242,7,1,289,278,11
BR1_2721601038,10,True,0,0,0,19005,262,52,7.4,False,10,False,1,0,0,18880,224,60,7.2,True,28.575466666666667,125,0,-1,314,284,30
BR1_2731878879,8,True,0,0,0,16139,183,60,6.6,False,9,False,1,1,0,18236,218,64,7.0,True,27.035516666666666,-2097,-1,-1,243,282,-39
BR1_2728560903,5,True,0,0,0,17656,241,76,7.4,False,7,False,1,0,0,18108,208,68,7.2,True,28.841816666666666,-452,-2,-1,317,276,41
BR1_2728089571,5,True,0,1,0,18517,281,52,7.4,True,6,False,0,0,0,16864,200,52,7.4,False,29.372083333333332,1653,-1,0,333,252,81
BR1_2729092341,7,False,0,1,0,16575,200,52,7.0,False,9,True,1,0,0,18075,211,44,6.8,True,27.144,-1500,-2,-1,252,255,-3
BR1_2729066560,2,False,1,0,0,17290,253,80,7.6,False,6,True,1,1,0,18086,246,56,7.8,True,28.011983333333333,-796,-4,0,333,302,31
BR1_2727509288,4,False,1,0,0,15233,233,44,6.8,True,4,True,0,0,0,15913,210,70,6.8,False,25.578266666666668,-680,0,1,277,280,-3
BR1_2726040136,11,False,0,0,0,18064,162,41,6.4,True,13,True,0,0,0,18186,201,44,6.6,False,27.34723333333333,-122,-2,0,203,245,-42
BR1_2713136540,8,False,0,1,0,18320,226,60,7.4,True,8,True,1,0,0,18514,211,64,7.4,False,28.565616666666667,-194,0,-1,286,275,11
BR1_2722821669,8,True,0,0,0,17915,228,47,6.8,True,5,False,0,0,0,15861,232,54,6.6,False,26.652583333333332,2054,3,0,275,286,-11
BR1_2726909897,7,True,0,0,0,17446,218,44,6.6,False,12,False,1,1,0,19425,240,60,7.2,True,26.553966666666668,-1979,-5,-1,262,300,-38
BR1_2726884184,4,False,1,0,0,14705,210,47,6.4,False,13,True,0,1,0,20809,221,67,7.2,True,26.707866666666668,-6104,-9,1,257,288,-31
BR1_2726840599,6,True,0,0,0,16439,221,51,7.0,True,2,False,0,0,0,14951,242,48,6.8,False,26.92655,1488,4,0,272,290,-18
BR1_2731257191,4,False,1,0,0,17028,253,67,7.6,False,5,True,0,0,0,17750,228,52,7.2,True,28.996033333333333,-722,-1,1,320,280,40
BR1_2727213836,5,False,0,0,0,18637,262,64,7.6,True,8,True,1,0,0,19368,244,64,7.4,False,29.8209,-731,-3,-1,326,308,18
BR1_2726588245,9,True,0,0,0,19406,219,76,8.0,True,3,False,1,0,0,16455,241,80,7.6,False,29.483383333333332,2951,6,-1,295,321,-26
BR1_2724473134,7,False,0,0,0,15205,173,40,6.6,False,6,True,0,0,0,16879,230,48,6.6,True,25.072783333333334,-1674,1,0,213,278,-65
BR1_2721311083,8,True,0,0,0,16667,206,46,6.8,False,7,False,0,0,0,15434,145,44,6.2,True,26.748716666666667,1233,1,0,252,189,63
BR1_2730039904,15,False,0,0,0,20228,204,35,6.8,False,8,True,0,0,0,17115,213,39,6.4,True,26.164283333333334,3113,7,0,239,252,-13
BR1_2730058564,7,False,1,0,0,16634,207,56,6.8,False,6,True,0,0,0,15854,211,48,6.6,True,26.147983333333332,780,1,1,263,259,4
BR1_2722530759,12,True,1,1,0,20645,221,59,7.4,True,10,False,0,0,0,19263,207,72,7.4,False,27.7284,1382,2,1,280,279,1
BR1_2720825204,9,True,0,0,0,19278,248,72,7.6,True,0,False,0,0,0,13445,234,44,6.6,False,25.763083333333334,5833,9,0,320,278,42
BR1_2720370142,4,False,0,0,0,15250,166,60,6.2,False,7,True,1,0,0,16883,215,56,6.8,True,25.10555,-1633,-3,-1,226,271,-45
BR1_2728997858,9,False,1,0,0,18718,191,52,7.0,True,11,True,0,0,0,20350,260,52,7.4,False,27.84205,-1632,-2,1,243,312,-69
BR1_2728189270,6,False,1,0,0,16551,226,50,6.8,False,4,True,0,0,0,15548,221,50,6.8,True,27.49035,1003,2,1,276,271,5
BR1_2731807516,6,True,0,1,1,18070,232,52,7.2,True,1,False,1,0,0,14778,215,68,7.0,False,25.711683333333333,3292,5,-1,284,283,1
BR1_2728732029,6,True,1,1,0,17101,229,60,7.0,True,6,False,0,0,0,16565,212,52,6.8,False,25.234916666666667,536,0,1,289,264,25
BR1_2728103559,14,True,0,0,0,20209,233,61,7.4,True,11,False,1,1,0,20474,229,56,7.4,False,28.615666666666666,-265,3,-1,294,285,9
BR1_2728089684,10,True,0,0,0,17852,196,56,6.8,True,7,False,0,0,0,16908,202,56,6.8,False,26.120066666666666,944,3,0,252,258,-6
BR1_2711370239,13,True,0,0,0,20346,226,63,7.4,True,8,False,0,0,0,18341,249,47,7.0,False,28.577133333333332,2005,5,0,289,296,-7
BR1_2731885105,10,True,1,1,0,19064,201,56,7.4,True,9,False,0,0,0,19549,232,71,7.6,False,28.912166666666668,-485,1,1,257,303,-46
BR1_2731877475,7,False,1,0,0,17200,205,56,7.0,True,8,True,0,1,1,20193,223,68,7.0,False,29.180616666666666,-2993,-1,1,261,291,-30
BR1_2730739245,13,True,0,0,0,22133,259,64,7.4,True,5,False,1,1,0,17355,210,51,7.2,False,27.572916666666668,4778,8,-1,323,261,62
BR1_2730709350,5,True,1,0,0,18576,275,60,7.8,True,1,False,0,1,0,16061,222,60,7.2,False,28.194866666666666,2515,4,1,335,282,53
BR1_2731787175,6,False,0,0,0,16178,196,64,6.8,False,7,True,0,0,0,18182,256,68,7.0,True,25.153,-2004,-1,0,260,324,-64
BR1_2731460999,11,True,1,1,0,18713,232,53,7.2,True,3,False,0,0,0,14529,185,50,6.4,False,26.7778,4184,8,1,285,235,50
BR1_2729150682,11,True,0,1,0,19301,240,60,7.0,True,7,False,1,0,0,16206,170,52,6.8,False,25.265666666666668,3095,4,-1,300,222,78
BR1_2724941213,7,False,0,0,0,19294,232,69,7.6,True,5,True,1,0,0,17305,240,48,7.2,False,28.7169,1989,2,-1,301,288,13
BR1_2728609638,9,True,1,1,0,19524,223,57,7.4,True,10,False,0,0,0,19466,234,70,7.2,False,27.627516666666665,58,-1,1,280,304,-24
BR1_2724674138,9,True,1,0,0,17905,234,44,7.2,False,5,False,0,1,0,17444,261,64,7.6,True,27.932316666666665,461,4,1,278,325,-47
BR1_2724091899,6,False,0,1,1,18232,218,80,7.2,False,11,True,1,0,0,21785,269,56,7.4,True,27.9333,-3553,-5,-1,298,325,-27
BR1_2715693263,4,False,0,1,0,15093,209,71,7.0,True,7,True,1,0,0,16525,221,60,7.0,False,27.483916666666666,-1432,-3,-1,280,281,-1
BR1_2730113126,9,False,1,0,0,20042,258,80,7.8,True,5,True,0,1,0,17443,207,60,6.8,False,29.19633333333333,2599,4,1,338,267,71
BR1_2729661198,5,True,0,0,0,17407,250,47,7.0,False,10,False,1,1,0,20224,253,56,7.6,True,29.415066666666668,-2817,-5,-1,297,309,-12
BR1_2728597731,7,True,0,1,1,20190,228,52,7.4,False,12,False,1,0,0,19651,228,84,8.0,True,29.013016666666665,539,-5,-1,280,312,-32
BR1_2728586285,9,True,1,0,0,17671,212,52,6.6,True,9,False,0,0,1,19470,210,60,7.2,False,27.03965,-1799,0,1,264,270,-6
BR1_2725115186,6,True,0,0,0,18035,237,48,7.0,True,8,False,1,1,0,19025,228,68,7.6,False,28.045066666666667,-990,-2,-1,285,296,-11
BR1_2731797903,7,True,1,0,0,16924,193,60,6.8,False,5,False,0,0,0,15644,202,44,7.0,True,26.6936,1280,2,1,253,246,7
BR1_2731377880,5,False,1,1,0,16806,204,56,6.8,False,10,True,0,0,1,20910,273,56,7.4,True,29.847266666666666,-4104,-5,1,260,329,-69
BR1_2731374874,8,False,0,0,0,18709,202,40,7.2,False,14,True,0,1,0,20562,212,44,7.4,True,28.73735,-1853,-6,0,242,256,-14
BR1_2730605937,7,False,0,1,0,18592,229,76,7.4,True,6,True,1,0,0,16820,211,56,7.0,False,29.150016666666666,1772,1,-1,305,267,38
BR1_2730590505,5,False,0,0,0,17043,213,56,7.4,False,10,True,0,1,0,20015,222,76,7.8,True,28.687416666666667,-2972,-5,0,269,298,-29
BR1_2731844924,12,True,1,1,0,19260,227,60,7.4,True,3,False,0,0,0,14467,189,60,6.6,False,26.1677,4793,9,1,287,249,38
BR1_2715569689,10,True,1,0,0,16749,185,44,6.4,True,7,False,0,1,0,16271,196,48,6.8,False,26.34615,478,3,1,229,244,-15
BR1_2715560729,10,False,0,0,0,19836,202,62,7.4,False,12,True,1,0,0,21201,257,53,7.6,True,29.532183333333332,-1365,-2,-1,264,310,-46
BR1_2731912919,9,True,1,1,0,18282,197,64,7.0,True,6,False,0,0,0,16844,208,52,6.8,False,27.252566666666667,1438,3,1,261,260,1
BR1_2731522456,13,True,0,0,0,21401,248,64,7.6,True,8,False,1,1,0,19095,229,43,7.4,False,28.03055,2306,5,-1,312,272,40
BR1_2731018505,5,False,0,0,0,15523,210,48,6.8,False,9,True,0,1,0,18238,237,60,6.8,True,27.248316666666668,-2715,-4,0,258,297,-39
BR1_2731874124,7,True,0,0,0,18432,223,51,7.2,False,8,False,1,1,0,18559,237,72,7.4,True,27.8399,-127,-1,-1,274,309,-35
BR1_2731864373,3,True,1,0,0,14729,194,61,6.8,False,9,False,0,0,0,16511,174,55,7.0,True,27.3792,-1782,-6,1,255,229,26
BR1_2730206883,11,False,1,0,0,20305,235,60,7.4,True,7,True,0,0,0,17855,229,60,7.4,False,27.883483333333334,2450,4,1,295,289,6
BR1_2728810064,8,False,1,0,0,18187,231,64,7.2,False,8,True,0,1,0,18782,205,36,7.2,True,29.49395,-595,0,1,295,241,54
BR1_2730922120,4,False,0,0,0,14990,222,40,6.4,False,12,True,0,1,0,18777,223,47,7.2,True,27.2177,-3787,-8,0,262,270,-8
BR1_2730911892,3,True,0,0,0,15140,220,44,6.6,True,5,False,1,1,0,16856,229,68,7.0,False,26.388866666666665,-1716,-2,-1,264,297,-33
BR1_2727066496,9,False,1,0,0,19466,210,52,7.2,True,13,True,0,1,0,20057,187,44,7.2,False,27.98975,-591,-4,1,262,231,31
BR1_2731810247,9,True,0,0,0,18901,211,49,7.2,False,13,False,0,1,0,19913,203,64,7.6,True,29.229133333333333,-1012,-4,0,260,267,-7
BR1_2731470804,11,True,1,0,0,20161,237,60,7.6,False,10,False,0,1,0,20775,241,60,7.8,True,27.73135,-614,1,1,297,301,-4
BR1_2723589006,9,True,1,1,1,20013,245,71,7.8,True,2,False,0,0,0,16632,250,50,7.4,False,29.963433333333334,3381,7,1,316,300,16
BR1_2723328153,10,False,1,0,0,19596,272,56,7.4,True,4,True,0,1,0,16851,215,58,7.0,False,27.98281666666667,2745,6,1,328,273,55
BR1_2710801439,9,False,1,0,0,17358,214,48,6.6,False,10,True,0,1,0,19315,199,47,6.6,True,25.338016666666668,-1957,-1,1,262,246,16
BR1_2729362674,10,False,1,1,0,19069,221,54,6.8,True,15,True,0,0,0,19372,207,59,7.2,False,26.9676,-303,-5,1,275,266,9
BR1_2729963694,9,True,1,0,0,20257,263,60,7.8,True,6,False,0,0,0,16518,206,51,7.2,False,27.842366666666667,3739,3,1,323,257,66
BR1_2729946657,9,False,1,0,0,17210,172,64,6.6,True,7,True,0,1,0,17759,207,63,6.8,False,25.6305,-549,2,1,236,270,-34
BR1_2727829460,8,False,1,0,0,18269,225,45,7.2,False,14,True,0,0,0,22943,280,74,7.8,True,28.41,-4674,-6,1,270,354,-84
BR1_2720981901,0,False,0,0,0,13534,233,51,6.6,False,7,True,1,1,0,18238,261,56,7.0,True,26.77515,-4704,-7,-1,284,317,-33
BR1_2710315505,5,False,0,0,0,17713,270,74,7.8,True,5,True,1,1,1,19463,261,58,7.4,False,28.443216666666668,-1750,0,-1,344,319,25
BR1_2731868197,4,True,0,1,0,16443,229,64,7.0,False,5,False,1,0,0,16135,190,60,7.0,True,26.873966666666668,308,-1,-1,293,250,43
BR1_2731279201,9,True,0,0,0,19373,228,56,6.8,False,3,False,0,0,0,14494,208,42,6.2,True,26.8006,4879,6,0,284,250,34
BR1_2730318465,10,False,1,0,0,18282,179,56,6.4,False,10,True,0,1,0,20078,235,64,7.4,True,28.640183333333333,-1796,0,1,235,299,-64
BR1_2727120143,11,False,1,1,1,21784,242,68,7.6,False,4,True,0,0,0,15825,219,52,7.0,True,29.638083333333334,5959,7,1,310,271,39
BR1_2726603697,7,True,0,1,0,17906,222,65,7.2,True,7,False,1,0,0,18245,271,47,7.2,False,28.378616666666666,-339,0,-1,287,318,-31
BR1_2731867960,7,True,0,0,0,18381,222,84,7.0,False,9,False,0,0,0,18471,225,48,7.4,True,29.3227,-90,-2,0,306,273,33
BR1_2730221383,3,False,0,0,0,14909,187,48,7.2,False,14,True,0,0,0,21264,221,68,7.8,True,28.13155,-6355,-11,0,235,289,-54
BR1_2707776292,9,True,0,0,0,18940,228,44,7.0,True,10,False,0,0,0,20120,256,51,7.4,False,28.60245,-1180,-1,0,272,307,-35
BR1_2707452538,7,True,0,0,0,17708,208,68,6.6,False,6,False,1,0,0,17273,232,48,6.6,True,26.7762,435,1,-1,276,280,-4
BR1_2731805598,8,False,0,1,0,19893,257,52,7.2,True,7,True,1,0,0,17904,219,68,7.2,False,29.501683333333332,1989,1,-1,309,287,22
BR1_2731693419,8,False,1,0,0,17797,213,52,7.2,False,14,True,0,0,0,21835,228,60,7.2,True,29.615783333333333,-4038,-6,1,265,288,-23
BR1_2730339994,6,True,1,0,0,16885,202,56,7.0,True,8,False,0,1,0,17773,221,48,7.0,False,26.649166666666666,-888,-2,1,258,269,-11
BR1_2719194985,9,True,0,0,0,18044,225,49,6.8,True,8,False,0,0,0,17828,242,40,6.8,False,26.063,216,1,0,274,282,-8
BR1_2730634343,5,True,0,0,0,15825,201,56,6.4,False,7,False,0,0,0,17386,236,44,6.6,True,27.042033333333332,-1561,-2,0,257,280,-23
BR1_2719205543,9,False,0,0,0,19809,265,67,7.4,False,13,True,0,0,0,22031,272,64,7.6,True,29.124116666666666,-2222,-4,0,332,336,-4
BR1_2718900024,14,True,1,1,0,23166,253,58,7.6,False,7,False,0,0,0,18237,223,49,6.4,True,29.185616666666668,4929,7,1,311,272,39
BR1_2730224107,5,True,0,1,0,15613,189,59,6.8,False,6,False,1,0,0,17403,224,71,7.2,True,26.175316666666667,-1790,-1,-1,248,295,-47
BR1_2730154960,7,True,1,1,0,17288,241,37,7.2,False,7,False,0,0,0,18816,227,63,7.4,True,27.87698333333333,-1528,0,1,278,290,-12
BR1_2730111046,6,False,0,0,0,17192,222,55,7.0,False,9,True,1,1,0,18119,218,60,7.2,True,25.782933333333332,-927,-3,-1,277,278,-1
BR1_2718448755,10,False,1,0,0,19180,219,92,7.6,True,4,True,0,0,0,16108,237,36,7.0,False,27.513316666666668,3072,6,1,311,273,38
BR1_2729920506,12,False,0,1,0,20565,200,52,7.0,True,10,True,0,0,0,19019,227,58,7.4,False,29.985533333333333,1546,2,0,252,285,-33
BR1_2729851704,3,False,1,0,0,15821,222,69,7.0,False,12,True,0,1,0,22327,229,50,7.6,True,27.570183333333333,-6506,-9,1,291,279,12
BR1_2720249338,5,False,1,1,0,17033,225,60,7.0,True,11,True,0,0,0,18763,238,64,7.2,False,25.29995,-1730,-6,1,285,302,-17
BR1_2720224332,11,True,1,0,0,18449,203,56,6.8,True,12,False,0,1,0,19358,203,52,6.8,False,27.040216666666666,-909,-1,1,259,255,4
BR1_2715906090,7,False,0,0,0,18924,279,47,7.4,False,5,True,1,1,0,18248,256,67,7.4,True,29.555416666666666,676,2,-1,326,323,3
BR1_2729484088,9,True,0,0,0,17101,195,52,6.6,False,8,False,1,1,0,18215,214,76,7.0,True,26.683033333333334,-1114,1,-1,247,290,-43
BR1_2731938548,15,True,0,1,1,22538,204,60,7.4,True,14,False,1,0,0,22652,217,60,7.4,False,28.123283333333333,-114,1,-1,264,277,-13
BR1_2731235192,2,True,0,1,0,15534,215,56,7.0,False,6,False,1,0,0,17824,247,60,7.2,True,26.620816666666666,-2290,-4,-1,271,307,-36
BR1_2730981556,8,True,0,1,0,17500,219,48,7.0,False,7,False,1,0,0,17262,230,48,7.0,True,27.198383333333332,238,1,-1,267,278,-11
BR1_2730925618,6,False,1,0,0,17622,224,56,6.8,False,8,True,0,0,0,18632,267,56,7.2,True,28.57205,-1010,-2,1,280,323,-43
BR1_2731395910,5,False,0,0,0,17433,250,62,7.2,False,8,True,0,1,0,20165,273,60,7.6,True,27.584883333333334,-2732,-3,0,312,333,-21
BR1_2731004015,10,False,0,1,0,18180,225,60,7.2,True,6,True,0,0,0,16930,224,64,6.4,False,26.88265,1250,4,0,285,288,-3
BR1_2730869373,9,True,1,0,0,17964,210,64,7.0,True,4,False,0,0,0,14195,177,40,6.6,False,26.172666666666668,3769,5,1,274,217,57
BR1_2730864059,7,False,0,1,0,17766,229,56,6.8,False,11,True,1,0,0,17848,189,56,6.8,True,27.377633333333332,-82,-4,-1,285,245,40
BR1_2725101906,12,True,1,0,0,21538,272,72,7.6,True,7,False,0,0,0,17800,255,40,7.0,False,29.304016666666666,3738,5,1,344,295,49
BR1_2725349012,4,False,1,0,0,15756,192,59,6.8,False,8,True,0,1,0,19121,242,56,7.0,True,26.142033333333334,-3365,-4,1,251,298,-47
BR1_2731843579,6,False,1,0,0,17405,214,47,7.0,False,9,True,0,0,0,20860,268,44,7.2,True,29.40495,-3455,-3,1,261,312,-51
BR1_2731823998,10,True,1,0,0,19320,225,58,7.2,True,4,False,0,0,0,16914,260,56,7.2,False,27.80003333333333,2406,6,1,283,316,-33
BR1_2731807594,2,True,0,1,0,16297,250,64,7.6,False,3,False,1,0,0,16226,243,52,7.2,True,28.601333333333333,71,-1,-1,314,295,19
BR1_2712075460,14,True,0,1,0,21879,247,56,7.2,True,4,False,1,0,0,18007,245,60,7.4,False,29.52035,3872,10,-1,303,305,-2
BR1_2708848508,8,False,1,0,0,19819,259,72,7.4,True,8,True,0,1,0,19737,293,47,7.6,False,28.9688,82,0,1,331,340,-9
BR1_2731808879,10,True,0,0,0,18234,223,44,7.0,False,7,False,1,0,0,17803,204,52,7.0,True,25.105883333333335,431,3,-1,267,256,11
BR1_2731719477,9,True,0,1,1,21292,259,48,7.2,True,5,False,1,0,0,16463,203,56,7.0,False,27.920066666666667,4829,4,-1,307,259,48
BR1_2731381477,6,False,1,1,1,19676,225,64,7.4,True,8,True,0,0,0,18279,237,48,7.4,False,28.34335,1397,-2,1,289,285,4
BR1_2731311506,5,False,0,0,0,15456,200,52,6.6,False,11,True,1,0,0,18500,222,64,7.0,True,26.937833333333334,-3044,-6,-1,252,286,-34
BR1_2731607869,0,False,0,1,0,14465,248,46,7.0,False,3,True,1,0,0,15868,220,84,7.2,True,25.886516666666665,-1403,-3,-1,294,304,-10
BR1_2731205911,13,False,1,1,0,21082,219,72,7.6,True,11,True,0,0,0,21352,226,68,7.2,False,29.456483333333335,-270,2,1,291,294,-3
BR1_2730685588,5,False,0,1,0,18510,270,56,7.6,True,6,True,1,0,0,18693,285,60,7.4,False,29.91435,-183,-1,-1,326,345,-19
BR1_2728047724,1,False,0,0,0,14303,224,48,6.6,False,6,True,0,0,0,18062,249,64,7.2,True,27.1527,-3759,-5,0,272,313,-41
BR1_2715597248,5,False,1,0,0,15498,233,34,7.0,True,5,True,0,0,0,15599,207,70,6.8,False,26.873466666666666,-101,0,1,267,277,-10
BR1_2715576716,6,True,0,1,0,18302,232,64,7.2,False,5,False,1,0,0,16948,226,63,7.2,True,28.1202,1354,1,-1,296,289,7
BR1_2731911257,11,True,1,0,0,19612,229,56,7.4,True,10,False,0,0,0,18974,216,59,7.2,False,29.790733333333332,638,1,1,285,275,10
BR1_2731383081,5,False,0,0,0,14998,160,52,6.8,False,10,True,1,1,1,21367,244,60,7.8,True,29.512983333333334,-6369,-5,-1,212,304,-92
BR1_2731374967,9,True,1,0,0,17801,176,48,7.0,False,11,False,0,0,0,20508,196,68,7.2,True,27.58265,-2707,-2,1,224,264,-40
BR1_2730975294,5,True,1,1,0,17223,209,56,6.8,True,5,False,0,0,0,17191,184,56,6.6,False,25.79318333333333,32,0,1,265,240,25
BR1_2730877735,5,False,1,0,0,15829,182,58,6.6,False,11,True,0,0,0,18906,194,56,7.0,True,26.30065,-3077,-6,1,240,250,-10
BR1_2727874567,6,True,0,0,0,16466,213,64,7.0,False,3,False,0,0,0,16549,242,71,7.0,True,26.698566666666668,-83,3,0,277,313,-36
BR1_2727853619,9,True,0,1,0,19916,230,63,7.0,False,9,False,1,0,0,19108,260,58,7.6,True,27.913816666666666,808,0,-1,293,318,-25
BR1_2731783669,5,False,0,1,0,16959,222,64,7.2,False,6,True,1,0,0,17918,278,68,7.4,True,29.978483333333333,-959,-1,-1,286,346,-60
BR1_2731691105,4,True,1,0,0,15514,211,56,6.6,True,2,False,0,1,0,14352,190,56,6.8,False,25.63785,1162,2,1,267,246,21
BR1_2722051821,3,True,1,1,0,16791,227,72,7.4,True,4,False,0,0,0,15679,204,52,7.0,False,29.789583333333333,1112,-1,1,299,256,43
BR1_2715289061,6,False,0,0,0,16290,216,48,7.0,False,6,True,1,0,0,16949,234,59,7.0,True,26.992183333333333,-659,0,-1,264,293,-29
BR1_2713182333,13,True,0,0,0,20672,201,58,7.0,True,7,False,0,0,0,15502,198,56,6.4,False,26.129016666666665,5170,6,0,259,254,5
BR1_2731570672,7,True,0,1,0,18702,268,68,7.4,False,4,False,1,0,0,17181,217,56,7.2,True,28.1562,1521,3,-1,336,273,63
BR1_2730391829,10,False,1,0,0,17536,172,60,6.8,True,13,True,0,0,0,19115,196,40,6.8,False,25.137233333333334,-1579,-3,1,232,236,-4
BR1_2731157859,6,True,1,0,0,19183,248,68,7.8,True,4,False,0,0,0,16002,210,60,6.8,False,29.941083333333335,3181,2,1,316,270,46
BR1_2730307557,6,False,0,0,0,19182,250,59,7.6,True,9,True,1,1,0,19063,241,56,7.4,False,28.06365,119,-3,-1,309,297,12
BR1_2718935558,8,False,0,1,0,18348,198,56,6.8,False,11,True,1,0,0,17570,192,56,6.8,True,27.358666666666668,778,-3,-1,254,248,6
BR1_2731177840,8,False,0,1,0,18614,222,55,7.2,True,9,True,1,0,0,18615,208,72,7.2,False,29.6552,-1,-1,-1,277,280,-3
BR1_2731111966,4,True,1,0,0,15744,215,58,7.4,False,9,False,0,1,0,19845,260,54,7.2,True,29.311016666666667,-4101,-5,1,273,314,-41
BR1_2731071222,13,True,0,1,0,20298,205,41,7.0,True,12,False,0,0,0,18787,198,38,6.6,False,25.247133333333334,1511,1,0,246,236,10
BR1_2730895608,1,False,0,1,0,16047,230,72,7.0,False,9,True,1,0,0,18276,193,64,7.2,True,27.703766666666667,-2229,-8,-1,302,257,45
BR1_2729045571,8,True,0,1,0,17079,197,60,6.6,True,12,False,0,0,0,19840,241,44,7.0,False,25.625333333333334,-2761,-4,0,257,285,-28
BR1_2731676427,8,False,0,0,0,18244,219,60,7.2,True,8,True,1,0,0,19553,271,67,7.4,False,29.761216666666666,-1309,0,-1,279,338,-59
BR1_2731059347,5,False,0,0,0,15879,227,66,7.2,False,3,True,0,0,0,15664,246,56,7.0,True,25.84545,215,2,0,293,302,-9
BR1_2731014968,9,True,1,1,0,19022,274,56,7.8,True,3,False,0,0,0,17621,259,71,7.4,False,29.1181,1401,6,1,330,330,0
BR1_2730268263,5,False,1,0,0,16781,211,41,7.0,True,11,True,0,1,0,19890,256,71,7.6,False,27.720666666666666,-3109,-6,1,252,327,-75
BR1_2731524805,6,True,0,1,0,16620,201,59,6.6,True,8,False,1,0,0,17823,243,58,7.0,False,26.66405,-1203,-2,-1,260,301,-41
BR1_2730562614,8,True,0,1,1,19545,220,60,7.0,True,6,False,1,0,0,16364,196,52,6.6,False,26.195333333333334,3181,2,-1,280,248,32
BR1_2730549498,10,True,0,1,0,17611,187,64,6.8,True,8,False,1,0,0,18543,222,55,7.2,False,27.6512,-932,2,-1,251,277,-26
BR1_2730466145,7,False,0,1,0,18433,232,54,7.2,False,11,True,1,0,0,20539,254,61,7.4,True,27.56605,-2106,-4,-1,286,315,-29
BR1_2726179600,16,True,0,1,0,21247,221,48,6.8,False,13,False,1,0,0,19888,187,60,6.8,True,26.986533333333334,1359,3,-1,269,247,22
BR1_2729721667,13,True,1,0,0,20623,242,56,7.0,True,5,False,0,0,0,15142,183,60,6.6,False,25.241683333333334,5481,8,1,298,243,55
BR1_2724920521,4,False,0,0,0,14598,176,40,6.6,False,10,True,0,1,0,17784,179,56,7.0,True,27.483216666666667,-3186,-6,0,216,235,-19
BR1_2719480402,9,True,1,0,0,18119,243,64,7.4,False,2,False,0,0,0,15434,233,56,7.0,True,27.15345,2685,7,1,307,289,18
BR1_2730705697,13,False,0,0,0,20655,222,53,7.2,False,10,True,1,0,0,20457,248,58,7.2,True,27.632266666666666,198,3,-1,275,306,-31
BR1_2729719313,6,False,0,0,0,17735,248,79,7.4,False,11,True,1,1,0,20720,269,56,7.6,True,27.51105,-2985,-5,-1,327,325,2
BR1_2729650994,8,False,0,0,0,17839,222,55,7.0,True,4,True,1,0,0,15460,217,53,7.0,False,27.4375,2379,4,-1,277,270,7
BR1_2729621321,11,False,0,1,0,21125,224,72,7.4,False,14,True,1,0,0,21336,220,64,7.4,True,28.980216666666667,-211,-3,-1,296,284,12
BR1_2713331024,9,False,1,1,0,20520,235,87,8.0,True,6,True,0,0,0,17803,253,64,7.4,False,27.7541,2717,3,1,322,317,5
BR1_2731759464,16,True,1,0,0,22627,243,55,7.6,True,11,False,0,0,0,20191,202,52,7.0,False,28.69635,2436,5,1,298,254,44
BR1_2730950725,9,True,0,0,0,20175,244,79,7.2,True,9,False,0,0,0,18791,248,52,7.4,False,28.153866666666666,1384,0,0,323,300,23
BR1_2728198950,10,True,1,1,1,19682,227,57,7.4,False,5,False,0,0,0,18360,252,49,7.6,True,29.79535,1322,5,1,284,301,-17
BR1_2730128710,11,False,0,0,0,19921,198,64,7.4,False,12,True,1,1,0,19801,183,56,7.2,True,28.63458333333333,120,-1,-1,262,239,23
BR1_2730670005,9,True,0,0,0,18603,235,56,7.2,False,12,False,1,0,0,20519,216,64,7.6,True,27.689316666666667,-1916,-3,-1,291,280,11
BR1_2729130343,6,False,1,0,0,15936,213,52,6.6,False,7,True,0,0,0,16886,206,63,7.0,True,26.3849,-950,-1,1,265,269,-4
BR1_2729114039,5,True,1,0,0,16674,245,76,7.0,True,3,False,0,0,0,15744,209,57,7.0,False,26.51205,930,2,1,321,266,55
BR1_2731697749,8,True,0,0,0,17644,202,67,6.4,False,5,False,1,0,0,18655,270,68,7.8,True,29.493466666666666,-1011,3,-1,269,338,-69
BR1_2731651911,12,True,0,1,0,18699,209,56,7.0,True,4,False,1,0,0,14386,186,43,6.6,False,26.882383333333333,4313,8,-1,265,229,36
BR1_2716375383,12,True,1,1,0,19269,245,44,6.8,True,7,False,0,0,0,16732,212,48,6.8,False,25.0807,2537,5,1,289,260,29
BR1_2730529261,13,False,0,1,0,22280,201,76,7.2,False,10,True,1,0,0,19350,212,48,7.0,True,29.278433333333332,2930,3,-1,277,260,17
BR1_2729771541,5,True,0,0,0,15318,211,52,6.6,False,5,False,0,1,0,16818,244,44,7.0,True,27.04115,-1500,0,0,263,288,-25
BR1_2731863267,7,False,0,0,0,17762,231,48,7.0,False,6,True,1,1,0,18210,245,64,7.4,True,29.093366666666668,-448,1,-1,279,309,-30
BR1_2731115010,13,True,0,0,0,18440,191,40,6.6,False,12,False,0,0,0,18263,149,64,6.2,True,25.677533333333333,177,1,0,231,213,18
BR1_2731092527,5,True,0,0,0,16379,235,52,7.0,False,4,False,1,0,0,16483,258,71,7.2,True,26.479016666666666,-104,1,-1,287,329,-42
BR1_2731076694,6,False,1,0,0,15927,213,48,6.8,False,7,True,0,0,0,17498,201,72,7.0,True,25.762166666666666,-1571,-1,1,261,273,-12
BR1_2731591186,7,True,0,0,0,16272,211,59,6.4,False,7,False,0,0,0,15546,188,36,6.2,True,25.694316666666666,726,0,0,270,224,46
BR1_2728151702,7,True,0,1,1,19335,238,59,7.0,True,7,False,1,0,0,16555,223,56,6.8,False,25.488,2780,0,-1,297,279,18
BR1_2721992915,10,False,0,0,0,19040,239,56,7.2,True,4,True,0,0,0,15016,186,47,6.2,False,25.3895,4024,6,0,295,233,62
BR1_2721857529,5,False,0,0,0,14605,163,52,6.2,True,8,True,0,0,0,18377,209,52,6.8,False,25.872066666666665,-3772,-3,0,215,261,-46
BR1_2731781278,5,False,1,0,0,18112,267,64,7.6,True,6,True,0,1,0,18717,240,80,7.6,False,29.5488,-605,-1,1,331,320,11
BR1_2731279898,4,False,1,0,0,18275,274,68,7.6,True,6,True,0,0,0,18196,263,64,7.6,False,29.697783333333334,79,-2,1,342,327,15
BR1_2731009191,10,False,0,0,0,18954,201,48,7.0,False,12,True,0,1,0,21299,242,62,7.2,True,28.888416666666668,-2345,-2,0,249,304,-55
BR1_2731622812,14,False,1,0,0,21555,253,60,7.6,True,7,True,0,0,0,17910,230,52,6.8,False,28.4368,3645,7,1,313,282,31
BR1_2731705037,8,False,0,0,0,18132,229,68,7.0,True,10,True,0,1,0,19274,237,39,7.2,False,27.3255,-1142,-2,0,297,276,21
BR1_2731633707,9,False,0,0,0,18865,221,64,7.4,False,9,True,1,1,1,21592,251,64,7.4,True,28.42615,-2727,0,-1,285,315,-30
BR1_2729040107,7,True,0,0,0,18861,256,44,7.4,True,8,False,1,0,0,18567,248,72,7.4,False,29.21135,294,-1,-1,300,320,-20
BR1_2731678303,10,True,0,0,0,18098,189,56,6.6,True,10,False,0,0,0,18270,194,52,6.8,False,27.451733333333333,-172,0,0,245,246,-1
BR1_2718613866,3,False,1,1,0,15967,214,56,6.8,True,8,True,0,0,0,18420,215,56,7.4,False,28.27705,-2453,-5,1,270,271,-1
BR1_2731749078,8,False,0,1,0,18935,203,56,7.4,True,7,True,1,0,0,18212,215,64,7.2,False,29.94921666666667,723,1,-1,259,279,-20
BR1_2730712859,5,False,0,0,0,15516,218,49,6.8,False,11,True,1,1,0,18203,226,58,7.0,True,25.12601666666667,-2687,-6,-1,267,284,-17
BR1_2725954100,6,False,0,1,1,19842,248,52,7.0,False,12,True,1,0,0,20706,272,61,7.4,True,28.184266666666666,-864,-6,-1,300,333,-33
BR1_2731443184,11,True,1,0,0,18155,203,56,7.2,True,2,False,0,0,0,14413,190,52,6.4,False,26.92615,3742,9,1,259,242,17
BR1_2729352109,8,False,0,1,0,17269,215,60,7.0,False,5,True,1,0,0,15431,206,55,6.6,True,27.37485,1838,3,-1,275,261,14
BR1_2728047506,9,False,0,0,0,17951,199,43,6.4,True,5,True,0,1,0,16203,203,56,6.8,False,27.38955,1748,4,0,242,259,-17
BR1_2726041014,4,False,0,0,0,16946,243,52,7.2,True,7,True,1,1,0,18708,235,55,7.4,False,27.943983333333332,-1762,-3,-1,295,290,5
BR1_2724795113,6,True,0,1,0,19107,247,48,7.0,False,7,False,1,0,0,17910,261,52,7.4,True,29.785183333333332,1197,-1,-1,295,313,-18
BR1_2724770521,12,True,0,1,0,21074,224,52,7.0,True,10,False,1,0,0,19940,206,76,7.0,False,28.440816666666667,1134,2,-1,276,282,-6
BR1_2724761749,6,True,0,0,0,16402,215,56,6.6,False,7,False,0,1,0,17165,190,64,7.0,True,25.5673,-763,-1,0,271,254,17
BR1_2717385139,2,False,1,0,0,15302,209,56,6.6,False,8,True,0,1,0,18739,237,56,7.4,True,27.48795,-3437,-6,1,265,293,-28
BR1_2711767278,6,False,0,0,0,15686,182,48,6.6,False,7,True,1,0,0,18018,239,42,7.0,True,26.003116666666667,-2332,-1,-1,230,281,-51
BR1_2731573680,10,False,1,0,0,18956,223,60,7.4,False,5,True,0,0,0,16865,208,60,7.2,True,29.445033333333335,2091,5,1,283,268,15
BR1_2731425757,4,True,1,0,0,16984,239,51,7.2,True,9,False,0,1,0,19670,248,59,7.8,False,28.114083333333333,-2686,-5,1,290,307,-17
BR1_2730714381,7,False,0,0,0,16798,211,57,7.0,False,11,True,0,0,0,19034,226,70,7.4,True,25.127966666666666,-2236,-4,0,268,296,-28
BR1_2729913531,7,True,0,0,0,16224,186,43,6.4,False,13,False,1,0,0,20316,208,61,7.0,True,27.429266666666667,-4092,-6,-1,229,269,-40
BR1_2724424363,7,False,1,1,0,18698,247,84,7.4,True,7,True,0,0,0,17539,231,60,7.4,False,28.389783333333334,1159,0,1,331,291,40
BR1_2731754440,5,True,0,0,0,16697,236,51,7.4,True,11,False,1,0,0,19419,209,72,7.6,False,29.684816666666666,-2722,-6,-1,287,281,6
BR1_2731686574,6,False,0,1,0,16725,210,52,7.2,True,12,True,0,0,0,20937,246,60,7.4,False,29.2281,-4212,-6,0,262,306,-44
BR1_2722804847,5,False,1,0,0,16630,233,76,7.0,False,9,True,0,0,0,19828,238,68,7.2,True,27.6188,-3198,-4,1,309,306,3
BR1_2729713260,5,False,0,0,0,17755,247,68,7.6,True,6,True,0,0,0,18517,238,52,7.4,False,29.365,-762,-1,0,315,290,25
BR1_2729963157,11,False,0,0,0,19646,217,60,7.4,False,8,True,1,0,0,17452,214,40,7.0,True,28.66336666666667,2194,3,-1,277,254,23
BR1_2729750000,10,False,1,0,0,19635,246,52,7.2,True,12,True,0,0,0,20067,241,52,7.4,False,27.749933333333335,-432,-2,1,298,293,5
BR1_2731940251,5,False,0,1,0,15781,229,56,7.2,False,6,True,1,0,0,15862,221,48,6.8,True,25.9946,-81,-1,-1,285,269,16
BR1_2721466954,13,True,0,0,0,20308,200,54,7.2,True,5,False,1,1,0,15671,191,50,6.4,False,27.0829,4637,8,-1,254,241,13
BR1_2727500718,10,False,1,0,0,18572,223,48,7.2,True,7,True,0,1,0,19525,220,68,7.2,False,29.323883333333335,-953,3,1,271,288,-17
BR1_2731655055,11,True,1,0,0,20461,218,60,7.2,False,11,False,0,1,0,21448,262,84,7.8,True,28.985116666666666,-987,0,1,278,346,-68
BR1_2731014643,8,True,0,0,0,16772,191,50,6.4,False,12,False,0,1,0,18951,184,52,7.0,True,26.191983333333333,-2179,-4,0,241,236,5
BR1_2731314523,6,False,0,1,2,17862,192,72,7.2,False,10,True,1,0,1,21541,226,56,7.4,True,29.71215,-3679,-4,-1,264,282,-18
BR1_2731293712,5,True,0,0,0,17101,246,48,7.2,False,9,False,0,1,0,19143,231,64,7.4,True,28.741533333333333,-2042,-4,0,294,295,-1
BR1_2731374203,5,True,0,1,0,17599,240,60,7.0,True,4,False,0,0,0,15333,216,56,7.0,False,26.6371,2266,1,0,300,272,28
BR1_2731350009,6,False,0,1,0,17944,225,60,7.4,False,7,True,1,0,0,19486,245,48,7.2,True,28.076233333333334,-1542,-1,-1,285,293,-8
BR1_2731333279,7,False,0,1,0,18920,277,64,7.6,False,6,True,1,0,0,17863,248,60,7.2,True,28.128783333333335,1057,1,-1,341,308,33
BR1_2720844731,13,False,0,0,0,19147,232,44,7.2,False,14,True,0,1,0,22304,228,76,7.6,True,27.818183333333334,-3157,-1,0,276,304,-28
BR1_2730294961,9,False,1,1,0,17130,167,44,6.8,True,7,True,0,0,0,17222,193,43,6.6,False,25.036983333333332,-92,2,1,211,236,-25
BR1_2729356370,17,False,1,0,0,22137,223,68,7.4,True,9,True,0,1,0,18656,176,44,6.8,False,29.31148333333333,3481,8,1,291,220,71
BR1_2727505360,5,False,0,0,0,17516,243,60,7.2,False,7,True,1,0,0,18852,267,70,7.6,True,28.2187,-1336,-2,-1,303,337,-34
BR1_2730939633,5,True,0,0,0,16773,202,44,6.8,False,9,False,1,0,0,21275,267,68,7.6,True,28.796766666666667,-4502,-4,-1,246,335,-89
BR1_2731748963,8,True,0,0,0,18471,215,70,7.2,True,13,False,0,0,0,19920,220,36,7.2,False,29.203733333333332,-1449,-5,0,285,256,29
BR1_2731701042,14,False,0,1,0,22786,203,48,7.2,False,11,True,1,0,0,19875,207,48,7.2,True,28.91575,2911,3,-1,251,255,-4
BR1_2731667866,8,False,0,0,0,20017,222,56,6.8,True,21,True,0,1,0,21787,132,47,7.2,False,29.0297,-1770,-13,0,278,179,99
BR1_2709051594,5,True,0,0,0,16953,215,46,7.0,False,8,False,0,0,1,21030,222,69,7.6,True,28.59795,-4077,-3,0,261,291,-30
BR1_2731806117,5,False,1,1,0,15607,193,56,7.0,False,9,True,0,0,0,17561,208,44,6.8,True,25.339483333333334,-1954,-4,1,249,252,-3
BR1_2731713528,6,True,0,1,0,17173,177,44,6.8,False,12,False,1,0,0,20581,264,76,7.8,True,27.685383333333334,-3408,-6,-1,221,340,-119
BR1_2731611275,7,True,1,0,0,16560,202,58,7.0,True,4,False,0,0,0,16563,249,50,6.6,False,27.385916666666667,-3,3,1,260,299,-39
BR1_2731229078,5,False,0,1,0,16010,206,64,6.8,True,7,True,1,0,0,16423,168,48,6.4,False,27.125333333333334,-413,-2,-1,270,216,54
BR1_2731927427,4,True,0,0,0,15897,221,50,7.6,False,4,False,1,0,0,16729,231,60,7.4,True,28.134716666666666,-832,0,-1,271,291,-20
BR1_2717248043,16,True,1,1,1,21785,230,48,7.2,True,3,False,0,0,0,15156,198,43,6.6,False,27.201416666666667,6629,13,1,278,241,37
BR1_2731801258,13,True,0,0,0,21270,265,43,7.0,True,5,False,1,1,0,15054,172,44,6.6,False,26.7237,6216,8,-1,308,216,92
BR1_2726978444,9,True,0,0,0,18241,203,60,7.0,True,5,False,0,0,0,15346,189,48,6.8,False,26.585616666666667,2895,4,0,263,237,26
BR1_2731541747,7,False,1,0,0,18649,268,68,7.4,True,9,True,0,1,0,19397,256,64,7.4,False,28.639966666666666,-748,-2,1,336,320,16
BR1_2730753546,2,False,0,0,0,15389,220,56,6.6,False,4,True,1,0,0,15936,207,56,7.0,True,27.395266666666668,-547,-2,-1,276,263,13
BR1_2731665762,8,False,0,0,0,16830,218,32,6.4,False,9,True,1,1,0,17434,187,68,7.0,True,25.767466666666667,-604,-1,-1,250,255,-5
BR1_2730636013,2,True,0,0,0,16191,238,52,7.0,False,3,False,0,0,0,16383,257,64,7.4,True,28.33135,-192,-1,0,290,321,-31
BR1_2729974621,11,True,1,1,0,19796,230,60,7.2,True,2,False,0,0,0,13709,181,48,6.4,False,26.070266666666665,6087,9,1,290,229,61
BR1_2730633308,10,False,0,0,0,19466,228,57,7.0,False,15,True,1,0,0,21440,202,68,7.4,True,28.9343,-1974,-5,-1,285,270,15
BR1_2731532194,6,False,0,0,0,16586,212,60,6.8,False,12,True,1,0,0,18548,227,40,6.8,True,25.713983333333335,-1962,-6,-1,272,267,5
BR1_2731321153,7,True,0,0,0,17506,215,48,6.8,False,13,False,1,0,0,21575,289,63,8.0,True,27.516616666666668,-4069,-6,-1,263,352,-89
BR1_2731160738,12,False,0,1,0,18824,207,40,6.8,True,6,True,1,0,0,15216,195,44,6.6,False,25.58455,3608,6,-1,247,239,8
BR1_2725473646,3,False,0,1,0,16894,230,60,7.2,False,9,True,1,0,0,19362,256,56,7.6,True,27.825316666666666,-2468,-6,-1,290,312,-22
BR1_2725084243,10,False,0,1,0,18533,212,48,6.6,True,8,True,1,0,0,17252,165,56,6.4,False,25.05855,1281,2,-1,260,221,39
BR1_2725000354,7,False,1,0,0,17383,229,56,6.8,True,5,True,0,1,0,16835,199,52,6.6,False,25.3084,548,2,1,285,251,34
BR1_2730373952,3,False,0,1,0,16916,248,64,7.0,False,9,True,1,0,0,19124,247,60,7.4,True,28.5268,-2208,-6,-1,312,307,5
BR1_2730346573,7,True,1,0,0,16919,221,44,6.8,True,3,False,0,1,0,14889,221,44,6.8,False,27.47975,2030,4,1,265,265,0
BR1_2719401550,7,True,0,1,0,19366,241,84,7.8,True,5,False,0,0,0,17302,251,49,7.6,False,28.673283333333334,2064,2,0,325,300,25
BR1_2731929231,12,True,1,0,0,19668,225,49,7.0,False,7,False,0,0,0,16432,176,54,6.8,True,26.474883333333334,3236,5,1,274,230,44
BR1_2731690731,7,False,0,0,0,18212,251,52,7.4,False,11,True,1,1,0,21928,264,67,7.8,True,28.760616666666667,-3716,-4,-1,303,331,-28
BR1_2731655078,9,False,1,0,0,17910,215,55,6.8,True,8,True,0,0,0,17152,227,48,6.8,False,25.5367,758,1,1,270,275,-5
BR1_2730119024,3,False,0,1,0,14624,191,60,6.8,False,7,True,1,0,0,16946,238,56,6.8,True,25.012283333333333,-2322,-4,-1,251,294,-43
BR1_2731926946,9,True,0,1,0,18411,222,51,7.2,True,6,False,0,0,0,16415,214,45,7.0,False,25.275616666666668,1996,3,0,273,259,14
BR1_2731211733,4,True,0,0,0,15675,238,44,7.0,True,1,False,1,0,0,14424,233,64,7.0,False,26.0557,1251,3,-1,282,297,-15
BR1_2731782039,9,False,1,0,0,16032,155,52,6.4,True,4,True,0,1,0,15936,208,42,6.6,False,25.710233333333335,96,5,1,207,250,-43
BR1_2731660427,13,True,0,0,0,19128,208,45,6.6,True,5,False,0,0,0,15483,208,54,6.6,False,26.98485,3645,8,0,253,262,-9
BR1_2728556151,8,True,1,1,0,18292,223,48,6.8,True,9,False,0,0,0,16885,174,52,6.8,False,25.514633333333332,1407,-1,1,271,226,45
BR1_2715014318,8,True,0,0,0,17069,226,56,7.0,True,4,False,0,0,0,16463,226,56,7.0,False,27.103983333333332,606,4,0,282,282,0
BR1_2731821726,9,True,0,1,0,17594,222,40,6.8,False,4,False,0,0,0,15245,214,52,7.0,True,26.71,2349,5,0,262,266,-4
BR1_2731155145,14,True,0,1,0,21577,219,51,7.4,False,13,False,1,0,0,21476,245,64,7.6,True,28.955916666666667,101,1,-1,270,309,-39
BR1_2731115174,9,True,0,0,0,19048,226,28,7.0,True,9,False,0,1,0,19025,224,50,7.0,False,29.983416666666667,23,0,0,254,274,-20
BR1_2730273831,7,False,1,1,0,19211,286,56,7.8,True,9,True,0,0,0,19223,282,55,7.4,False,27.808633333333333,-12,-2,1,342,337,5
BR1_2731221159,8,False,0,1,0,19911,235,68,7.6,True,5,True,1,0,0,16417,209,46,6.8,False,29.32208333333333,3494,3,-1,303,255,48
BR1_2724816579,8,True,0,0,0,17471,227,52,6.8,True,3,False,0,0,0,14731,195,68,6.4,False,27.494416666666666,2740,5,0,279,263,16
BR1_2728000166,8,False,1,0,0,16463,198,67,6.6,False,7,True,0,1,0,16660,222,43,6.8,True,25.147683333333333,-197,1,1,265,265,0
BR1_2722247645,15,True,0,0,0,22523,235,56,7.8,True,9,False,0,0,0,18885,219,76,7.0,False,29.664016666666665,3638,6,0,291,295,-4
BR1_2722229310,7,True,0,0,0,16737,204,50,6.8,False,7,False,1,1,0,16995,227,51,6.8,True,26.165366666666667,-258,0,-1,254,278,-24
BR1_2731947792,6,True,0,0,0,16221,202,50,6.4,False,11,False,0,1,0,19081,229,49,7.0,True,27.296483333333335,-2860,-5,0,252,278,-26
BR1_2730976633,8,True,0,0,0,18216,218,64,6.6,True,8,False,1,0,0,17077,194,52,6.6,False,27.274766666666668,1139,0,-1,282,246,36
BR1_2731669251,6,False,0,1,0,18258,229,68,7.4,False,13,True,1,0,0,21432,274,71,7.6,True,29.0773,-3174,-7,-1,297,345,-48
BR1_2731791988,11,True,0,0,0,19420,198,36,6.8,False,16,False,0,0,0,22225,278,4,7.2,True,29.1604,-2805,-5,0,234,282,-48
BR1_2731844974,7,True,0,0,0,16296,186,40,6.4,False,8,False,1,1,1,18831,198,52,6.6,True,27.05125,-2535,-1,-1,226,250,-24
BR1_2731836793,5,False,1,0,0,17997,255,55,7.0,True,5,True,0,1,0,16907,227,56,7.2,False,28.738316666666666,1090,0,1,310,283,27
BR1_2731815952,7,False,1,0,0,16047,205,44,6.4,False,8,True,0,0,0,17970,216,60,7.4,True,26.03645,-1923,-1,1,249,276,-27
BR1_2731311752,12,False,0,0,0,18604,196,43,6.8,True,8,True,0,1,0,18839,197,48,6.8,False,27.187716666666667,-235,4,0,239,245,-6
BR1_2704545902,7,True,0,1,0,18205,223,60,7.4,True,10,False,1,0,0,17928,226,60,7.4,False,29.36255,277,-3,-1,283,286,-3
BR1_2731579944,10,True,0,0,0,19032,248,68,7.2,False,2,False,1,1,0,15029,211,71,7.0,True,25.54095,4003,8,-1,316,282,34
BR1_2730197654,4,False,1,0,0,16668,223,68,7.0,False,6,True,0,0,0,16286,229,68,7.0,True,26.489583333333332,382,-2,1,291,297,-6
BR1_2731368339,7,False,1,0,0,16670,226,52,6.8,True,5,True,0,0,0,15760,207,50,6.8,False,26.170416666666668,910,2,1,278,257,21
BR1_2731856864,9,False,1,0,0,18774,227,65,7.6,False,8,True,0,1,0,19060,227,69,7.4,True,29.49395,-286,1,1,292,296,-4
BR1_2731728958,5,False,0,1,0,17515,264,48,7.2,True,2,True,0,0,0,16635,264,68,7.6,False,27.634,880,3,0,312,332,-20
BR1_2719361629,5,True,0,0,0,16666,208,54,6.8,True,2,False,1,0,0,14360,205,56,6.8,False,25.201116666666667,2306,3,-1,262,261,1
BR1_2719326047,7,True,0,0,0,15966,209,52,6.8,True,6,False,1,0,0,15700,175,48,6.6,False,25.853266666666666,266,1,-1,261,223,38
BR1_2731788508,7,False,1,1,0,18142,225,60,7.0,True,9,True,0,0,0,20951,248,64,7.4,False,29.22115,-2809,-2,1,285,312,-27
BR1_2730758792,8,False,0,0,0,16124,203,48,6.6,False,8,True,0,1,0,17530,205,72,7.2,True,26.940316666666668,-1406,0,0,251,277,-26
BR1_2730075561,12,True,1,0,0,18308,181,48,6.8,True,8,False,0,0,0,16693,187,36,6.6,False,26.190683333333332,1615,4,1,229,223,6
BR1_2730345718,8,False,0,1,0,18878,219,52,7.6,True,11,True,1,0,0,19629,212,56,7.4,False,28.53795,-751,-3,-1,271,268,3
BR1_2730332115,9,False,0,1,0,17878,213,60,7.0,False,5,True,1,0,0,16255,237,68,7.2,True,26.412333333333333,1623,4,-1,273,305,-32
BR1_2730782041,5,False,1,0,0,17129,207,60,7.4,False,10,True,0,1,0,19344,225,55,7.4,True,28.14435,-2215,-5,1,267,280,-13
BR1_2731614427,11,False,1,0,0,20611,248,52,7.4,True,6,True,0,0,0,18222,267,40,7.2,False,29.230233333333334,2389,5,1,300,307,-7
BR1_2731559713,6,True,0,0,0,16756,229,52,7.2,False,10,False,1,0,0,19708,242,59,7.4,True,28.88635,-2952,-4,-1,281,301,-20
BR1_2731058115,9,True,1,0,0,19532,250,56,7.2,False,7,False,0,1,0,19008,247,55,7.4,True,29.094466666666666,524,2,1,306,302,4
BR1_2729697618,10,True,0,0,0,19326,216,49,7.2,True,9,False,0,1,0,19829,239,64,7.4,False,28.991983333333334,-503,1,0,265,303,-38
BR1_2731950342,7,True,0,0,0,18437,245,61,7.2,True,8,False,0,0,0,18780,245,55,7.0,False,28.562966666666668,-343,-1,0,306,300,6
BR1_2727051562,8,False,0,1,0,20212,256,63,7.4,True,8,True,1,0,0,18117,249,52,7.0,False,28.823183333333333,2095,0,-1,319,301,18
BR1_2716299256,8,False,0,1,0,18941,229,53,7.0,True,7,True,1,0,0,16246,194,58,6.6,False,25.389466666666667,2695,1,-1,282,252,30
BR1_2715985419,12,True,1,1,0,19403,246,56,7.2,True,3,False,0,0,0,15753,222,58,6.8,False,25.018366666666665,3650,9,1,302,280,22
BR1_2731784472,4,False,0,1,0,16526,218,72,7.0,False,2,True,1,0,0,17023,268,56,7.4,True,29.593183333333332,-497,2,-1,290,324,-34
BR1_2718802568,8,False,0,0,0,17422,230,44,6.8,False,8,True,1,1,0,18311,198,72,7.2,True,25.124683333333333,-889,0,-1,274,270,4
BR1_2714911961,7,False,0,1,0,19864,275,72,7.4,True,9,True,0,0,0,19309,243,52,7.4,False,28.941633333333332,555,-2,0,347,295,52
BR1_2731190984,11,True,0,0,0,17770,197,52,6.8,False,6,False,0,0,0,16479,215,40,6.4,True,27.1365,1291,5,0,249,255,-6
BR1_2730270713,6,True,1,1,0,16020,187,59,6.8,True,4,False,0,0,0,14675,197,64,6.8,False,25.56785,1345,2,1,246,261,-15
BR1_2730515863,6,True,1,0,0,15819,211,52,6.6,True,4,False,0,0,0,14261,184,40,6.8,False,25.56645,1558,2,1,263,224,39
BR1_2729245115,5,True,0,0,0,15155,208,40,7.0,False,4,False,0,0,0,16260,229,48,6.8,True,25.324716666666667,-1105,1,0,248,277,-29
BR1_2727976373,8,True,0,0,0,18404,212,53,7.0,False,7,False,1,1,1,19019,223,68,7.6,True,29.710533333333334,-615,1,-1,265,291,-26
BR1_2727953375,8,False,1,0,0,15040,167,52,6.6,True,9,True,0,0,0,17692,218,48,6.8,False,25.598333333333333,-2652,-1,1,219,266,-47
BR1_2727688990,7,True,1,1,0,17884,203,56,7.0,True,4,False,0,0,0,14919,197,50,7.0,False,27.369916666666665,2965,3,1,259,247,12
BR1_2729758518,8,True,1,0,0,16883,185,48,6.4,False,6,False,0,0,0,15970,188,44,6.2,True,26.53535,913,2,1,233,232,1
BR1_2728943526,8,True,1,0,0,18037,226,48,7.0,False,13,False,1,1,0,21571,253,64,7.8,True,29.1863,-3534,-5,0,274,317,-43
BR1_2731609481,6,False,0,0,0,18631,279,68,7.4,False,9,True,1,0,0,19168,220,60,7.4,True,28.20135,-537,-3,-1,347,280,67
BR1_2731551723,9,True,0,1,1,21233,248,68,8.0,True,5,False,1,0,0,16190,220,52,7.2,False,28.599533333333333,5043,4,-1,316,272,44
BR1_2714840987,6,False,0,1,0,16222,190,59,6.6,True,6,True,0,0,0,17127,222,56,6.8,False,25.351733333333332,-905,0,0,249,278,-29
BR1_2731036407,9,True,1,0,0,17332,197,52,7.0,False,3,False,0,1,0,15273,200,59,7.0,True,26.48275,2059,6,1,249,259,-10
BR1_2730282620,6,True,1,0,0,16540,238,57,6.6,True,3,False,0,0,0,14807,217,53,6.6,False,25.137383333333332,1733,3,1,295,270,25
BR1_2730255603,4,False,0,1,0,17263,223,64,7.2,False,10,True,0,0,0,20111,262,67,7.6,True,28.577966666666665,-2848,-6,0,287,329,-42
BR1_2730499577,8,True,0,1,0,16523,201,28,6.4,False,7,False,1,0,0,16324,185,60,6.6,True,26.7858,199,1,-1,229,245,-16
BR1_2730453210,6,True,1,1,0,18191,248,52,7.2,False,12,False,0,0,0,20749,283,48,7.8,True,28.474466666666668,-2558,-6,1,300,331,-31
BR1_2731504098,10,False,1,0,0,19810,232,52,7.6,True,7,True,0,1,0,18370,214,56,7.6,False,28.1907,1440,3,1,284,270,14
BR1_2731457570,9,False,1,0,0,17742,210,48,6.4,True,8,True,0,0,0,17746,186,45,6.4,False,25.77205,-4,1,1,258,231,27
BR1_2731323449,7,True,0,0,0,15621,144,48,6.6,False,3,False,1,0,0,14808,209,64,6.6,True,25.241266666666668,813,4,-1,192,273,-81
BR1_2731631300,9,False,0,0,0,19242,235,56,7.4,True,7,True,0,0,0,16924,200,49,6.4,False,26.04008333333333,2318,2,0,291,249,42
BR1_2731586773,4,True,0,0,0,15312,206,44,6.6,False,5,False,1,0,0,15808,226,60,6.6,True,26.111933333333333,-496,-1,-1,250,286,-36
BR1_2720381334,2,False,1,0,0,16488,263,64,7.4,False,5,True,0,0,0,18418,270,51,7.6,True,29.52028333333333,-1930,-3,1,327,321,6
BR1_2719026239,11,True,0,1,0,18665,202,52,6.8,True,7,False,1,0,0,16706,192,55,6.8,False,27.063416666666665,1959,4,-1,254,247,7
BR1_2716631297,12,True,0,0,0,20004,259,56,7.8,True,6,False,1,1,0,17873,241,68,7.4,False,29.2163,2131,6,-1,315,309,6
BR1_2715366221,6,False,0,0,0,16242,164,50,6.4,False,10,True,1,0,0,18135,197,55,7.0,True,25.424916666666668,-1893,-4,-1,214,252,-38
BR1_2731303333,12,False,0,0,0,18478,222,52,7.0,True,8,True,0,0,0,17089,188,48,7.0,False,26.712666666666667,1389,4,0,274,236,38
BR1_2731280677,10,False,0,0,0,18153,181,64,7.2,False,4,True,1,0,0,15186,184,48,6.6,True,26.156883333333333,2967,6,-1,245,232,13
BR1_2729772956,5,True,0,0,0,15720,225,48,7.0,True,4,False,1,0,0,14435,205,48,7.0,False,26.563716666666668,1285,1,-1,273,253,20
BR1_2730916701,9,True,0,1,0,19227,223,60,7.4,True,13,False,1,0,0,20239,208,42,7.2,False,27.604783333333334,-1012,-4,-1,283,250,33
BR1_2731765433,14,False,0,1,0,22855,251,68,7.4,True,15,True,0,0,0,21245,193,44,7.4,False,27.6079,1610,-1,0,319,237,82
BR1_2731731494,8,True,0,0,0,17287,219,44,6.8,False,9,False,0,1,0,15833,157,38,6.6,True,25.706083333333332,1454,-1,0,263,195,68
BR1_2731706219,11,True,0,0,0,17493,199,48,7.0,True,9,False,0,0,0,17508,221,52,6.4,False,26.531716666666668,-15,2,0,247,273,-26
BR1_2731370042,7,False,0,0,0,15413,162,36,6.4,False,11,True,0,0,0,19723,225,47,6.8,True,26.847366666666666,-4310,-4,0,198,272,-74
BR1_2731792363,9,True,1,1,0,19022,228,76,7.0,True,4,False,0,0,0,15124,215,44,6.8,False,26.1365,3898,5,1,304,259,45
BR1_2716335436,4,True,0,0,0,16143,228,50,7.0,False,6,False,1,1,0,20028,296,72,7.6,True,29.882983333333332,-3885,-2,-1,278,368,-90
BR1_2715191493,6,True,1,1,0,17258,219,56,6.4,True,4,False,0,0,0,14685,200,51,6.4,False,26.995233333333335,2573,2,1,275,251,24
BR1_2715179351,11,True,1,0,0,18299,207,50,7.0,True,3,False,0,0,0,14587,193,56,6.8,False,27.311683333333335,3712,8,1,257,249,8
BR1_2728880311,8,True,0,1,0,17666,240,48,6.8,False,6,False,1,0,0,15987,231,60,6.8,True,25.788716666666666,1679,2,-1,288,291,-3
BR1_2718075891,8,True,0,1,0,19671,257,74,7.6,True,3,False,0,0,0,15415,197,58,7.0,False,28.069416666666665,4256,5,0,331,255,76
BR1_2716738660,12,False,0,1,0,21847,240,64,7.8,True,9,True,0,0,0,18383,223,52,7.0,False,28.679866666666666,3464,3,0,304,275,29
BR1_2730485576,9,False,0,0,0,18398,217,52,7.0,True,7,True,0,1,0,18042,185,64,6.8,False,26.502433333333332,356,2,0,269,249,20
BR1_2731308428,5,False,0,1,0,17735,213,44,7.2,True,10,True,0,0,0,19525,232,64,7.4,False,29.39595,-1790,-5,0,257,296,-39
BR1_2731284943,9,True,1,1,0,15942,141,44,6.4,False,14,False,0,0,0,19506,212,44,7.0,True,25.1925,-3564,-5,1,185,256,-71
BR1_2730728235,8,False,0,0,0,18500,208,56,7.0,False,11,True,1,1,0,20247,227,60,7.4,True,29.640033333333335,-1747,-3,-1,264,287,-23
BR1_2730694916,5,True,1,0,0,17438,267,64,7.4,True,7,False,0,0,0,17861,220,43,7.2,False,28.425916666666666,-423,-2,1,331,263,68
BR1_2730381803,7,True,1,0,0,17918,212,64,7.0,True,8,False,0,0,0,19762,263,44,7.2,False,28.484166666666667,-1844,-1,1,276,307,-31
BR1_2730180948,6,False,0,0,0,18139,250,50,7.2,True,2,True,0,0,0,15741,225,60,7.2,False,27.643766666666668,2398,4,0,300,285,15
BR1_2728524251,8,False,1,0,0,19675,252,76,7.4,True,6,True,0,0,0,17503,242,60,7.2,False,29.460216666666668,2172,2,1,328,302,26
BR1_2726827977,4,True,0,0,0,15414,230,46,6.8,False,5,False,0,1,0,16064,232,56,7.0,True,25.607116666666666,-650,-1,0,276,288,-12
BR1_2730229352,7,True,1,0,0,17383,208,44,6.8,True,9,False,0,0,0,18011,212,56,7.2,False,26.96141666666667,-628,-2,1,252,268,-16
BR1_2721184528,7,True,1,0,0,16048,195,56,6.8,True,9,False,0,0,0,18475,237,54,7.4,False,26.4213,-2427,-2,1,251,291,-40
BR1_2721101063,10,True,0,0,0,17633,205,50,7.0,True,4,False,0,0,0,14845,175,50,6.6,False,26.02413333333333,2788,6,0,255,225,30
BR1_2731479166,6,True,0,1,0,18002,214,72,7.6,True,7,False,1,0,0,19294,249,77,8.0,False,29.026716666666665,-1292,-1,-1,286,326,-40
BR1_2731351226,11,False,0,0,0,19064,193,63,7.0,False,6,True,1,1,0,18467,233,40,6.8,True,28.8254,597,5,-1,256,273,-17
BR1_2731836777,6,True,1,1,0,18306,209,64,7.4,True,3,False,0,0,0,17303,260,41,7.0,False,28.663,1003,3,1,273,301,-28
BR1_2731304730,12,False,1,0,0,20350,215,54,7.6,False,9,True,0,0,0,20170,249,54,7.2,True,29.475233333333332,180,3,1,269,303,-34
BR1_2728538934,9,False,1,0,0,17714,219,43,6.8,True,6,True,0,0,0,16763,207,52,6.6,False,26.6404,951,3,1,262,259,3
BR1_2720565646,14,True,0,0,0,20080,221,37,7.0,True,8,False,0,0,0,18397,235,55,7.2,False,25.808016666666667,1683,6,0,258,290,-32
BR1_2730107149,8,True,0,0,0,18761,227,56,7.2,False,8,False,1,0,0,19830,259,76,7.6,True,27.901616666666666,-1069,0,-1,283,335,-52
BR1_2731146967,8,False,1,1,0,19624,228,72,7.4,True,7,True,0,0,0,17278,215,52,7.6,False,27.99485,2346,1,1,300,267,33
BR1_2731635271,9,False,0,0,0,20313,251,52,7.6,True,7,True,0,1,0,18035,227,56,7.2,False,28.541683333333335,2278,2,0,303,283,20
BR1_2731180029,10,False,0,0,0,18625,237,60,7.0,False,5,True,1,0,0,16865,232,64,7.0,True,26.24495,1760,5,-1,297,296,1
BR1_2731122574,11,False,1,0,0,20743,294,76,8.0,True,5,True,0,1,0,17139,207,80,7.4,False,29.232266666666668,3604,6,1,370,287,83
BR1_2731932394,8,False,0,0,0,18018,232,56,7.2,True,5,True,0,0,0,15747,216,36,6.4,False,26.65673333333333,2271,3,0,288,252,36
BR1_2730555362,8,False,0,0,0,17386,189,59,6.8,False,4,True,1,0,0,16376,233,68,7.0,True,25.1651,1010,4,-1,248,301,-53
BR1_2730529255,3,True,0,0,0,15318,210,48,6.8,False,10,False,0,0,0,18379,220,64,7.2,True,25.087733333333333,-3061,-7,0,258,284,-26
BR1_2731788077,6,True,0,0,0,17002,203,54,6.8,False,3,False,1,0,0,15269,233,49,6.8,True,25.691366666666667,1733,3,-1,257,282,-25
BR1_2731747050,5,False,1,0,0,16788,249,64,7.2,True,4,True,0,0,0,15977,229,48,6.8,False,26.376216666666668,811,1,1,313,277,36
BR1_2730749866,10,True,1,1,0,19119,176,52,6.6,True,11,False,0,0,0,17379,157,52,6.4,False,25.792516666666668,1740,-1,1,228,209,19
BR1_2730050525,9,False,0,1,0,17845,212,56,7.2,False,8,True,1,0,0,18255,209,40,7.2,True,27.5733,-410,1,-1,268,249,19
BR1_2729792131,14,True,0,0,0,20888,185,71,7.4,True,6,False,1,1,0,17532,204,33,7.0,False,28.1868,3356,8,-1,256,237,19
BR1_2731774384,8,False,0,0,0,17829,184,48,6.6,False,10,True,1,1,0,18165,225,64,7.2,True,27.3354,-336,-2,-1,232,289,-57
BR1_2724850332,7,False,0,0,0,15570,191,44,6.6,False,12,True,1,1,0,20008,255,66,7.0,True,25.6527,-4438,-5,-1,235,321,-86
BR1_2724833415,14,True,0,1,0,20294,188,54,6.8,True,10,False,1,0,0,16978,180,51,6.6,False,26.835233333333335,3316,4,-1,242,231,11
BR1_2724806959,12,True,1,1,0,19988,220,72,7.2,True,6,False,0,0,0,16836,230,40,6.8,False,27.321433333333335,3152,6,1,292,270,22
BR1_2731824686,5,False,1,1,0,15943,202,52,6.4,True,6,True,0,0,0,16109,222,56,6.4,False,26.76515,-166,-1,1,254,278,-24
BR1_2719530739,7,False,0,1,0,18411,235,64,7.2,False,11,True,1,0,0,18790,200,47,7.2,True,29.678116666666668,-379,-4,-1,299,247,52
BR1_2731480263,9,False,0,0,0,19073,231,49,7.2,False,14,True,1,1,0,21114,262,52,7.6,True,29.343083333333333,-2041,-5,-1,280,314,-34
BR1_2731448384,7,True,1,1,0,18924,256,60,7.4,True,7,False,0,0,0,17611,218,52,7.2,False,27.69055,1313,0,1,316,270,46
BR1_2730789627,7,False,1,0,0,18602,274,63,7.2,False,8,True,0,0,0,18275,249,52,7.4,True,27.589716666666668,327,-1,1,337,301,36
BR1_2730646692,12,False,0,0,0,21380,235,55,7.4,True,12,True,1,1,1,21888,247,62,7.6,False,28.510633333333335,-508,0,-1,290,309,-19
BR1_2731688968,7,False,0,1,0,19197,253,52,7.6,True,8,True,1,0,0,18423,200,60,7.4,False,29.57743333333333,774,-1,-1,305,260,45
BR1_2731063679,6,True,0,0,0,17318,215,44,6.8,False,10,False,1,1,0,18679,191,48,6.8,True,26.749083333333335,-1361,-4,-1,259,239,20
BR1_2723492644,9,False,1,0,0,20305,255,60,7.4,False,7,True,0,0,0,17928,241,68,7.6,True,29.15875,2377,2,1,315,309,6
BR1_2731082487,3,True,1,0,0,14891,216,48,6.6,False,7,False,0,0,0,17005,230,56,7.2,True,25.9435,-2114,-4,1,264,286,-22
BR1_2731719420,9,False,0,0,0,17576,214,56,7.0,False,8,True,0,1,0,17614,220,52,7.0,True,27.406833333333335,-38,1,0,270,272,-2
BR1_2716674920,12,True,1,1,0,19766,236,60,7.8,True,8,False,0,0,0,19699,251,60,7.4,False,29.264483333333335,67,4,1,296,311,-15
BR1_2731239662,8,True,1,0,0,16733,210,43,6.8,True,3,False,0,0,0,15682,237,64,6.8,False,27.2631,1051,5,1,253,301,-48
BR1_2730625025,9,True,1,0,0,19235,238,64,7.4,False,6,False,0,0,0,18897,265,73,7.6,True,27.56051666666667,338,3,1,302,338,-36
BR1_2731783987,7,True,1,0,0,16441,211,52,7.0,True,6,False,0,0,0,15940,197,44,6.6,False,26.666266666666665,501,1,1,263,241,22
BR1_2731930623,7,True,0,0,0,18185,253,52,7.4,False,6,False,1,0,0,17023,197,56,7.2,True,28.011883333333333,1162,1,-1,305,253,52
BR1_2724074038,9,False,1,0,0,20131,257,54,7.2,False,5,True,0,0,0,15998,201,44,6.8,True,29.827516666666668,4133,4,1,311,245,66
BR1_2721724060,3,False,0,1,0,15659,215,52,7.0,False,9,True,1,0,0,19369,249,72,7.8,True,29.003066666666665,-3710,-6,-1,267,321,-54
BR1_2731831713,2,True,0,0,0,14647,228,43,6.8,False,1,False,0,0,0,14474,230,52,6.8,True,25.722716666666667,173,1,0,271,282,-11
BR1_2731754368,13,True,0,0,0,21176,203,48,7.4,True,14,False,0,1,0,21718,223,56,7.6,False,29.311366666666668,-542,-1,0,251,279,-28
BR1_2731723767,8,False,1,0,0,18721,210,66,7.6,True,8,True,0,0,0,19128,212,53,7.2,False,27.66795,-407,0,1,276,265,11
BR1_2729863472,6,False,1,1,0,17120,230,64,7.2,True,1,True,0,0,0,14267,206,48,6.4,False,26.450216666666666,2853,5,1,294,254,40
BR1_2729471140,3,False,1,0,0,16682,213,72,7.4,False,9,True,0,0,0,20029,247,71,7.6,True,28.87655,-3347,-6,1,285,318,-33
BR1_2726239164,10,False,0,0,0,21363,276,64,7.8,True,5,True,1,1,1,19392,233,72,7.6,False,29.026316666666666,1971,5,-1,340,305,35
BR1_2731703082,9,True,1,0,0,19564,243,42,7.4,False,7,False,0,0,0,18534,245,61,7.2,True,29.50325,1030,2,1,285,306,-21
BR1_2731562641,4,True,1,1,1,20448,290,68,7.6,False,0,False,0,0,0,15861,277,76,7.6,True,28.49275,4587,4,1,358,353,5
BR1_2729068338,12,True,1,0,0,20683,267,60,7.2,True,4,False,0,1,0,16756,191,60,7.0,False,27.54525,3927,8,1,327,251,76
BR1_2724384376,12,True,1,0,0,19915,205,52,7.2,True,9,False,0,0,0,19104,244,48,7.6,False,29.550366666666665,811,3,1,257,292,-35
BR1_2731695956,3,False,0,0,0,15574,241,64,7.0,False,3,True,0,1,0,15982,225,68,7.0,True,25.297333333333334,-408,0,0,305,293,12
BR1_2729482458,4,False,0,0,0,18232,284,70,7.4,True,8,True,0,0,0,19900,257,62,7.2,False,28.10365,-1668,-4,0,354,319,35
BR1_2728457105,6,False,1,0,0,16214,176,50,6.4,True,10,True,0,0,0,17997,188,60,6.8,False,27.429233333333332,-1783,-4,1,226,248,-22
BR1_2731265090,9,False,0,0,1,18872,200,48,7.0,True,18,True,1,1,0,24661,230,54,7.4,False,29.761366666666667,-5789,-9,-1,248,284,-36
BR1_2729276395,8,False,0,0,0,16062,186,48,6.6,False,14,True,0,0,0,20907,211,44,7.0,True,27.453433333333333,-4845,-6,0,234,255,-21
BR1_2728520325,8,True,0,0,0,19616,235,59,7.0,True,8,False,1,1,0,18739,215,60,6.8,False,29.104933333333335,877,0,-1,294,275,19
BR1_2728480888,9,True,1,1,0,21256,270,87,7.8,True,5,False,0,0,0,17529,222,64,7.2,False,28.1669,3727,4,1,357,286,71
BR1_2728458393,6,False,1,1,0,19346,235,84,7.6,True,6,True,0,0,0,18555,242,56,7.0,False,29.241483333333335,791,0,1,319,298,21
BR1_2728405963,6,False,1,0,0,18844,270,52,7.6,True,8,True,0,0,0,17940,216,63,7.4,False,28.259333333333334,904,-2,1,322,279,43
BR1_2730534515,8,True,1,1,0,16122,239,44,7.2,True,1,False,0,0,0,14813,234,72,7.2,False,26.575616666666665,1309,7,1,283,306,-23
BR1_2730143638,6,False,0,0,0,17036,211,48,7.2,False,14,True,0,0,0,21774,250,72,7.6,True,27.695616666666666,-4738,-8,0,259,322,-63
BR1_2729206049,13,False,1,1,0,22294,273,76,7.8,True,4,True,0,0,0,16443,222,56,7.0,False,27.668283333333335,5851,9,1,349,278,71
BR1_2729199385,10,True,0,0,0,18466,230,48,6.8,False,11,False,1,0,0,18381,174,72,6.8,True,26.9627,85,-1,-1,278,246,32
BR1_2730366990,7,False,0,0,0,17471,209,64,7.2,False,13,True,0,0,1,23388,259,52,7.8,True,28.11155,-5917,-6,0,273,311,-38
BR1_2730093752,10,True,0,1,0,19065,212,56,7.2,False,4,False,1,0,0,15674,202,56,7.0,True,29.906716666666668,3391,6,-1,268,258,10
BR1_2728893281,8,True,1,0,0,19352,254,55,7.2,True,13,False,0,0,0,21284,243,54,7.6,False,29.555033333333334,-1932,-5,1,309,297,12
BR1_2725165794,6,False,0,0,0,13945,145,44,6.6,False,12,True,0,0,0,17748,168,64,6.8,True,25.820933333333333,-3803,-6,0,189,232,-43
BR1_2724955535,6,False,1,0,0,18955,262,74,7.2,True,14,True,0,1,0,20270,212,44,7.2,False,29.61541666666667,-1315,-8,1,336,256,80
BR1_2724938368,7,False,1,0,0,15014,154,42,6.0,False,12,True,0,0,0,18928,192,40,6.6,True,26.59255,-3914,-5,1,196,232,-36
BR1_2724731573,11,False,1,1,0,20020,217,68,7.2,True,5,True,0,0,0,15421,199,44,6.6,False,25.48005,4599,6,1,285,243,42
BR1_2731836312,4,True,0,0,0,16621,243,60,7.4,False,6,False,0,0,0,18043,244,64,7.6,True,27.688916666666668,-1422,-2,0,303,308,-5
BR1_2730835566,1,False,0,1,0,13757,204,48,6.8,False,5,True,1,0,0,16323,234,60,7.0,True,27.058483333333335,-2566,-4,-1,252,294,-42
BR1_2731521627,3,False,0,1,0,15521,217,72,7.0,True,6,True,1,0,0,17326,231,68,7.0,False,27.0691,-1805,-3,-1,289,299,-10
BR1_2731508454,11,False,0,0,0,19091,256,46,7.6,False,8,True,1,1,0,19883,210,61,7.0,True,29.009416666666667,-792,3,-1,302,271,31
BR1_2730978181,2,True,1,0,0,14561,192,60,6.4,False,5,False,0,1,0,15511,174,63,6.6,True,25.741833333333332,-950,-3,1,252,237,15
BR1_2730808621,12,True,0,0,0,20927,259,62,7.4,False,11,False,1,1,0,21939,249,80,7.6,True,29.102766666666668,-1012,1,-1,321,329,-8
BR1_2729288735,5,False,0,0,0,17167,280,52,7.2,True,1,True,1,0,0,14114,232,56,7.0,False,25.678066666666666,3053,4,-1,332,288,44
BR1_2731567352,12,False,0,0,0,20000,246,52,7.6,True,7,True,1,0,0,18311,216,64,7.2,False,29.61093333333333,1689,5,-1,298,280,18
BR1_2730420190,6,False,0,1,0,17608,223,68,7.4,True,11,True,1,0,0,19242,236,68,7.4,False,28.208066666666667,-1634,-5,-1,291,304,-13
BR1_2731934974,4,True,0,1,0,17914,249,68,7.4,False,5,False,1,0,1,18793,229,56,7.4,True,27.674083333333332,-879,-1,-1,317,285,32
BR1_2730675577,10,True,1,0,1,21183,266,60,7.6,True,2,False,0,1,0,15887,223,68,7.0,False,28.086266666666667,5296,8,1,326,291,35
BR1_2731082183,9,False,1,0,0,17364,221,51,7.2,False,5,True,0,1,0,16718,247,48,6.8,True,25.134366666666665,646,4,1,272,295,-23
BR1_2729349103,17,False,1,0,0,22880,255,52,7.4,True,10,True,0,0,0,19641,213,49,7.4,False,27.6511,3239,7,1,307,262,45
BR1_2729322340,8,True,0,1,0,18906,244,71,7.2,False,12,False,1,0,0,20304,221,72,7.4,True,29.9493,-1398,-4,-1,315,293,22
BR1_2729293982,7,False,0,1,0,18683,231,72,7.4,False,10,True,1,0,0,20068,259,52,7.8,True,29.9023,-1385,-3,-1,303,311,-8
BR1_2731840321,10,True,0,1,0,18200,220,49,7.0,True,5,False,1,0,0,15253,188,60,6.6,False,27.1565,2947,5,-1,269,248,21
BR1_2724918755,8,False,0,0,0,18269,238,52,6.8,True,7,True,0,0,0,17127,195,44,6.8,False,26.17955,1142,1,0,290,239,51
BR1_2724910068,4,False,0,0,0,15004,200,48,6.4,False,7,True,1,1,0,17691,220,55,6.6,True,25.703333333333333,-2687,-3,-1,248,275,-27
BR1_2722753844,9,True,1,0,0,16830,201,40,6.4,False,7,False,0,0,0,16946,215,40,6.8,True,26.470416666666665,-116,2,1,241,255,-14
BR1_2721946407,4,False,0,0,0,14383,157,45,6.4,False,6,True,1,0,0,15484,195,43,6.4,True,25.44895,-1101,-2,-1,202,238,-36
BR1_2730964773,9,False,0,0,0,19388,233,36,7.0,False,9,True,1,0,0,18941,239,56,7.0,True,29.2051,447,0,-1,269,295,-26
BR1_2731724638,10,True,1,0,0,20003,246,60,7.4,True,4,False,0,0,0,16609,244,60,7.4,False,27.829033333333335,3394,6,1,306,304,2
BR1_2729536800,6,True,0,0,0,17447,227,63,7.2,False,12,False,0,0,0,20125,253,42,7.2,True,28.66595,-2678,-6,0,290,295,-5
BR1_2731465274,5,False,1,0,0,17525,234,60,7.4,False,10,True,0,0,0,19932,267,56,7.4,True,28.15755,-2407,-5,1,294,323,-29
BR1_2730545088,5,False,0,0,0,17022,222,68,7.8,False,7,True,2,1,1,20408,227,60,7.6,True,29.26745,-3386,-2,-2,290,287,3
BR1_2731529576,4,False,0,1,0,17854,271,76,7.4,True,6,True,0,0,0,17511,262,52,7.8,False,27.76255,343,-2,0,347,314,33
BR1_2731006929,8,True,0,0,0,18370,208,61,7.4,False,7,False,1,0,0,18887,251,54,7.4,True,29.01925,-517,1,-1,269,305,-36
BR1_2730973171,5,False,1,1,0,15979,224,55,7.2,True,3,True,0,0,0,15754,219,56,6.8,False,27.1346,225,2,1,279,275,4
BR1_2731502523,7,True,0,1,0,20391,278,67,7.6,False,6,False,1,0,0,18143,256,44,7.6,True,29.665466666666667,2248,1,-1,345,300,45
BR1_2731483655,9,False,0,0,0,19309,259,56,7.2,True,9,True,1,0,0,18834,249,47,7.6,False,28.5741,475,0,-1,315,296,19
BR1_2731269889,4,False,1,0,0,15194,208,56,6.8,False,4,True,0,0,0,16014,195,72,7.2,True,27.1418,-820,0,1,264,267,-3
BR1_2725494656,10,True,1,0,0,18472,212,64,7.0,True,8,False,0,1,0,17754,193,72,6.6,False,27.128883333333334,718,2,1,276,265,11
BR1_2723154048,5,True,0,1,0,16044,232,56,7.2,True,4,False,0,0,0,14932,200,48,6.8,False,27.2292,1112,1,0,288,248,40
BR1_2731689895,11,False,1,0,0,20666,247,52,7.4,True,4,True,0,1,0,16993,253,52,7.0,False,29.2446,3673,7,1,299,305,-6
BR1_2725834630,11,False,1,1,0,20405,225,73,7.2,True,10,True,0,0,0,19073,202,59,7.2,False,27.867166666666666,1332,1,1,298,261,37
BR1_2731706278,4,True,1,0,0,16108,234,63,7.0,True,2,False,0,1,0,14634,211,64,6.8,False,26.180966666666666,1474,2,1,297,275,22
BR1_2731650986,8,False,0,1,0,19337,235,64,7.4,True,4,True,0,0,0,17540,280,60,7.4,False,29.79606666666667,1797,4,0,299,340,-41
BR1_2727484270,7,True,1,0,0,19686,263,80,7.4,True,4,False,0,1,0,18942,264,56,7.4,False,28.652983333333335,744,3,1,343,320,23
BR1_2726745342,4,False,0,0,0,16997,259,47,7.6,False,8,True,1,1,0,19824,258,80,7.8,True,28.67285,-2827,-4,-1,306,338,-32
BR1_2731492767,6,False,1,1,0,16872,234,56,7.0,False,5,True,0,0,0,16396,226,60,7.0,True,25.14305,476,1,1,290,286,4
BR1_2724095024,16,True,0,1,0,22398,246,74,7.8,True,4,False,0,0,0,16197,183,52,7.0,False,29.619666666666667,6201,12,0,320,235,85
BR1_2731608298,7,True,0,0,0,16046,173,48,6.8,False,9,False,0,0,0,18856,185,56,7.0,True,25.469466666666666,-2810,-2,0,221,241,-20
BR1_2731505737,12,True,1,1,0,19459,180,48,6.6,True,9,False,0,0,0,18019,177,52,6.6,False,25.72385,1440,3,1,228,229,-1
BR1_2727604177,11,False,1,1,0,20344,226,63,7.6,True,6,True,0,0,0,18668,292,52,7.2,False,29.389533333333333,1676,5,1,289,344,-55
BR1_2725537423,12,False,1,1,0,20873,232,64,7.4,False,9,True,0,0,0,18859,246,44,7.2,True,28.978783333333332,2014,3,1,296,290,6
BR1_2720013436,10,True,1,1,0,19343,254,64,7.0,False,11,False,0,0,0,19868,222,64,7.2,True,28.69098333333333,-525,-1,1,318,286,32
BR1_2731588002,3,True,0,0,0,15022,202,49,7.0,False,8,False,1,0,0,16912,204,60,6.8,True,25.050416666666667,-1890,-5,-1,251,264,-13
BR1_2731535601,9,True,0,0,0,17460,186,42,7.4,False,9,False,1,0,0,20182,265,60,7.4,True,27.991116666666667,-2722,0,-1,228,325,-97
BR1_2731586959,4,False,0,0,0,14990,205,48,6.8,True,5,True,0,0,0,16064,218,56,6.8,False,26.0518,-1074,-1,0,253,274,-21
BR1_2729896125,10,True,1,0,0,19736,238,56,7.2,True,6,False,0,1,0,17137,210,58,7.0,False,27.91945,2599,4,1,294,268,26
BR1_2729877579,8,False,0,1,1,18027,208,56,6.6,True,10,True,1,0,0,18028,196,60,6.6,False,26.660616666666666,-1,-2,-1,264,256,8
BR1_2731606211,6,False,0,0,0,17403,249,52,7.6,True,7,True,1,0,0,18645,276,68,7.4,False,27.73365,-1242,-1,-1,301,344,-43
BR1_2731741793,12,False,0,0,0,20302,244,56,8.2,True,5,True,1,1,1,19012,217,72,7.4,False,28.6277,1290,7,-1,300,289,11
BR1_2713075703,7,False,0,1,0,19462,263,74,7.4,True,8,True,1,0,0,18743,233,59,7.2,False,28.3611,719,-1,-1,337,292,45
BR1_2713009816,4,False,0,0,0,16623,233,68,7.0,False,6,True,0,1,0,17591,245,52,7.0,True,26.094466666666666,-968,-2,0,301,297,4
BR1_2712994057,5,False,1,0,0,15899,166,64,6.6,True,11,True,0,0,0,18953,217,40,7.0,False,25.951266666666665,-3054,-6,1,230,257,-27
BR1_2723176657,9,True,1,1,0,19559,274,64,7.4,True,12,False,0,0,0,20925,259,48,7.6,False,27.7401,-1366,-3,1,338,307,31
BR1_2731532374,13,True,1,1,0,20801,214,64,7.8,True,7,False,0,0,0,18041,201,48,6.8,False,29.38585,2760,6,1,278,249,29
BR1_2731517279,11,False,0,0,0,19022,182,57,6.8,False,13,True,0,0,0,19141,162,46,6.6,True,27.177133333333334,-119,-2,0,239,208,31
BR1_2731343988,9,True,0,0,0,17756,205,56,6.8,True,12,False,1,0,0,19647,181,60,7.0,False,28.549516666666666,-1891,-3,-1,261,241,20
BR1_2731004348,7,False,0,0,0,15797,146,47,6.0,False,15,True,1,0,0,18975,176,39,6.4,True,26.199916666666667,-3178,-8,-1,193,215,-22
BR1_2731592454,8,False,0,0,0,18044,231,72,7.4,True,6,True,0,0,0,18947,271,56,7.4,False,27.68215,-903,2,0,303,327,-24
BR1_2729595535,8,False,0,0,0,16849,210,64,6.6,False,7,True,1,1,0,17366,205,68,6.8,True,26.67595,-517,1,-1,274,273,1
BR1_2730879869,18,True,1,0,0,22983,244,72,8.0,True,11,False,0,1,0,19914,243,44,7.4,False,29.255233333333333,3069,7,1,316,287,29
BR1_2728837767,15,True,1,0,1,22097,234,58,7.6,True,6,False,0,0,0,18003,236,56,7.2,False,27.6799,4094,9,1,292,292,0
BR1_2726502064,6,False,0,1,0,18081,249,48,7.2,False,4,True,1,0,0,17245,265,64,7.4,True,28.8691,836,2,-1,297,329,-32
BR1_2728687973,9,True,1,0,0,17868,239,51,7.0,False,4,False,0,0,0,15663,197,60,6.8,True,26.97298333333333,2205,5,1,290,257,33
BR1_2720537628,1,False,0,0,0,13967,204,48,6.6,False,6,True,1,0,0,17363,240,56,7.0,True,25.987166666666667,-3396,-5,-1,252,296,-44
BR1_2731645294,8,False,0,1,0,19924,241,80,7.6,True,6,True,1,0,0,17611,238,52,7.2,False,28.845266666666667,2313,2,-1,321,290,31
BR1_2731691169,8,False,0,1,0,18051,225,40,7.2,True,12,True,0,0,0,19311,218,56,7.2,False,28.870683333333332,-1260,-4,0,265,274,-9
BR1_2725290948,2,True,0,0,0,14564,197,64,6.8,False,4,False,1,1,0,16272,225,64,7.2,True,27.25145,-1708,-2,-1,261,289,-28
BR1_2724966786,9,False,0,0,0,17491,179,56,6.6,False,12,True,0,0,0,19778,199,52,6.8,True,26.123116666666668,-2287,-3,0,235,251,-16
BR1_2731541372,8,False,0,0,0,18784,242,53,7.6,False,5,True,1,1,0,18891,276,62,7.6,True,29.86705,-107,3,-1,295,338,-43
BR1_2720649003,8,False,1,1,0,20144,272,72,7.6,True,9,True,0,0,0,19751,242,64,7.4,False,28.543166666666668,393,-1,1,344,306,38
BR1_2719869480,7,False,0,0,0,17575,205,56,7.2,False,10,True,0,1,0,19967,242,64,7.6,True,29.912966666666666,-2392,-3,0,261,306,-45
BR1_2731684395,5,True,1,0,0,16541,231,66,7.4,False,8,False,0,0,0,18200,212,60,7.8,True,28.73775,-1659,-3,1,297,272,25
BR1_2731243523,5,False,0,1,0,16760,220,56,7.0,True,5,True,1,0,0,15002,189,60,7.0,False,25.701583333333332,1758,0,-1,276,249,27
BR1_2730856760,9,False,0,1,0,20219,240,60,7.2,True,9,True,1,0,0,19610,222,80,7.6,False,27.638366666666666,609,0,-1,300,302,-2
BR1_2728698205,6,False,0,1,0,17621,199,56,7.0,False,10,True,1,0,0,19873,234,64,7.4,True,29.092433333333332,-2252,-4,-1,255,298,-43
BR1_2731014664,8,True,0,1,0,18662,230,64,7.2,False,6,False,0,0,0,18647,237,52,7.4,True,28.955566666666666,15,2,0,294,289,5
BR1_2730993050,6,False,0,1,0,18918,283,60,7.4,False,9,True,1,0,0,19079,229,64,7.4,True,28.449916666666667,-161,-3,-1,343,293,50
BR1_2731848408,8,False,0,0,0,18183,232,46,7.2,False,14,True,1,0,0,21062,244,60,7.6,True,29.682266666666667,-2879,-6,-1,278,304,-26
BR1_2730108633,6,False,1,0,0,17048,233,64,7.2,True,6,True,0,0,0,16956,234,68,7.0,False,26.07015,92,0,1,297,302,-5
BR1_2729113484,6,True,0,0,0,17576,225,48,7.2,False,6,False,1,1,0,18736,240,64,7.8,True,27.53495,-1160,0,-1,273,304,-31
BR1_2731537515,12,True,1,1,0,20341,227,66,7.0,True,10,False,0,0,0,18571,240,41,7.0,False,27.595333333333333,1770,2,1,293,281,12
BR1_2731703255,8,True,1,1,0,19361,253,90,8.2,True,0,False,0,0,0,15322,243,74,7.0,False,29.325666666666667,4039,8,1,343,317,26
BR1_2731319835,4,True,1,0,0,16773,222,52,7.0,True,6,False,0,1,0,18329,235,67,7.4,False,27.747483333333335,-1556,-2,1,274,302,-28
BR1_2731266398,11,True,1,1,0,20092,233,64,7.4,True,7,False,0,0,0,19090,234,64,7.4,False,28.902483333333333,1002,4,1,297,298,-1
BR1_2730692444,10,False,1,0,0,19604,231,72,7.6,False,7,True,0,1,0,18620,233,56,7.4,True,29.996983333333333,984,3,1,303,289,14
BR1_2705092246,6,False,1,0,0,16492,227,52,6.8,False,6,True,0,1,0,17282,211,56,7.2,True,26.23565,-790,0,1,279,267,12
BR1_2705069833,2,False,0,0,0,15123,240,62,6.8,False,7,True,1,0,0,16871,231,51,7.0,True,26.246233333333333,-1748,-5,-1,302,282,20
BR1_2730749821,4,True,0,0,0,16109,213,60,7.0,False,1,False,1,0,0,13654,220,44,6.8,True,27.22145,2455,3,-1,273,264,9
BR1_2729607038,5,True,0,0,0,15272,173,52,6.6,False,8,False,1,0,0,18250,226,64,7.0,True,27.070733333333333,-2978,-3,-1,225,290,-65
BR1_2731874714,9,True,0,0,0,16480,174,56,6.6,True,5,False,0,0,0,15294,169,52,6.6,False,25.966783333333332,1186,4,0,230,221,9
BR1_2730861241,7,True,0,0,0,16971,215,48,6.6,True,5,False,0,0,0,15510,200,51,6.6,False,25.559083333333334,1461,2,0,263,251,12
BR1_2731951107,5,True,1,0,0,17400,256,68,7.0,True,2,False,0,0,0,13796,185,44,6.2,False,27.327066666666667,3604,3,1,324,229,95
BR1_2731452938,3,True,0,0,0,16664,229,71,7.0,False,4,False,0,0,0,14801,182,56,6.8,True,26.861133333333335,1863,-1,0,300,238,62
BR1_2731677413,12,True,1,1,1,21264,236,72,7.8,True,4,False,0,0,0,17238,212,64,7.0,False,28.2748,4026,8,1,308,276,32
BR1_2731231274,2,False,1,1,0,16641,266,60,7.4,False,9,True,0,0,0,20283,274,72,7.6,True,28.849966666666667,-3642,-7,1,326,346,-20
BR1_2731829222,4,False,1,1,0,17235,272,60,7.6,False,4,True,0,0,0,17551,260,62,7.6,True,29.161133333333332,-316,0,1,332,322,10
BR1_2731802949,8,True,1,1,0,18971,235,59,7.2,True,8,False,0,0,0,19153,261,50,7.4,False,28.4173,-182,0,1,294,311,-17
BR1_2731539938,7,True,0,0,0,17693,191,68,6.6,False,16,False,1,0,0,21344,229,59,7.4,True,29.9304,-3651,-9,-1,259,288,-29
BR1_2731859836,12,False,0,1,0,21128,243,52,7.6,False,3,True,1,0,0,16563,227,60,7.0,True,28.016516666666668,4565,9,-1,295,287,8
BR1_2730987246,4,True,0,0,1,18230,235,68,7.0,True,1,False,0,1,0,13252,160,44,6.4,False,25.107216666666666,4978,3,0,303,204,99
BR1_2731706563,11,False,1,1,0,19440,210,70,7.4,True,9,True,0,0,0,19387,242,60,7.2,False,29.413066666666666,53,2,1,280,302,-22
BR1_2730748079,6,True,0,0,0,17249,229,60,7.0,False,7,False,0,0,0,18321,247,48,7.4,True,28.74015,-1072,-1,0,289,295,-6
BR1_2729683298,6,True,0,0,0,17608,207,52,7.6,False,7,False,0,1,0,18827,224,58,7.6,True,28.9177,-1219,-1,0,259,282,-23
BR1_2731330320,11,True,0,0,0,18429,199,56,7.0,False,8,False,1,1,0,17018,193,63,6.8,True,27.105566666666668,1411,3,-1,255,256,-1
BR1_2731252961,5,False,0,0,0,16757,236,59,7.4,True,5,True,0,0,0,17659,245,32,7.0,False,28.205183333333334,-902,0,0,295,277,18
BR1_2731179407,10,True,0,0,0,20471,248,72,7.8,False,8,False,1,1,0,18558,213,60,7.2,True,28.48005,1913,2,-1,320,273,47
BR1_2728314845,9,True,0,0,0,18423,215,60,7.4,True,13,False,0,1,0,20619,208,56,7.4,False,27.7772,-2196,-4,0,275,264,11
BR1_2722321555,8,False,1,0,0,17506,176,56,6.6,False,7,True,0,1,0,17285,226,56,6.8,True,25.302383333333335,221,1,1,232,282,-50
BR1_2731363781,10,False,0,0,0,17976,214,40,6.8,False,8,True,0,1,0,17796,194,48,6.8,True,25.903616666666668,180,2,0,254,242,12
BR1_2731171812,10,True,1,0,0,19283,254,60,7.2,True,4,False,0,0,0,15554,235,38,6.6,False,26.4321,3729,6,1,314,273,41
BR1_2720318119,8,True,1,0,0,17094,235,59,7.2,True,3,False,0,0,0,15398,220,55,7.0,False,26.426916666666667,1696,5,1,294,275,19
BR1_2729182615,2,False,0,1,0,14581,191,66,6.8,False,7,True,1,0,0,16645,202,48,7.0,True,25.340033333333334,-2064,-5,-1,257,250,7
BR1_2725576882,4,False,0,0,0,18160,298,56,7.8,False,6,True,1,1,0,19572,259,76,7.4,True,29.6164,-1412,-2,-1,354,335,19
BR1_2725554309,16,True,1,1,0,20939,212,74,7.0,True,3,False,0,0,0,13919,169,46,6.0,False,26.56395,7020,13,1,286,215,71
BR1_2717825139,13,True,0,1,0,21713,228,61,7.8,True,6,False,0,0,0,18145,240,50,7.4,False,27.691316666666665,3568,7,0,289,290,-1
BR1_2731785134,7,True,0,0,0,17161,225,52,6.6,False,8,False,0,1,0,17774,219,48,6.6,True,26.5414,-613,-1,0,277,267,10
BR1_2731761207,4,True,0,0,0,15315,206,42,6.6,False,13,False,0,0,0,19290,243,49,7.4,True,26.11455,-3975,-9,0,248,292,-44
BR1_2730732238,9,False,0,1,0,17152,177,40,6.4,True,15,True,1,0,0,19903,228,32,7.0,False,25.54045,-2751,-6,-1,217,260,-43
BR1_2731647792,8,True,0,1,0,18735,227,56,7.0,True,6,False,1,0,0,16386,198,52,6.4,False,26.20018333333333,2349,2,-1,283,250,33
BR1_2731838938,7,False,1,1,0,19332,244,60,7.6,True,9,True,0,0,0,19743,232,60,7.8,False,29.686116666666667,-411,-2,1,304,292,12
BR1_2731913441,8,False,1,0,0,17415,183,64,7.0,False,15,True,0,1,0,23835,275,39,7.6,True,28.814183333333332,-6420,-7,1,247,314,-67
BR1_2731487244,6,False,1,1,0,17583,224,70,7.8,False,7,True,0,0,0,18203,237,64,7.4,True,29.2332,-620,-1,1,294,301,-7
BR1_2731938996,3,False,0,0,0,14810,197,42,6.4,False,8,True,1,0,0,18357,231,72,7.2,True,26.922366666666665,-3547,-5,-1,239,303,-64
BR1_2731412982,6,False,0,0,0,16560,207,44,6.8,True,7,True,0,1,0,17532,228,48,6.8,False,25.953416666666666,-972,-1,0,251,276,-25
BR1_2730066905,12,True,0,1,0,20161,203,60,7.2,False,14,False,1,0,1,22856,246,48,7.6,True,29.26905,-2695,-2,-1,263,294,-31
BR1_2730017470,2,False,0,0,0,15023,247,52,7.0,False,7,True,1,1,0,17549,246,60,7.4,True,26.8821,-2526,-5,-1,299,306,-7
BR1_2729743551,6,False,0,0,0,16513,227,56,7.2,False,8,True,0,1,0,18667,205,56,7.0,True,27.240816666666667,-2154,-2,0,283,261,22
BR1_2729900616,10,False,1,0,0,18403,230,52,7.2,True,8,True,0,0,0,17535,200,56,6.8,False,26.426116666666665,868,2,1,282,256,26
BR1_2730907106,2,False,1,0,0,15907,239,68,7.4,False,9,True,0,1,1,20668,236,60,7.0,True,28.545966666666665,-4761,-7,1,307,296,11
BR1_2703479263,11,True,1,0,0,21142,242,63,7.4,True,8,False,0,1,1,19497,224,42,7.0,False,29.540316666666666,1645,3,1,305,266,39
BR1_2703327616,9,True,0,1,0,18994,229,56,6.8,True,7,False,0,0,0,17426,204,76,7.2,False,26.22671666666667,1568,2,0,285,280,5
BR1_2726914150,7,True,0,0,0,17354,218,60,7.0,False,8,False,0,0,0,16738,242,44,7.0,True,27.0414,616,-1,0,278,286,-8
BR1_2712840103,8,True,0,0,0,17335,219,51,6.8,True,9,False,1,0,0,16801,228,40,6.8,False,27.288833333333333,534,-1,-1,270,268,2
BR1_2729458656,4,True,1,0,0,19056,297,76,7.8,True,2,False,0,1,0,16420,265,56,7.4,False,28.971683333333335,2636,2,1,373,321,52
BR1_2729433794,9,True,0,0,0,18103,201,64,7.2,False,5,False,0,0,0,17840,243,56,7.6,True,27.90795,263,4,0,265,299,-34
BR1_2730007663,4,False,1,0,0,15526,204,88,7.2,False,4,True,0,0,0,15471,233,48,6.8,True,26.64615,55,0,1,292,281,11
BR1_2731608348,7,True,0,0,0,17106,208,44,6.8,False,8,False,1,1,0,18256,221,56,7.0,True,25.543483333333334,-1150,-1,-1,252,277,-25
BR1_2731105963,6,False,0,0,0,15916,206,44,6.8,False,7,True,1,0,0,16788,227,56,7.0,True,25.406333333333333,-872,-1,-1,250,283,-33
BR1_2731229039,10,True,1,0,0,19090,226,52,7.0,True,8,False,0,0,0,20258,251,56,7.2,False,28.7364,-1168,2,1,278,307,-29
BR1_2731193687,4,True,0,0,0,16879,251,56,7.0,False,7,False,1,0,0,18399,253,56,7.6,True,28.13906666666667,-1520,-3,-1,307,309,-2
BR1_2725480035,7,False,0,0,0,15707,198,52,6.6,False,6,True,1,0,0,16913,221,38,6.8,True,27.057166666666667,-1206,1,-1,250,259,-9
BR1_2706887530,14,True,0,1,0,22255,222,56,7.6,False,13,False,0,0,0,20669,212,52,7.4,True,29.245383333333333,1586,1,0,278,264,14
BR1_2706861213,6,False,0,0,0,18754,269,60,7.6,False,5,True,0,0,0,19371,286,63,7.6,True,28.444783333333334,-617,1,0,329,349,-20
BR1_2731576271,8,True,1,0,0,16937,194,46,6.6,True,8,False,0,0,0,16622,190,52,6.6,False,26.6064,315,0,1,240,242,-2
BR1_2729673322,3,False,0,0,0,15004,216,64,7.2,False,2,True,1,1,0,14913,235,52,7.2,True,26.5694,91,1,-1,280,287,-7
BR1_2728843676,6,False,0,0,0,16592,198,48,7.0,True,9,True,0,0,0,16903,215,60,6.8,False,25.978283333333334,-311,-3,0,246,275,-29
BR1_2728826194,8,True,0,1,0,19507,264,40,7.4,True,12,False,1,0,0,20055,250,63,7.8,False,29.428416666666667,-548,-4,-1,304,313,-9
BR1_2727831759,6,False,1,0,0,18295,288,64,7.6,True,5,True,0,1,0,17674,245,60,7.2,False,27.987983333333332,621,1,1,352,305,47
BR1_2731178230,5,True,0,0,0,17264,245,52,7.2,False,4,False,1,0,0,17203,248,68,7.2,True,27.683716666666665,61,1,-1,297,316,-19
BR1_2728921315,8,False,1,0,0,18144,210,56,6.8,False,6,True,0,1,0,16791,204,56,7.0,True,25.938183333333335,1353,2,1,266,260,6
BR1_2727878138,9,True,0,0,0,16877,205,60,6.8,True,6,False,1,0,0,17661,229,60,7.0,False,26.594733333333334,-784,3,-1,265,289,-24
BR1_2727853496,7,True,0,0,0,19065,294,63,7.6,False,2,False,1,0,0,17141,239,72,7.4,True,28.75105,1924,5,-1,357,311,46
BR1_2731450617,7,False,0,1,0,17527,214,71,7.0,True,12,True,1,0,0,18707,212,44,6.6,False,25.992433333333334,-1180,-5,-1,285,256,29
BR1_2730551233,7,False,0,1,0,18975,223,43,7.4,False,9,True,1,0,0,19339,221,60,7.4,True,28.940016666666665,-364,-2,-1,266,281,-15
BR1_2730533019,3,False,1,0,0,16799,256,64,7.6,True,5,True,0,0,0,17106,258,49,7.4,False,28.377916666666668,-307,-2,1,320,307,13
BR1_2715572748,7,True,0,1,0,16426,190,59,7.0,False,4,False,1,0,0,15997,209,48,6.4,True,27.4265,429,3,-1,249,257,-8
BR1_2716105228,9,False,0,0,0,18834,215,46,7.2,False,10,True,1,0,0,20764,221,66,7.4,True,29.4043,-1930,-1,-1,261,287,-26
BR1_2722762069,9,False,1,0,0,18710,235,40,7.2,False,5,True,0,0,0,17830,238,60,7.4,True,29.511616666666665,880,4,1,275,298,-23
BR1_2731869300,14,True,1,1,0,21769,260,68,7.8,True,9,False,0,0,0,18906,243,56,7.4,False,28.355716666666666,2863,5,1,328,299,29
BR1_2731661059,14,True,1,0,0,19952,213,44,7.0,True,6,False,0,0,0,16056,212,60,7.0,False,25.430116666666667,3896,8,1,257,272,-15
BR1_2731635255,9,True,0,0,0,17524,219,49,6.8,True,4,False,1,0,0,14735,201,49,6.8,False,26.74801666666667,2789,5,-1,268,250,18
BR1_2731660556,6,True,1,0,0,18471,257,48,7.2,False,6,False,0,1,0,17324,204,63,7.0,True,29.6907,1147,0,1,305,267,38
BR1_2731637546,7,True,0,0,0,18083,217,52,7.4,False,11,False,0,0,0,19702,230,56,7.4,True,27.9064,-1619,-4,0,269,286,-17
BR1_2731468070,5,False,0,0,0,16011,198,40,6.4,False,13,True,1,0,0,19252,195,67,7.0,True,27.081383333333335,-3241,-8,-1,238,262,-24
BR1_2726153775,4,False,1,0,0,15026,165,52,6.6,False,12,True,0,0,0,19996,193,64,7.4,True,26.028483333333334,-4970,-8,1,217,257,-40
BR1_2717279519,5,False,0,1,0,18480,261,68,7.4,False,8,True,1,0,0,18612,245,56,7.4,True,28.042133333333332,-132,-3,-1,329,301,28
BR1_2730568046,3,False,1,0,0,17040,250,52,7.2,True,7,True,0,1,0,18164,260,62,7.2,False,29.462766666666667,-1124,-4,1,302,322,-20
BR1_2727116784,9,True,1,0,0,18422,222,52,7.0,True,9,False,0,0,0,18979,240,42,7.0,False,29.154916666666665,-557,0,1,274,282,-8
BR1_2729712864,6,False,1,0,0,18494,248,67,7.4,False,8,True,0,1,0,19639,249,52,7.4,True,27.995,-1145,-2,1,315,301,14
BR1_2731878492,9,True,0,1,0,17246,211,44,7.0,False,7,False,1,0,0,16081,181,56,7.2,True,26.2643,1165,2,-1,255,237,18
BR1_2731770742,6,False,1,0,0,16837,258,56,7.0,True,4,True,0,1,0,17064,233,56,7.2,False,28.284,-227,2,1,314,289,25
BR1_2728992224,11,False,1,0,0,20232,240,68,7.6,False,6,True,0,1,0,17953,251,72,7.2,True,28.754433333333335,2279,5,1,308,323,-15
BR1_2728962818,11,False,0,0,0,19787,226,48,7.4,True,15,True,1,0,0,21234,215,52,7.2,False,29.171133333333334,-1447,-4,-1,274,267,7
BR1_2728939613,10,True,0,0,0,17488,197,60,6.6,False,8,False,0,0,0,17223,204,44,7.0,True,25.9806,265,2,0,257,248,9
BR1_2731895466,9,True,0,1,0,20118,238,75,8.0,True,7,False,1,0,0,18668,275,52,7.6,False,27.64355,1450,2,-1,313,327,-14
BR1_2696468791,10,True,0,0,0,16927,180,48,6.6,True,2,False,0,0,0,13872,188,50,6.6,False,25.008583333333334,3055,8,0,228,238,-10
BR1_2730350630,5,True,0,0,0,16172,220,64,6.8,True,4,False,1,1,0,15536,193,56,6.6,False,26.131316666666667,636,1,-1,284,249,35
BR1_2729904808,6,True,1,0,0,17563,239,59,7.2,False,5,False,0,0,0,17458,221,68,7.6,True,29.5614,105,1,1,298,289,9
BR1_2729851440,10,False,0,1,0,19870,234,76,7.4,False,13,True,1,0,0,21838,247,60,7.8,True,28.5746,-1968,-3,-1,310,307,3
BR1_2730615401,11,False,0,1,0,20053,240,52,7.2,True,8,True,0,0,0,18399,227,50,7.0,False,28.3581,1654,3,0,292,277,15
BR1_2730597212,9,False,0,0,0,18578,207,64,7.4,True,12,True,0,1,0,19857,192,59,6.6,False,26.210483333333332,-1279,-3,0,271,251,20
BR1_2729947697,13,True,0,0,0,20392,235,48,7.2,True,9,False,0,1,0,19989,222,71,7.6,False,29.189933333333332,403,4,0,283,293,-10
BR1_2731628210,11,False,0,1,0,19911,205,68,7.4,False,14,True,0,0,0,21005,231,68,7.2,True,27.6369,-1094,-3,0,273,299,-26
BR1_2727612535,3,True,1,0,0,14433,206,51,7.2,True,6,False,0,1,0,16213,214,56,7.2,False,26.3557,-1780,-3,1,257,270,-13
BR1_2727120320,10,False,0,0,0,21129,244,68,7.8,True,10,True,0,0,0,19491,237,64,7.4,False,29.973066666666668,1638,0,0,312,301,11
BR1_2731580691,12,True,1,0,0,20444,227,55,7.6,True,3,False,0,0,0,15489,213,43,6.8,False,29.22115,4955,9,1,282,256,26
BR1_2731932776,7,False,0,0,0,18131,207,68,7.6,False,11,True,1,1,0,20594,247,76,7.4,True,28.1919,-2463,-4,-1,275,323,-48
BR1_2731072896,14,False,1,1,0,19487,161,66,7.0,True,11,True,0,0,0,17325,144,44,6.2,False,27.4526,2162,3,1,227,188,39
BR1_2730653637,6,False,0,1,0,19005,254,80,7.8,True,6,True,1,0,0,19844,257,64,7.6,False,29.0699,-839,0,-1,334,321,13
BR1_2695908141,4,True,0,1,0,16881,259,60,7.2,True,3,False,0,0,0,15978,249,68,7.0,False,27.451633333333334,903,1,0,319,317,2
BR1_2726231601,6,True,1,0,0,17440,248,57,7.2,False,8,False,0,0,0,18781,252,58,7.4,True,29.130533333333332,-1341,-2,1,305,310,-5
BR1_2719436711,5,True,0,0,0,17507,215,72,7.4,False,9,False,1,1,0,20136,240,80,7.8,True,28.652116666666668,-2629,-4,-1,287,320,-33
BR1_2718590462,9,False,1,1,0,18567,226,55,7.0,True,9,True,0,0,0,16574,190,46,6.8,False,26.016983333333332,1993,0,1,281,236,45
BR1_2714606188,5,True,1,0,0,16265,203,65,7.2,True,7,False,0,0,0,16499,219,62,7.4,False,25.238233333333334,-234,-2,1,268,281,-13
BR1_2731726449,6,False,0,0,0,16797,200,53,6.6,False,8,True,0,0,0,17501,213,55,7.0,True,26.3252,-704,-2,0,253,268,-15
BR1_2730662161,10,True,0,1,1,20870,270,54,7.2,False,6,False,1,0,0,17902,202,64,7.6,True,27.879633333333334,2968,4,-1,324,266,58
BR1_2722417206,14,False,0,0,0,20553,237,64,7.6,True,8,True,0,1,0,20339,256,64,7.2,False,28.7872,214,6,0,301,320,-19
BR1_2720574736,8,True,0,1,0,16951,201,56,6.6,False,6,False,1,0,0,17280,242,59,6.8,True,27.18725,-329,2,-1,257,301,-44
BR1_2720112239,7,True,0,1,0,17601,229,59,7.2,True,2,False,0,0,0,14127,208,52,6.4,False,25.390233333333335,3474,5,0,288,260,28
BR1_2731309508,5,False,0,0,0,15457,197,52,7.0,False,6,True,1,0,0,16840,217,68,6.6,True,27.061666666666667,-1383,-1,-1,249,285,-36
BR1_2730663014,14,True,1,1,0,19995,223,48,7.2,True,2,False,0,0,0,14372,215,44,6.4,False,25.90455,5623,12,1,271,259,12
BR1_2722035216,8,False,1,0,0,17583,228,59,7.2,True,7,True,0,0,0,15199,178,44,6.4,False,26.6926,2384,1,1,287,222,65
BR1_2731614815,7,True,0,0,0,16827,206,44,6.6,True,4,False,1,0,0,16311,243,52,7.0,False,25.87151666666667,516,3,-1,250,295,-45
BR1_2724472730,9,True,1,0,0,19001,221,76,7.2,True,7,False,0,0,0,16730,204,40,7.0,False,28.5585,2271,2,1,297,244,53
BR1_2731164436,9,False,0,0,0,17201,198,56,6.8,False,7,True,1,1,0,18602,215,48,7.0,True,26.358583333333332,-1401,2,-1,254,263,-9
BR1_2731691358,6,False,0,0,0,15488,188,64,6.8,False,6,True,1,0,0,15599,188,68,7.0,True,25.581583333333334,-111,0,-1,252,256,-4
BR1_2731839707,6,True,0,0,0,16232,181,48,6.4,False,7,False,1,0,0,16756,218,44,6.6,True,25.084233333333334,-524,-1,-1,229,262,-33
BR1_2731752330,3,False,0,0,0,17148,249,66,7.2,False,8,True,1,1,0,18524,256,60,7.4,True,28.3451,-1376,-5,-1,315,316,-1
BR1_2730857880,6,True,0,0,0,16895,202,40,6.6,True,12,False,0,0,0,17760,197,48,6.8,False,25.92031666666667,-865,-6,0,242,245,-3
BR1_2730844588,5,True,1,0,0,15953,211,64,6.8,False,11,False,0,0,0,17954,209,48,6.8,True,26.430133333333334,-2001,-6,1,275,257,18
BR1_2729716635,5,False,1,0,0,17050,241,55,7.2,True,4,True,0,1,0,17719,261,64,7.4,False,28.617566666666665,-669,1,1,296,325,-29
BR1_2729515786,9,False,1,0,0,18546,236,68,7.6,True,8,True,0,1,0,17952,221,48,7.6,False,29.730166666666666,594,1,1,304,269,35
BR1_2728083543,7,True,1,0,0,18009,224,48,7.2,False,8,False,0,1,1,19423,217,48,7.0,True,28.807616666666668,-1414,-1,1,272,265,7
BR1_2730657258,7,True,1,0,0,16847,236,44,7.0,False,1,False,0,1,0,14927,221,64,7.0,True,25.825433333333333,1920,6,1,280,285,-5
BR1_2730594949,3,False,0,0,0,15174,211,36,6.8,False,12,True,1,0,0,18408,218,48,6.8,True,27.165483333333334,-3234,-9,-1,247,266,-19
BR1_2704842366,9,False,0,0,0,19504,226,53,7.6,True,11,True,1,0,0,20194,249,50,7.6,False,28.192633333333333,-690,-2,-1,279,299,-20
BR1_2704834258,7,True,0,0,0,17708,232,52,6.6,True,4,False,1,0,0,15735,207,44,6.6,False,27.109566666666666,1973,3,-1,284,251,33
BR1_2704796985,5,False,0,0,0,16322,192,56,6.6,False,11,True,1,0,0,20656,259,48,6.8,True,25.226133333333333,-4334,-6,-1,248,307,-59
BR1_2731818221,5,True,1,0,0,17730,226,64,7.2,True,2,False,0,0,0,16245,263,48,7.2,False,28.215733333333333,1485,3,1,290,311,-21
BR1_2731237773,7,False,1,0,0,18015,218,56,6.8,True,6,True,0,1,0,16495,215,40,6.6,False,26.7836,1520,1,1,274,255,19
BR1_2731214293,9,False,1,0,0,16813,188,54,6.8,True,3,True,0,0,0,15730,244,44,6.6,False,26.577283333333334,1083,6,1,242,288,-46
BR1_2731188322,13,True,0,0,0,19438,200,64,7.0,True,9,False,0,0,0,17444,197,47,6.6,False,27.368616666666668,1994,4,0,264,244,20
BR1_2722649706,10,True,0,0,0,18016,185,36,6.6,True,18,False,1,0,1,23599,234,60,7.6,False,29.8997,-5583,-8,-1,221,294,-73
BR1_2722600063,13,False,1,0,0,18745,215,40,6.8,True,8,True,0,0,0,15915,186,56,6.4,False,26.143433333333334,2830,5,1,255,242,13
BR1_2722278173,5,True,0,0,0,16493,233,48,6.6,True,10,False,1,0,0,18051,205,44,6.8,False,25.178816666666666,-1558,-5,-1,281,249,32
BR1_2731950931,8,False,1,1,0,19799,257,43,7.2,True,15,True,0,0,0,20955,220,44,7.2,False,27.823166666666665,-1156,-7,1,300,264,36
BR1_2731597992,10,True,0,1,1,21422,263,52,7.6,False,7,False,1,0,0,18046,230,56,7.2,True,28.533283333333333,3376,3,-1,315,286,29
BR1_2731947381,5,False,1,0,0,16221,188,56,6.8,True,7,True,0,0,0,15748,199,32,6.6,False,26.6563,473,-2,1,244,231,13
BR1_2731933960,7,True,0,0,0,18000,170,56,6.8,False,10,False,0,0,0,19301,222,60,7.0,True,28.827883333333332,-1301,-3,0,226,282,-56
BR1_2731867768,13,True,1,0,0,22542,237,60,7.8,False,6,False,0,1,0,17448,191,60,6.8,True,28.052683333333334,5094,7,1,297,251,46
BR1_2727762881,6,False,0,0,0,16750,228,61,7.0,True,2,True,0,0,0,14699,246,54,6.8,False,27.18695,2051,4,0,289,300,-11
BR1_2727401218,12,True,0,0,0,18965,193,60,6.6,False,4,False,1,1,0,16900,221,64,6.6,True,25.650833333333335,2065,8,-1,253,285,-32
BR1_2731859658,2,False,0,0,0,14011,165,50,6.6,False,11,True,1,0,0,18976,231,58,7.0,True,27.24175,-4965,-9,-1,215,289,-74
BR1_2705660599,5,False,0,1,0,17713,223,55,7.2,False,9,True,1,0,0,18662,225,48,7.0,True,28.761283333333335,-949,-4,-1,278,273,5
BR1_2704960666,5,True,0,0,0,16471,207,56,6.6,True,4,False,0,1,0,16646,236,72,7.0,False,26.45093333333333,-175,1,0,263,308,-45
BR1_2729788688,11,False,0,0,0,18479,172,40,7.0,False,20,True,0,1,0,24049,239,72,7.4,True,29.4314,-5570,-9,0,212,311,-99
BR1_2731078786,9,False,1,0,1,20730,269,44,7.4,False,11,True,0,1,0,21906,280,50,7.4,True,28.476583333333334,-1176,-2,1,313,330,-17
BR1_2706727016,6,False,1,0,0,18489,254,59,7.4,True,9,True,0,1,0,19208,264,39,7.4,False,27.797733333333333,-719,-3,1,313,303,10
BR1_2731582246,9,True,1,1,0,17636,202,58,6.8,True,7,False,0,0,0,16203,221,50,7.0,False,25.686533333333333,1433,2,1,260,271,-11
BR1_2718930232,5,False,1,0,0,15836,196,60,6.6,False,9,True,0,1,0,19651,241,60,6.8,True,26.572533333333332,-3815,-4,1,256,301,-45
BR1_2708812715,5,False,0,0,0,16054,231,72,6.8,True,6,True,0,0,0,17526,266,56,7.0,False,25.487516666666668,-1472,-1,0,303,322,-19
BR1_2708637943,10,True,0,0,0,18436,218,68,7.0,True,7,False,0,0,0,17051,200,52,6.6,False,25.938083333333335,1385,3,0,286,252,34
BR1_2730951658,9,False,1,0,0,16659,188,48,6.6,True,10,True,0,0,0,18109,204,42,7.2,False,25.109416666666668,-1450,-1,1,236,246,-10
BR1_2731845361,5,False,0,0,0,15392,196,56,6.4,False,9,True,1,1,0,18355,239,52,7.0,True,27.4694,-2963,-4,-1,252,291,-39
BR1_2731877029,7,False,0,1,0,17239,236,63,6.8,True,8,True,1,0,0,17426,200,51,7.2,False,26.094116666666668,-187,-1,-1,299,251,48
BR1_2731675154,12,True,0,1,0,20527,243,56,7.2,False,9,False,1,0,0,19725,232,72,7.6,True,29.784766666666666,802,3,-1,299,304,-5
BR1_2731644696,8,False,0,1,0,17299,217,43,6.8,True,7,True,1,0,0,16286,234,47,6.6,False,26.628633333333333,1013,1,-1,260,281,-21
BR1_2711599993,8,False,1,1,0,18899,243,64,7.4,True,4,True,0,0,0,17752,250,69,7.2,False,29.3845,1147,4,1,307,319,-12
BR1_2696839172,6,False,0,0,0,16757,202,45,7.4,True,7,True,1,1,0,19907,238,66,7.4,False,29.817483333333332,-3150,-1,-1,247,304,-57
BR1_2731163353,9,False,0,0,0,18547,246,52,7.2,False,10,True,1,0,0,20554,235,71,7.4,True,28.02945,-2007,-1,-1,298,306,-8
BR1_2726201839,8,False,0,0,0,17897,197,80,7.2,True,6,True,1,0,0,16364,224,40,6.6,False,27.29105,1533,2,-1,277,264,13
BR1_2726176364,11,True,1,1,0,20436,215,71,7.2,True,4,False,0,0,0,18149,224,60,7.2,False,28.065316666666668,2287,7,1,286,284,2
BR1_2726149524,6,True,1,0,0,17027,203,48,6.8,True,8,False,0,1,0,17537,208,52,7.2,False,25.900666666666666,-510,-2,1,251,260,-9
BR1_2726120339,5,True,0,0,0,16574,202,44,6.8,False,13,False,1,0,0,21209,236,47,7.6,True,28.052383333333335,-4635,-8,-1,246,283,-37
BR1_2728511266,11,True,1,0,0,19875,244,47,7.4,False,8,False,0,1,0,19399,238,41,7.4,True,29.18385,476,3,1,291,279,12
BR1_2727043805,9,False,0,0,0,18453,257,44,7.2,True,7,True,0,0,0,16675,192,52,6.6,False,27.3783,1778,2,0,301,244,57
BR1_2718930896,5,True,0,0,0,15741,220,52,6.6,False,6,False,1,0,0,16496,195,55,6.6,True,26.221683333333335,-755,-1,-1,272,250,22
BR1_2710295763,4,False,0,0,0,16696,207,59,7.2,False,5,True,0,0,0,16791,226,46,7.4,True,28.045566666666666,-95,-1,0,266,272,-6
BR1_2731635840,6,False,0,0,0,16961,236,52,7.0,True,3,True,0,0,0,15270,204,60,6.8,False,27.283716666666667,1691,3,0,288,264,24
BR1_2730959470,9,True,1,1,0,19795,249,54,7.6,True,4,False,0,0,0,16708,226,69,7.2,False,29.7969,3087,5,1,303,295,8
BR1_2731546114,4,False,1,0,0,15616,232,60,7.0,True,5,True,0,1,0,16256,222,72,6.8,False,26.634,-640,-1,1,292,294,-2
BR1_2675698068,6,True,1,0,0,15537,183,58,6.8,True,5,False,0,1,0,17068,200,48,7.0,False,25.513883333333332,-1531,1,1,241,248,-7
BR1_2675626894,10,False,0,1,0,18357,183,60,6.8,False,6,True,1,0,0,16617,187,45,6.8,True,26.9361,1740,4,-1,243,232,11
BR1_2675602370,6,False,0,0,0,17084,211,64,6.8,False,3,True,1,0,0,15597,195,48,6.6,True,26.4865,1487,3,-1,275,243,32
BR1_2731857039,18,False,1,1,0,22619,202,49,7.6,True,9,True,0,0,0,18759,212,64,7.0,False,29.46055,3860,9,1,251,276,-25
BR1_2731882341,8,False,1,0,0,16138,184,60,7.2,True,3,True,0,0,0,16314,239,54,6.8,False,26.23575,-176,5,1,244,293,-49
BR1_2731525246,8,False,1,1,0,16524,159,60,6.8,True,5,True,0,0,0,15948,220,48,6.4,False,25.5077,576,3,1,219,268,-49
BR1_2731539148,10,False,1,0,1,20706,248,48,7.4,True,10,True,0,1,1,20762,239,52,7.4,False,28.081866666666667,-56,0,1,296,291,5
BR1_2731511891,15,True,1,0,0,20314,208,52,7.4,False,6,False,0,0,0,16121,184,52,6.6,True,25.995416666666667,4193,9,1,260,236,24
BR1_2731657306,13,True,0,0,0,19426,207,44,6.8,True,9,False,0,0,0,17942,170,52,7.0,False,25.42555,1484,4,0,251,222,29
BR1_2728709310,7,True,0,0,0,17493,204,54,7.0,False,8,False,0,0,0,18343,226,52,7.4,True,27.654483333333335,-850,-1,0,258,278,-20
BR1_2727912145,7,True,0,0,0,15972,212,52,6.6,True,7,False,0,0,0,16434,178,44,6.8,False,26.1147,-462,0,0,264,222,42
BR1_2727883877,14,True,0,0,0,18290,162,44,6.6,True,11,False,0,0,0,16997,154,52,6.8,False,26.0804,1293,3,0,206,206,0
BR1_2731897238,11,True,1,0,0,19087,221,55,7.2,True,12,False,0,1,0,20676,237,44,7.6,False,29.65595,-1589,-1,1,276,281,-5
BR1_2731809390,5,False,1,0,0,16787,219,48,7.2,True,9,True,0,0,0,19238,264,40,7.8,False,27.977216666666667,-2451,-4,1,267,304,-37
BR1_2731883186,7,False,0,1,0,18131,187,60,7.0,False,16,True,0,0,0,21571,253,44,7.4,True,28.47395,-3440,-9,0,247,297,-50
BR1_2729025159,9,False,1,0,0,16935,204,39,6.8,False,10,True,0,0,0,18853,223,68,7.0,True,26.99895,-1918,-1,1,243,291,-48
BR1_2728995644,8,False,0,0,0,17296,197,60,6.8,True,4,True,0,0,0,15105,176,52,6.4,False,25.492516666666667,2191,4,0,257,228,29
BR1_2728503358,13,True,0,1,0,21358,259,70,7.4,True,8,False,0,0,0,18555,235,65,7.2,False,28.704666666666668,2803,5,0,329,300,29
BR1_2731151088,6,False,1,0,0,16299,223,40,6.8,True,8,True,0,0,0,17638,235,68,7.2,False,25.68395,-1339,-2,1,263,303,-40
BR1_2731061756,9,False,0,0,0,18558,224,40,7.2,False,13,True,0,0,0,19961,212,36,7.0,True,29.314033333333334,-1403,-4,0,264,248,16
BR1_2731019268,8,False,1,1,0,17199,222,52,7.0,True,4,True,0,0,0,15054,203,48,6.8,False,27.185616666666668,2145,4,1,274,251,23
BR1_2730985527,6,False,0,0,0,16362,225,48,6.8,False,9,True,1,0,0,18450,205,70,6.8,True,27.014166666666668,-2088,-3,-1,273,275,-2
BR1_2730658153,5,False,0,0,0,17103,200,68,7.2,False,10,True,1,1,1,20501,233,40,7.4,True,28.373683333333332,-3398,-5,-1,268,273,-5
BR1_2731583518,12,True,1,1,0,19457,211,60,7.4,False,10,False,0,0,0,19071,232,64,7.4,True,27.922016666666668,386,2,1,271,296,-25
BR1_2718496965,8,True,0,0,0,17970,241,60,7.2,True,12,False,1,0,0,20046,223,60,7.2,False,28.055233333333334,-2076,-4,-1,301,283,18
BR1_2727630837,11,True,0,0,0,18997,213,52,7.0,True,11,False,1,0,0,20337,241,56,7.4,False,29.151466666666668,-1340,0,-1,265,297,-32
BR1_2721617458,10,True,0,0,0,17983,172,58,6.6,False,17,False,1,1,0,21372,207,50,7.2,True,25.676666666666666,-3389,-7,-1,230,257,-27
BR1_2718900380,11,False,0,1,0,20432,243,68,7.6,False,7,True,1,0,0,17588,227,48,7.0,True,29.6191,2844,4,-1,311,275,36
BR1_2731678137,5,False,0,0,0,16737,223,52,7.2,False,14,True,1,1,0,23063,280,68,7.6,True,28.31965,-6326,-9,-1,275,348,-73
BR1_2731629679,10,True,1,1,0,17125,196,48,7.0,True,5,False,0,0,0,16191,196,48,6.8,False,26.08145,934,5,1,244,244,0
BR1_2729424393,7,True,1,0,0,18136,204,56,7.2,False,8,False,0,1,0,18512,182,55,7.0,True,28.726366666666667,-376,-1,1,260,237,23
BR1_2731584017,9,False,1,1,0,19652,280,59,7.6,True,6,True,0,0,0,17138,207,60,7.0,False,27.9627,2514,3,1,339,267,72
BR1_2730613684,9,False,0,1,0,17879,229,44,7.0,True,6,True,1,0,0,16323,232,52,7.0,False,27.311466666666668,1556,3,-1,273,284,-11
BR1_2730217031,8,False,0,1,0,19627,218,64,7.4,False,12,True,1,0,0,20458,227,68,7.6,True,29.631783333333335,-831,-4,-1,282,295,-13
BR1_2725370203,6,True,0,0,0,18332,252,51,7.4,False,9,False,1,0,0,18247,203,66,7.4,True,27.7246,85,-3,-1,303,269,34
BR1_2724566033,17,True,0,0,0,20525,188,52,7.0,True,5,False,0,0,0,14895,214,48,6.4,False,26.846816666666665,5630,12,0,240,262,-22
BR1_2696378141,4,False,0,0,0,14546,154,44,6.2,False,10,True,1,0,0,19354,233,54,7.0,True,27.0436,-4808,-6,-1,198,287,-89
BR1_2696335903,5,True,0,0,0,16022,236,56,6.8,True,6,False,0,0,0,16625,224,64,6.8,False,25.300916666666666,-603,-1,0,292,288,4
BR1_2696329286,12,True,1,1,0,18726,219,40,7.2,True,5,False,0,0,0,15632,197,48,6.4,False,26.976566666666667,3094,7,1,259,245,14
BR1_2731281325,5,False,0,0,0,14913,164,53,6.8,False,8,True,1,0,0,17411,218,60,7.0,True,25.46313333333333,-2498,-3,-1,217,278,-61
BR1_2731809423,7,False,0,0,0,16771,198,48,7.0,False,11,True,0,0,0,18890,212,64,7.2,True,27.543283333333335,-2119,-4,0,246,276,-30
BR1_2731784300,9,True,0,0,0,17715,190,52,6.6,True,8,False,0,1,0,16948,172,52,6.2,False,26.8943,767,1,0,242,224,18
BR1_2731726760,7,True,0,0,1,16536,213,36,6.6,False,9,False,1,1,0,18483,207,60,7.2,True,26.31345,-1947,-2,-1,249,267,-18
BR1_2731264695,10,False,1,0,0,20363,214,60,7.6,True,10,True,0,0,0,18953,227,52,7.6,False,28.644816666666667,1410,0,1,274,279,-5
BR1_2728354969,9,True,1,1,0,20292,244,60,7.4,False,9,False,0,0,0,20025,231,62,7.6,True,29.1252,267,0,1,304,293,11
BR1_2724730273,12,False,0,1,0,19143,220,40,6.8,False,10,True,1,0,0,18467,184,66,6.6,True,26.973633333333332,676,2,-1,260,250,10
BR1_2716715190,6,True,0,1,0,16567,228,64,6.8,False,7,False,1,0,0,16971,236,44,6.8,True,25.13605,-404,-1,-1,292,280,12
BR1_2731362242,5,False,1,0,0,14765,212,43,6.6,False,9,True,0,0,0,18215,221,56,6.8,True,25.8572,-3450,-4,1,255,277,-22
BR1_2726581138,1,False,0,1,0,14323,206,64,6.6,False,11,True,1,0,0,19076,226,56,7.2,True,27.028333333333332,-4753,-10,-1,270,282,-12
BR1_2726566362,13,True,0,0,0,19336,217,52,7.2,True,8,False,0,0,0,17082,164,52,6.6,False,26.031166666666667,2254,5,0,269,216,53
BR1_2721330510,12,True,0,0,1,20414,202,48,7.0,True,15,False,0,0,0,23679,231,44,7.2,False,28.954883333333335,-3265,-3,0,250,275,-25
BR1_2720465733,12,True,1,0,0,20050,221,55,7.4,False,9,False,0,0,0,20039,252,75,7.4,True,28.43625,11,3,1,276,327,-51
BR1_2720456783,15,True,0,0,0,19327,201,60,7.2,True,6,False,0,0,0,15152,186,24,6.4,False,25.681783333333332,4175,9,0,261,210,51
BR1_2707262842,9,True,1,0,0,17415,228,68,7.4,True,2,False,0,1,0,14429,207,48,6.8,False,25.603066666666667,2986,7,1,296,255,41
BR1_2713689771,7,True,1,1,0,18003,208,64,7.6,True,6,False,0,0,0,17583,222,60,7.6,False,29.42385,420,1,1,272,282,-10
BR1_2709575850,3,False,0,0,0,15124,214,32,6.8,True,12,True,0,0,0,17967,226,40,6.8,False,26.309933333333333,-2843,-9,0,246,266,-20
BR1_2707317593,9,False,1,0,0,20635,279,64,7.6,True,7,True,0,0,0,18016,223,56,7.4,False,27.968983333333334,2619,2,1,343,279,64
BR1_2701909711,5,False,0,0,0,17746,192,76,7.0,False,8,True,1,1,0,18902,232,52,7.4,True,29.089783333333333,-1156,-3,-1,268,284,-16
BR1_2699761884,8,False,0,0,0,18134,208,62,7.0,False,7,True,1,1,0,17292,194,42,6.8,True,29.16095,842,1,-1,270,236,34
BR1_2730284245,11,True,1,1,0,20338,225,56,7.2,True,6,False,0,0,0,18304,227,56,7.2,False,29.62105,2034,5,1,281,283,-2
BR1_2728609720,4,False,0,0,0,16489,222,36,6.8,False,6,True,1,0,0,17134,237,64,7.0,True,25.833066666666667,-645,-2,-1,258,301,-43
BR1_2731201150,7,True,0,0,0,18847,254,48,7.2,False,5,False,0,1,0,17381,233,65,7.2,True,29.695666666666668,1466,2,0,302,298,4
BR1_2731197817,10,True,0,0,0,19426,250,46,7.4,True,8,False,0,0,0,19613,248,56,7.6,False,29.646333333333335,-187,2,0,296,304,-8
BR1_2731370912,11,False,1,1,0,20100,237,52,7.6,True,7,True,0,0,0,18114,227,40,7.0,False,29.095233333333333,1986,4,1,289,267,22
BR1_2731371311,4,False,0,0,1,18825,241,64,7.6,False,4,True,1,1,0,16957,210,72,7.0,True,29.759883333333335,1868,0,-1,305,282,23
BR1_2731366189,10,True,1,0,0,17775,189,48,7.2,False,10,False,0,0,0,20570,259,48,7.6,True,28.040916666666668,-2795,0,1,237,307,-70
BR1_2731940973,11,True,1,1,0,21154,278,56,7.8,False,2,False,0,0,0,16125,230,68,7.4,True,27.95628333333333,5029,9,1,334,298,36
BR1_2731946270,9,False,0,0,0,19895,255,68,7.6,True,5,True,1,1,0,16502,231,60,7.2,False,28.203766666666667,3393,4,-1,323,291,32
BR1_2731878190,9,True,1,1,0,18479,196,56,7.0,True,1,False,0,0,0,13364,200,48,6.4,False,26.87405,5115,8,1,252,248,4
BR1_2731305198,5,False,0,1,0,17615,222,56,7.6,False,10,True,1,0,0,20012,270,56,7.4,True,29.8056,-2397,-5,-1,278,326,-48
BR1_2730352337,8,True,0,0,0,19176,216,54,7.2,False,9,False,1,1,0,19797,240,65,7.4,True,29.240683333333333,-621,-1,-1,270,305,-35
BR1_2731623153,4,False,0,0,0,16742,235,52,6.8,False,6,True,1,0,0,17397,231,56,7.2,True,27.0366,-655,-2,-1,287,287,0
BR1_2731576467,6,True,1,1,0,19256,270,60,7.4,False,6,False,0,0,0,17572,227,67,7.6,True,29.640883333333335,1684,0,1,330,294,36
BR1_2731833465,7,True,1,1,0,18270,217,68,7.0,True,6,False,0,0,0,18825,243,56,7.0,False,28.3018,-555,1,1,285,299,-14
BR1_2730009186,9,False,0,0,0,20575,231,55,7.4,False,11,True,1,1,0,19420,200,60,7.2,True,28.345483333333334,1155,-2,-1,286,260,26
BR1_2726764647,14,True,1,0,0,21023,230,57,7.6,True,10,False,0,1,0,19539,202,62,7.4,False,27.551283333333334,1484,4,1,287,264,23
BR1_2727882323,9,False,1,0,0,19447,246,64,7.4,True,5,True,0,1,0,18078,245,60,7.6,False,28.099283333333332,1369,4,1,310,305,5
BR1_2716634770,7,False,1,0,0,16989,243,52,6.8,True,5,True,0,0,0,15677,204,75,6.8,False,25.645016666666667,1312,2,1,295,279,16
BR1_2711070662,3,False,0,1,0,14685,190,51,6.6,False,9,True,0,0,0,17304,209,44,6.6,True,26.652083333333334,-2619,-6,0,241,253,-12
BR1_2709470482,9,True,1,0,0,16292,171,56,6.8,True,4,False,0,1,0,15246,193,60,6.6,False,25.793266666666668,1046,5,1,227,253,-26
BR1_2729483815,12,True,1,0,0,18531,229,32,6.8,True,6,False,0,0,0,16597,178,68,6.8,False,26.995266666666666,1934,6,1,261,246,15
BR1_2720446201,11,True,0,0,0,18786,199,54,6.6,True,10,False,1,0,0,18186,222,65,6.8,False,26.62,600,1,-1,253,287,-34
BR1_2726076251,5,True,1,0,0,17141,232,72,7.4,False,6,False,0,0,0,18673,235,59,7.4,True,29.076,-1532,-1,1,304,294,10
BR1_2726035592,4,False,0,0,0,16363,210,64,7.0,False,12,True,1,0,0,21589,254,88,7.8,True,29.727766666666668,-5226,-8,-1,274,342,-68
BR1_2726518060,9,True,0,0,0,18828,253,54,7.4,False,7,False,0,1,0,18471,240,49,7.4,True,28.236133333333335,357,2,0,307,289,18
BR1_2730301391,8,True,0,0,0,18380,238,56,7.0,False,5,False,1,0,0,16277,205,48,6.6,True,25.0805,2103,3,-1,294,253,41
BR1_2731229850,15,True,1,1,0,22702,230,56,7.6,True,6,False,0,0,0,17672,236,56,7.2,False,28.067616666666666,5030,9,1,286,292,-6
BR1_2731173577,11,True,1,0,0,19537,219,60,7.4,True,8,False,0,0,0,19186,250,60,7.4,False,28.005466666666667,351,3,1,279,310,-31
BR1_2731856935,15,True,0,0,0,20975,212,44,7.0,True,6,False,0,0,0,14812,176,48,6.8,False,25.4697,6163,9,0,256,224,32
BR1_2726894969,3,True,1,0,0,16038,239,67,6.8,True,3,False,0,1,0,15558,236,52,7.4,False,25.67155,480,0,1,306,288,18
BR1_2731659093,8,True,1,0,0,17618,157,68,7.2,False,9,False,0,1,0,20937,268,60,7.4,True,28.180733333333333,-3319,-1,1,225,328,-103
BR1_2731146672,6,False,0,1,0,17234,204,48,6.8,False,13,True,1,0,0,21444,252,52,7.4,True,27.946766666666665,-4210,-7,-1,252,304,-52
BR1_2675419531,5,False,0,0,0,16777,229,76,7.2,False,5,True,1,0,0,16518,250,56,7.4,True,26.374566666666666,259,0,-1,305,306,-1
BR1_2675383877,4,False,0,1,0,20010,276,55,7.4,False,5,True,1,0,0,17636,249,71,7.6,True,28.364066666666666,2374,-1,-1,331,320,11
BR1_2718702597,16,True,0,0,0,21093,225,52,7.4,True,10,False,1,0,0,19968,207,52,7.0,False,28.107016666666667,1125,6,-1,277,259,18
BR1_2725120521,5,True,0,1,1,18893,278,56,7.6,True,4,False,1,0,0,16765,263,55,7.2,False,29.883983333333333,2128,1,-1,334,318,16
BR1_2725099510,14,True,0,1,0,21581,255,72,7.6,True,7,False,0,0,0,17872,233,68,7.2,False,25.992483333333332,3709,7,0,327,301,26
BR1_2730328118,5,False,0,0,0,15710,177,60,6.4,True,5,True,1,0,0,15670,188,48,6.6,False,27.4381,40,0,-1,237,236,1
BR1_2727506457,6,False,0,0,0,15936,192,41,6.6,False,8,True,0,0,0,17558,226,58,7.2,True,25.08335,-1622,-2,0,233,284,-51
BR1_2730686197,3,False,0,0,0,15473,222,44,6.8,True,3,True,1,0,0,14871,215,58,6.6,False,25.732216666666666,602,0,-1,266,273,-7
BR1_2730619664,5,True,1,1,0,17086,224,75,7.2,True,5,False,0,0,0,15475,222,44,6.8,False,25.008883333333333,1611,0,1,299,266,33
BR1_2730197119,12,True,1,1,0,20630,252,60,7.6,True,8,False,0,0,0,18960,257,48,7.4,False,29.54,1670,4,1,312,305,7
BR1_2705049097,6,False,0,1,0,16689,235,56,7.0,True,8,True,1,0,0,18154,213,60,7.0,False,25.293916666666668,-1465,-2,-1,291,273,18
BR1_2705024984,8,True,1,0,0,16339,181,50,6.6,True,10,False,0,0,0,17991,207,48,6.8,False,26.862033333333333,-1652,-2,1,231,255,-24
BR1_2731466241,10,True,0,0,0,18865,217,68,7.2,False,8,False,1,0,0,18175,213,62,7.2,True,28.4317,690,2,-1,285,275,10
BR1_2730262322,3,False,0,1,0,15893,222,64,7.0,False,7,True,1,0,0,18442,244,56,7.8,True,29.624616666666668,-2549,-4,-1,286,300,-14
BR1_2730698042,4,False,0,0,0,16141,234,59,7.0,True,6,True,0,0,0,16965,228,55,6.6,False,26.821933333333334,-824,-2,0,293,283,10
BR1_2731605749,9,False,0,0,0,18557,242,40,7.0,True,10,True,1,0,0,18585,191,68,7.0,False,28.63768333333333,-28,-1,-1,282,259,23
BR1_2731664712,6,True,0,0,0,16849,196,54,6.6,False,8,False,0,0,0,17246,216,40,7.0,True,26.95925,-397,-2,0,250,256,-6
BR1_2731176595,4,False,0,0,0,14506,175,61,7.0,False,4,True,0,0,0,15592,245,36,7.2,True,27.02805,-1086,0,0,236,281,-45
BR1_2731307298,6,True,1,0,0,16290,210,56,6.8,False,5,False,0,1,0,15285,159,56,6.6,True,25.754,1005,1,1,266,215,51
BR1_2730767062,7,False,1,0,0,17585,221,60,7.4,False,5,True,0,1,0,17738,267,64,7.2,True,28.154183333333332,-153,2,1,281,331,-50
BR1_2731612559,7,False,1,0,0,17215,246,58,7.0,True,4,True,0,0,0,15213,207,58,6.8,False,25.00935,2002,3,1,304,265,39
BR1_2730953614,7,False,0,0,0,17022,199,48,7.4,False,11,True,1,1,0,19930,217,76,7.8,True,29.36345,-2908,-4,-1,247,293,-46
BR1_2696384228,10,True,0,0,0,18697,206,47,6.8,True,10,False,1,0,0,19357,202,72,7.2,False,27.110983333333333,-660,0,-1,253,274,-21
BR1_2693835170,3,False,1,0,0,15625,247,68,7.2,False,4,True,0,1,0,16119,260,52,7.0,True,25.39835,-494,-1,1,315,312,3
BR1_2728619116,7,True,0,1,0,17468,187,59,7.0,True,5,False,0,0,0,19004,253,68,7.4,False,27.566066666666668,-1536,2,0,246,321,-75
BR1_2730490254,12,False,0,0,0,18767,165,52,7.0,True,7,True,0,0,0,17534,211,40,6.8,False,27.446866666666665,1233,5,0,217,251,-34
BR1_2714709625,11,True,0,0,0,18988,194,60,7.2,False,7,False,1,0,0,19046,281,71,7.4,True,27.656216666666666,-58,4,-1,254,352,-98
BR1_2714688524,10,False,1,0,0,16300,173,48,6.4,False,7,True,0,0,0,16997,194,55,6.8,True,26.224216666666667,-697,3,1,221,249,-28
BR1_2731199525,12,True,1,0,0,21183,259,66,7.8,False,9,False,0,0,0,19404,266,58,7.6,True,29.619683333333334,1779,3,1,325,324,1
BR1_2722578288,14,True,1,0,1,22963,280,64,8.0,True,4,False,0,0,0,16760,208,56,7.0,False,28.551433333333332,6203,10,1,344,264,80
BR1_2731797078,10,False,0,0,0,18331,224,48,7.0,True,5,True,1,0,0,15465,200,64,6.6,False,27.277316666666668,2866,5,-1,272,264,8
BR1_2731763297,6,True,0,0,0,15871,193,48,6.6,False,7,False,1,0,0,18195,238,68,6.8,True,27.488866666666667,-2324,-1,-1,241,306,-65
BR1_2731340816,7,False,0,0,0,16482,144,60,6.2,True,14,True,0,0,0,19728,204,44,6.8,False,27.485116666666666,-3246,-7,0,204,248,-44
BR1_2731288028,13,True,0,0,0,19958,238,56,7.2,True,12,False,0,0,0,18319,214,40,7.2,False,25.541083333333333,1639,1,0,294,254,40
BR1_2731723375,10,False,1,0,0,20465,256,56,7.8,True,6,True,0,0,0,17415,235,56,7.2,False,28.589116666666666,3050,4,1,312,291,21
BR1_2731695430,5,False,1,1,0,16689,211,68,7.0,True,6,True,0,0,0,15862,213,52,6.8,False,25.080966666666665,827,-1,1,279,265,14
BR1_2731443484,13,False,0,0,0,20457,230,56,7.4,True,7,True,2,0,0,19486,246,76,7.4,False,27.705733333333335,971,6,-2,286,322,-36
BR1_2721929756,8,True,1,0,0,17563,229,68,7.2,True,5,False,0,0,0,15987,214,72,7.2,False,26.39195,1576,3,1,297,286,11
BR1_2728291789,9,True,1,0,0,17161,200,48,6.6,True,6,False,0,1,0,17901,218,64,6.8,False,27.127383333333334,-740,3,1,248,282,-34
BR1_2726889585,8,True,0,0,0,18918,245,52,7.4,False,4,False,1,1,0,17531,260,56,7.6,True,27.644933333333334,1387,4,-1,297,316,-19
BR1_2727381372,9,True,0,1,0,19683,231,56,7.4,True,7,False,1,0,0,18102,218,67,7.2,False,29.976016666666666,1581,2,-1,287,285,2
BR1_2731037062,9,True,1,0,1,21915,265,48,7.6,True,7,False,0,0,0,17587,216,68,7.2,False,27.692066666666665,4328,2,1,313,284,29
BR1_2721237180,8,False,0,0,0,18052,194,56,7.0,False,6,True,1,0,0,18876,264,68,7.6,True,29.960566666666665,-824,2,-1,250,332,-82
BR1_2702617661,4,True,0,0,0,14515,195,36,6.8,False,7,False,0,0,0,16994,208,68,7.0,True,26.481833333333334,-2479,-3,0,231,276,-45
BR1_2731176784,5,True,1,0,0,15961,206,68,6.8,True,8,False,0,0,0,17109,216,52,6.8,False,25.513,-1148,-3,1,274,268,6
BR1_2729950766,9,False,1,0,0,20042,262,80,7.4,True,9,True,0,0,0,19261,217,56,7.2,False,28.39235,781,0,1,342,273,69
BR1_2731304977,9,True,1,0,0,17827,217,56,6.8,True,6,False,0,0,0,16016,188,64,6.6,False,26.9925,1811,3,1,273,252,21
BR1_2731287011,8,True,0,0,0,17455,243,52,7.2,True,2,False,0,0,0,14241,199,56,6.6,False,25.377083333333335,3214,6,0,295,255,40
BR1_2731231692,8,True,1,1,0,18936,237,49,7.4,True,10,False,0,0,0,18770,248,38,7.4,False,28.767783333333334,166,-2,1,286,286,0
BR1_2720060602,7,False,0,0,0,18177,235,57,7.0,False,11,True,1,1,0,20882,250,72,7.6,True,28.8332,-2705,-4,-1,292,322,-30
BR1_2696282805,7,False,0,1,0,19006,231,65,7.4,True,7,True,1,0,0,18832,248,62,7.6,False,29.282,174,0,-1,296,310,-14
BR1_2714680664,3,False,0,0,0,16524,245,64,7.4,False,10,True,0,0,0,19014,210,64,7.4,True,28.428816666666666,-2490,-7,0,309,274,35
BR1_2731180233,12,True,0,1,0,19108,220,52,6.8,True,3,False,0,0,0,15218,214,63,6.6,False,25.0628,3890,9,0,272,277,-5
BR1_2730940081,9,True,0,1,0,19277,273,56,7.6,True,10,False,1,0,0,19039,224,60,7.2,False,28.753283333333332,238,-1,-1,329,284,45
BR1_2703369229,7,True,0,1,0,20211,261,65,7.6,True,7,False,1,0,0,18431,248,50,7.2,False,27.82725,1780,0,-1,326,298,28
BR1_2731498713,7,False,0,0,0,18321,230,60,7.4,False,9,True,0,1,0,20009,254,53,7.6,True,28.1084,-1688,-2,0,290,307,-17
BR1_2730900641,10,True,1,1,1,20874,209,48,7.0,True,5,False,0,0,0,17037,221,71,7.2,False,29.229816666666668,3837,5,1,257,292,-35
BR1_2729843091,10,True,0,0,0,19104,228,53,7.2,False,11,False,0,0,0,17868,179,46,6.8,True,27.467583333333334,1236,-1,0,281,225,56
BR1_2727881950,8,False,0,1,0,18479,227,60,7.2,False,10,True,1,0,0,19828,259,72,7.4,True,28.993066666666667,-1349,-2,-1,287,331,-44
BR1_2708134681,9,True,1,0,0,19337,260,64,7.4,True,2,False,0,0,0,17390,247,68,7.6,False,28.166783333333335,1947,7,1,324,315,9
BR1_2707951956,9,True,0,1,0,18153,201,52,7.0,True,5,False,1,0,0,16751,213,56,6.8,False,26.699683333333333,1402,4,-1,253,269,-16
BR1_2731295068,6,True,0,1,0,15928,210,56,6.8,True,2,False,1,0,0,14595,216,75,7.0,False,25.276816666666665,1333,4,-1,266,291,-25
BR1_2731224040,4,False,0,1,0,15958,235,52,7.0,True,5,True,0,0,0,17116,238,52,7.0,False,27.18873333333333,-1158,-1,0,287,290,-3
BR1_2731199067,5,False,0,0,0,15746,201,56,6.6,False,13,True,0,0,0,19530,250,51,7.0,True,25.106283333333334,-3784,-8,0,257,301,-44
BR1_2731809825,7,False,0,0,0,16328,197,44,6.8,True,7,True,1,0,0,17243,217,70,7.0,False,25.555016666666667,-915,0,-1,241,287,-46
BR1_2731347886,4,False,0,0,0,16046,194,48,6.6,True,8,True,0,0,0,17328,196,52,6.8,False,26.815333333333335,-1282,-4,0,242,248,-6
BR1_2730438983,3,True,0,1,0,18185,251,73,7.8,False,10,False,1,0,0,20373,240,64,7.2,True,28.083633333333335,-2188,-7,-1,324,304,20
BR1_2730432803,9,False,0,0,0,19355,233,55,7.4,True,5,True,0,0,0,18064,218,68,7.4,False,29.74065,1291,4,0,288,286,2
BR1_2727360894,8,False,0,1,0,18549,245,52,7.4,False,11,True,1,0,0,20835,264,44,7.6,True,28.468533333333333,-2286,-3,-1,297,308,-11
BR1_2730020241,11,True,0,0,0,19305,227,40,7.4,True,8,False,1,0,0,18310,207,63,7.0,False,29.254283333333333,995,3,-1,267,270,-3
BR1_2729929830,4,True,1,0,0,15958,217,48,6.6,False,5,False,0,0,1,17759,208,72,7.4,True,26.78145,-1801,-1,1,265,280,-15
BR1_2731282154,6,False,0,1,1,19296,230,64,7.6,False,8,True,1,0,0,19330,281,60,7.6,True,28.603716666666667,-34,-2,-1,294,341,-47
BR1_2731109068,5,False,0,0,0,16308,226,48,6.8,False,5,True,0,1,0,17089,235,56,6.8,True,25.003716666666666,-781,0,0,274,291,-17
BR1_2731086686,11,True,1,1,0,20710,278,60,7.8,True,8,False,0,0,0,17883,247,76,7.4,False,28.719116666666668,2827,3,1,338,323,15
BR1_2731562692,1,False,0,0,0,13249,177,52,6.6,False,12,True,1,0,0,19037,205,52,7.2,True,25.6056,-5788,-11,-1,229,257,-28
BR1_2731513227,10,False,0,0,0,19997,239,73,7.8,False,10,True,1,1,0,20761,240,70,7.8,True,27.8783,-764,0,-1,312,310,2
BR1_2731495283,7,False,1,1,1,17875,226,59,7.0,False,8,True,0,0,0,17054,175,48,7.0,True,27.16185,821,-1,1,285,223,62
BR1_2731958013,7,False,1,0,0,16147,188,60,6.8,False,10,True,0,1,0,18991,208,60,7.2,True,25.485166666666668,-2844,-3,1,248,268,-20
BR1_2731937537,2,False,0,0,0,15292,194,72,7.0,False,7,True,1,1,0,20183,245,80,7.8,True,28.167833333333334,-4891,-5,-1,266,325,-59
BR1_2731841212,8,False,1,0,0,17635,169,64,7.0,True,4,True,0,0,0,15013,172,44,6.4,False,25.55465,2622,4,1,233,216,17
BR1_2731099108,12,False,0,1,0,21073,277,68,7.8,True,7,True,1,0,1,20197,224,58,7.4,False,27.98015,876,5,-1,345,282,63
BR1_2731080600,3,True,1,0,0,14921,222,48,6.6,False,3,False,0,1,0,16421,244,60,7.2,True,26.4474,-1500,0,1,270,304,-34
BR1_2731058252,7,True,0,0,0,17779,226,51,6.6,False,10,False,0,1,1,20690,242,56,7.6,True,28.5645,-2911,-3,0,277,298,-21
BR1_2717319985,11,True,1,0,0,19517,239,52,7.0,False,3,False,0,0,0,15122,202,48,6.6,True,26.694666666666667,4395,8,1,291,250,41
BR1_2731193980,4,True,0,0,0,14755,196,48,6.8,True,4,False,0,0,0,15499,221,55,6.6,False,27.078333333333333,-744,0,0,244,276,-32
BR1_2731691212,7,False,1,1,0,17931,224,68,7.2,True,4,True,0,0,0,15382,215,64,6.8,False,25.645983333333334,2549,3,1,292,279,13
BR1_2675368309,6,False,0,1,0,19278,273,51,7.8,False,8,True,1,0,0,19763,258,59,8.0,True,28.252233333333333,-485,-2,-1,324,317,7
BR1_2674566121,6,True,1,0,0,16398,212,60,7.2,False,9,False,0,0,0,17865,244,56,7.2,True,25.393116666666668,-1467,-3,1,272,300,-28
BR1_2722317312,4,True,0,1,0,18400,242,76,7.4,False,7,False,1,0,0,19129,256,68,7.6,True,27.972733333333334,-729,-3,-1,318,324,-6
BR1_2721279382,11,False,0,0,0,18565,198,36,6.4,True,12,True,0,1,0,18748,172,48,6.6,False,25.818383333333333,-183,-1,0,234,220,14
BR1_2731459099,10,True,1,0,0,18628,192,62,7.2,True,12,False,0,0,0,20808,225,76,7.4,False,29.078483333333335,-2180,-2,1,254,301,-47
BR1_2689203723,6,False,0,0,0,17420,219,48,7.2,False,7,True,1,0,0,17176,177,48,7.0,True,29.051466666666666,244,-1,-1,267,225,42
BR1_2688922960,7,False,0,0,0,16464,214,40,7.0,True,3,True,1,0,0,14353,193,56,6.6,False,25.366433333333333,2111,4,-1,254,249,5
BR1_2731143824,13,True,1,1,2,22975,249,64,7.6,True,3,False,0,0,0,14977,180,48,6.8,False,27.946633333333335,7998,10,1,313,228,85
BR1_2730330035,10,True,1,1,0,19884,221,60,7.2,True,9,False,0,0,0,19247,237,64,7.4,False,29.061833333333333,637,1,1,281,301,-20
BR1_2730309151,9,True,0,0,0,18373,172,60,6.8,False,17,False,1,1,0,21708,222,52,7.0,True,25.98065,-3335,-8,-1,232,274,-42
BR1_2730339247,7,True,0,0,0,17311,205,56,6.8,True,3,False,1,0,0,14760,215,46,6.6,False,27.37325,2551,4,-1,261,261,0
BR1_2730295295,7,False,0,0,0,17240,221,38,7.2,True,10,True,1,1,0,20380,241,80,7.6,False,28.388916666666667,-3140,-3,-1,259,321,-62
BR1_2730086369,3,False,0,0,0,16173,261,60,7.6,False,4,True,1,0,0,17903,257,72,7.6,True,29.375366666666668,-1730,-1,-1,321,329,-8
BR1_2690636865,11,True,0,0,0,18355,226,48,6.8,True,9,False,0,1,0,17484,206,43,6.6,False,26.3739,871,2,0,274,249,25
BR1_2730693420,9,True,1,0,0,19697,221,63,7.4,True,6,False,0,1,0,18570,239,76,7.6,False,29.98235,1127,3,1,284,315,-31
BR1_2695161003,12,True,0,1,0,19949,191,72,7.2,False,5,False,0,0,0,17591,218,64,7.0,True,29.790316666666666,2358,7,0,263,282,-19
BR1_2695101188,10,True,1,0,0,18824,232,52,7.0,True,3,False,0,1,0,15721,186,60,6.6,False,25.933433333333333,3103,7,1,284,246,38
BR1_2726503795,16,False,1,0,0,22903,256,80,7.6,True,12,True,0,0,0,20412,256,48,7.4,False,27.67728333333333,2491,4,1,336,304,32
BR1_2723105624,6,True,0,1,0,18553,271,72,7.4,True,2,False,1,0,0,15108,225,50,7.2,False,29.922716666666666,3445,4,-1,343,275,68
BR1_2729430411,6,False,1,0,0,18031,249,56,7.2,True,8,True,0,1,0,19581,264,52,7.4,False,27.9322,-1550,-2,1,305,316,-11
BR1_2727285863,9,True,0,0,0,19098,218,60,7.0,False,11,False,1,0,0,19670,201,59,7.2,True,29.863033333333334,-572,-2,-1,278,260,18
BR1_2731294339,5,False,0,0,0,17397,173,64,6.8,False,15,True,0,0,0,21571,233,53,7.6,True,27.9041,-4174,-10,0,237,286,-49
BR1_2726050937,7,True,1,0,0,18184,260,56,7.4,False,6,False,0,1,0,18281,214,80,7.8,True,29.641783333333333,-97,1,1,316,294,22
BR1_2716119867,10,True,1,0,0,20258,255,60,7.6,True,10,False,0,0,0,20196,223,71,7.4,False,28.169166666666666,62,0,1,315,294,21
BR1_2731869049,8,True,0,0,0,16290,162,48,6.0,False,10,False,0,0,0,18012,206,50,6.8,True,25.60045,-1722,-2,0,210,256,-46
BR1_2727502087,9,True,0,1,0,19207,245,70,7.6,True,4,False,1,0,0,16114,211,56,6.8,False,29.639233333333333,3093,5,-1,315,267,48
BR1_2729037616,1,False,1,0,0,15206,207,57,7.2,False,9,True,0,1,0,18459,197,64,7.4,True,28.670666666666666,-3253,-8,1,264,261,3
BR1_2728493825,3,False,0,0,0,13495,166,60,6.6,False,8,True,0,0,0,18214,189,56,7.0,True,25.64215,-4719,-5,0,226,245,-19
BR1_2722256162,6,False,0,1,0,16487,202,40,6.8,False,14,True,1,0,0,19075,207,60,7.2,True,25.03175,-2588,-8,-1,242,267,-25
BR1_2731626632,5,False,1,0,0,15807,211,60,7.2,True,6,True,0,1,0,17465,219,80,6.8,False,27.041833333333333,-1658,-1,1,271,299,-28
BR1_2700300290,5,False,0,0,0,17501,269,56,7.4,False,8,True,0,0,0,18446,250,55,7.6,True,27.726416666666665,-945,-3,0,325,305,20
BR1_2726585150,7,True,1,0,0,18654,228,56,7.6,False,9,False,0,0,0,19609,246,60,7.8,True,29.863333333333333,-955,-2,1,284,306,-22
BR1_2724976372,10,False,1,0,0,19830,248,84,8.0,True,3,True,0,1,0,16861,219,63,7.2,False,27.65145,2969,7,1,332,282,50
BR1_2731857847,8,False,1,1,0,19359,241,60,7.4,True,10,True,0,0,0,18816,210,52,7.4,False,28.088283333333333,543,-2,1,301,262,39
BR1_2727219530,6,False,1,0,0,18684,245,62,7.4,False,2,True,0,0,0,16085,274,58,7.4,True,29.073583333333332,2599,4,1,307,332,-25
BR1_2729523917,9,True,0,0,0,18243,189,52,7.2,False,10,False,0,1,0,19942,238,68,7.4,True,29.2421,-1699,-1,0,241,306,-65
BR1_2728594718,9,True,1,0,0,18716,202,51,7.4,True,3,False,0,0,0,16053,239,64,7.2,False,28.177733333333332,2663,6,1,253,303,-50
BR1_2731025536,9,True,0,0,0,19102,235,72,7.4,False,7,False,1,0,0,17554,248,47,7.0,True,29.551333333333332,1548,2,-1,307,295,12
BR1_2726520105,8,True,1,0,0,18029,198,64,7.2,False,6,False,0,0,0,18273,252,51,7.2,True,27.898466666666668,-244,2,1,262,303,-41
BR1_2709957004,7,True,1,0,0,15756,174,40,6.4,False,11,False,0,0,0,19274,225,51,7.0,True,27.279716666666666,-3518,-4,1,214,276,-62
BR1_2709833052,13,False,1,1,0,19921,228,44,7.4,False,8,True,0,0,0,17891,239,36,6.8,True,26.973083333333335,2030,5,1,272,275,-3
BR1_2731715711,10,True,0,0,0,20556,224,52,7.6,False,9,False,0,0,0,19203,211,68,7.0,True,28.975783333333332,1353,1,0,276,279,-3
BR1_2731487602,2,True,0,0,0,15993,232,68,6.8,False,2,False,1,1,0,15120,239,64,7.0,True,26.685683333333333,873,0,-1,300,303,-3
BR1_2731845228,10,True,0,1,0,19534,208,52,7.4,False,9,False,1,0,0,19578,247,53,7.0,True,28.669666666666668,-44,1,-1,260,300,-40
BR1_2731802132,7,False,0,0,0,16019,192,48,6.6,False,7,True,1,0,0,17367,225,64,6.8,True,25.496183333333335,-1348,0,-1,240,289,-49
BR1_2731470210,4,False,0,0,0,15594,200,46,6.6,False,8,True,0,1,0,17513,197,48,6.8,True,27.00775,-1919,-4,0,246,245,1
BR1_2729974125,12,True,0,0,0,19429,211,72,7.0,True,7,False,0,0,0,15941,195,60,6.8,False,26.327733333333335,3488,5,0,283,255,28
BR1_2730251687,9,True,1,0,0,18613,226,52,7.2,True,5,False,0,0,0,15706,185,60,6.8,False,26.558883333333334,2907,4,1,278,245,33
BR1_2730212647,7,False,0,1,0,19132,233,44,7.4,True,11,True,0,0,0,19456,218,60,7.4,False,29.655416666666667,-324,-4,0,277,278,-1
BR1_2729701190,8,True,0,1,0,19549,215,44,6.8,False,12,False,1,0,0,20218,244,44,7.4,True,28.306166666666666,-669,-4,-1,259,288,-29
BR1_2730876010,7,False,0,1,0,16825,183,56,6.6,False,7,True,0,0,0,16374,186,40,6.6,True,26.92195,451,0,0,239,226,13
BR1_2730799784,5,True,1,1,0,18015,240,59,7.2,False,5,False,0,0,0,17787,234,55,7.0,True,28.818966666666668,228,0,1,299,289,10
BR1_2718480463,7,True,0,1,0,19615,249,64,7.4,True,8,False,1,0,0,18075,229,76,7.6,False,29.30705,1540,-1,-1,313,305,8
BR1_2731211351,6,False,0,1,0,17431,225,64,7.2,False,9,True,1,0,0,19128,214,56,7.0,True,29.68045,-1697,-3,-1,289,270,19
BR1_2681121484,12,False,0,0,0,20312,256,40,7.0,False,7,True,0,1,0,17098,196,72,7.0,True,27.28015,3214,5,0,296,268,28
BR1_2679966947,9,False,0,0,0,18216,211,40,7.0,True,4,True,0,0,0,14308,176,43,6.4,False,25.827783333333333,3908,5,0,251,219,32
BR1_2731457691,7,True,1,0,2,19569,261,60,7.4,False,9,False,0,0,0,19391,228,56,7.6,True,27.53555,178,-2,1,321,284,37
BR1_2731447381,6,True,1,0,0,16394,211,40,6.8,False,7,False,0,0,0,17670,227,68,6.8,True,27.197133333333333,-1276,-1,1,251,295,-44
BR1_2731424211,13,True,1,0,0,20803,217,50,7.4,True,11,False,0,0,0,19822,218,60,7.2,False,27.93648333333333,981,2,1,267,278,-11
BR1_2729340005,11,True,0,0,0,19656,238,52,7.2,False,9,False,0,1,0,18385,218,43,7.6,True,28.034966666666666,1271,2,0,290,261,29
BR1_2731353802,7,True,0,1,0,17598,216,52,6.4,False,10,False,1,0,0,17441,183,44,6.8,True,26.057883333333333,157,-3,-1,268,227,41
BR1_2731035580,7,True,0,0,0,15743,194,50,6.4,False,8,False,1,0,0,15908,169,56,6.4,True,25.572216666666666,-165,-1,-1,244,225,19
BR1_2731021528,6,False,1,1,0,18368,255,56,7.4,True,3,True,0,0,0,16515,214,60,7.4,False,28.2437,1853,3,1,311,274,37
BR1_2727604627,7,True,0,0,0,16888,202,60,6.8,False,11,False,1,0,0,19431,233,48,7.2,True,26.08675,-2543,-4,-1,262,281,-19
BR1_2727575194,2,False,0,0,0,14244,189,64,6.6,False,8,True,1,1,0,18085,247,48,7.0,True,25.961166666666667,-3841,-6,-1,253,295,-42
BR1_2731884151,8,False,0,1,0,18751,206,42,7.0,True,8,True,1,0,0,18652,236,57,7.2,False,29.464,99,0,-1,248,293,-45
BR1_2731874684,8,True,0,1,0,16102,179,60,6.8,True,5,False,0,0,0,15621,209,48,6.6,False,27.080016666666666,481,3,0,239,257,-18
BR1_2719994504,5,True,0,0,0,16188,203,51,6.8,False,8,False,1,0,0,17067,200,48,7.0,True,27.0893,-879,-3,-1,254,248,6
BR1_2704848684,2,True,1,0,0,15031,232,60,7.0,True,3,False,0,1,0,15550,245,56,7.0,False,26.736416666666667,-519,-1,1,292,301,-9
BR1_2729881415,8,True,0,1,0,17722,205,68,7.0,False,5,False,1,0,0,15346,171,56,6.8,True,26.288216666666667,2376,3,-1,273,227,46
BR1_2726054554,11,False,1,0,0,19738,208,80,7.8,True,15,True,0,0,0,23182,263,54,7.6,False,28.795033333333333,-3444,-4,1,288,317,-29
BR1_2731916838,13,False,1,1,0,21080,239,80,7.4,True,7,True,0,0,0,17540,217,44,7.0,False,29.643833333333333,3540,6,1,319,261,58
BR1_2731375245,11,True,1,0,0,19024,229,48,7.2,True,4,False,0,0,0,14716,179,40,6.4,False,26.723466666666667,4308,7,1,277,219,58
BR1_2731373018,11,False,1,0,0,17960,178,40,7.0,False,11,True,0,1,0,19040,222,48,7.2,True,29.907333333333334,-1080,0,1,218,270,-52
BR1_2731723813,8,False,1,0,0,19219,240,72,7.6,True,4,True,0,0,0,16144,257,56,7.4,False,29.691483333333334,3075,4,1,312,313,-1
BR1_2731147128,9,True,0,0,0,18080,199,48,7.0,False,9,False,1,0,0,18423,225,56,7.0,True,26.16935,-343,0,-1,247,281,-34
BR1_2730794624,11,True,0,0,0,18860,189,62,7.0,False,13,False,1,0,0,20130,198,56,6.6,True,26.13175,-1270,-2,-1,251,254,-3
BR1_2731927067,7,False,0,1,0,16355,211,60,6.8,False,4,True,0,0,0,15964,204,56,6.6,True,26.1498,391,3,0,271,260,11
BR1_2731712719,6,True,1,0,0,16609,225,48,6.8,True,1,False,0,0,0,14404,208,64,6.6,False,26.10305,2205,5,1,273,272,1
BR1_2731762718,6,False,1,0,1,15697,200,56,7.0,True,9,True,0,1,0,18872,213,56,7.0,False,25.89625,-3175,-3,1,256,269,-13
BR1_2731733926,2,False,0,1,0,17377,265,64,7.4,False,8,True,1,0,0,17670,252,51,7.6,True,27.525316666666665,-293,-6,-1,329,303,26
BR1_2722175292,10,True,1,0,0,19750,254,72,7.4,True,11,False,0,1,0,17616,139,44,6.6,False,27.668266666666668,2134,-1,1,326,183,143
BR1_2722134995,5,True,0,0,0,15857,179,47,6.6,False,11,False,0,1,0,19015,217,53,6.6,True,26.481383333333333,-3158,-6,0,226,270,-44
BR1_2703873057,4,False,1,0,0,17507,247,64,7.6,False,6,True,0,1,0,18692,260,60,7.2,True,29.41285,-1185,-2,1,311,320,-9
BR1_2729160015,6,False,1,0,0,16326,214,60,7.2,False,3,True,0,1,0,14925,217,40,6.8,True,25.540366666666667,1401,3,1,274,257,17
BR1_2729374639,7,False,1,0,0,17442,213,64,7.0,False,7,True,0,0,0,16856,221,46,6.6,True,26.544966666666667,586,0,1,277,267,10
BR1_2729863150,10,False,1,1,0,19634,234,52,7.6,True,9,True,0,0,0,19279,241,55,7.2,False,28.596166666666665,355,1,1,286,296,-10
BR1_2729831517,9,False,0,0,0,18181,230,52,7.2,False,3,True,1,1,0,14663,180,60,7.0,True,26.992,3518,6,-1,282,240,42
BR1_2711342731,11,True,1,1,0,21110,223,68,7.4,True,12,False,0,0,0,20474,196,51,6.8,False,29.5884,636,-1,1,291,247,44
BR1_2711339166,10,False,0,1,0,17620,198,36,6.6,True,9,True,0,0,0,16906,179,42,6.8,False,25.13918333333333,714,1,0,234,221,13
BR1_2731541638,3,False,1,0,0,14486,186,56,6.8,False,6,True,0,1,0,17655,234,48,7.0,True,26.4066,-3169,-3,1,242,282,-40
BR1_2731288774,3,False,1,1,0,16592,244,72,7.6,False,4,True,0,0,0,17657,292,63,7.6,True,29.943483333333333,-1065,-1,1,316,355,-39
BR1_2731229270,3,False,1,1,0,14681,193,54,6.6,False,8,True,0,0,0,17334,218,65,7.2,True,26.0745,-2653,-5,1,247,283,-36
BR1_2724378271,7,False,0,0,0,18621,228,46,7.0,False,12,True,0,0,0,20886,257,74,7.4,True,29.6523,-2265,-5,0,274,331,-57
BR1_2723073482,5,False,1,0,0,17310,209,76,7.6,True,5,True,0,1,0,17289,255,76,7.6,False,29.632883333333332,21,0,1,285,331,-46
BR1_2729868767,8,False,1,1,0,17720,200,56,7.0,True,8,True,0,0,0,16404,164,48,7.0,False,25.46905,1316,0,1,256,212,44
BR1_2731955183,7,False,0,0,0,16793,207,44,6.8,True,6,True,1,1,0,15820,187,52,6.4,False,25.908333333333335,973,1,-1,251,239,12
BR1_2731303959,8,False,1,0,0,18847,241,56,7.4,False,7,True,0,1,0,19609,231,60,7.4,True,28.425433333333334,-762,1,1,297,291,6
BR1_2730657224,7,False,0,0,1,18425,259,40,7.2,True,4,True,0,1,0,18949,227,64,7.2,False,28.589933333333335,-524,3,0,299,291,8
BR1_2727541898,11,True,0,0,0,19236,213,46,7.2,True,5,False,0,1,0,18038,214,69,7.2,False,29.9889,1198,6,0,259,283,-24
BR1_2731659174,7,True,1,0,0,18688,250,60,7.4,True,8,False,0,1,0,17799,203,67,7.2,False,28.17578333333333,889,-1,1,310,270,40
BR1_2731631463,12,True,1,0,0,20305,240,56,7.4,True,8,False,0,1,0,18548,222,56,7.4,False,28.6501,1757,4,1,296,278,18
BR1_2718861378,7,True,1,0,0,16722,232,36,6.8,False,6,False,0,0,0,16940,243,64,7.0,True,25.628816666666665,-218,1,1,268,307,-39
BR1_2718783426,10,True,1,0,1,20004,206,47,7.4,False,5,False,0,1,0,17275,232,56,7.4,True,28.088633333333334,2729,5,1,253,288,-35
BR1_2731471188,8,False,0,0,0,19172,223,69,7.2,True,15,True,1,0,0,21346,196,54,7.4,False,29.203466666666667,-2174,-7,-1,292,250,42
BR1_2722418532,6,False,0,0,0,17298,247,48,7.0,True,8,True,1,0,0,18241,233,48,7.0,False,27.772433333333332,-943,-2,-1,295,281,14
BR1_2721995934,16,False,1,0,0,22018,220,56,7.4,True,9,True,0,1,0,20011,248,64,7.2,False,28.6305,2007,7,1,276,312,-36
BR1_2729734937,9,True,1,0,0,17383,205,44,6.8,False,6,False,0,1,0,15701,185,56,6.4,True,26.07815,1682,3,1,249,241,8
BR1_2731341307,17,True,1,0,1,21654,191,44,7.0,True,8,False,0,0,0,17649,171,44,6.8,False,26.54005,4005,9,1,235,215,20
BR1_2731319785,13,False,0,0,0,20527,227,68,7.6,True,7,True,0,0,0,17827,213,44,7.0,False,29.44595,2700,6,0,295,257,38
BR1_2702955305,5,False,1,0,0,16741,210,55,6.8,True,8,True,0,0,0,18815,263,53,7.6,False,28.3349,-2074,-3,1,265,316,-51
BR1_2731843181,8,True,0,0,0,17033,198,48,6.8,False,12,False,1,1,0,19723,202,64,7.0,True,25.658666666666665,-2690,-4,-1,246,266,-20
BR1_2729042641,15,True,0,0,0,18551,167,49,6.6,False,12,False,1,0,0,21275,213,50,6.8,True,25.204433333333334,-2724,3,-1,216,263,-47
BR1_2729920221,7,True,0,1,0,19414,262,64,7.6,False,10,False,1,0,0,20557,248,75,8.0,True,28.588083333333334,-1143,-3,-1,326,323,3
BR1_2729889441,11,True,0,1,1,21717,264,59,7.8,False,4,False,1,0,0,16175,217,67,7.2,True,29.97415,5542,7,-1,323,284,39
BR1_2730627389,10,True,0,1,0,21154,271,77,7.8,False,8,False,0,0,0,18239,230,46,7.4,True,28.917416666666668,2915,2,0,348,276,72
BR1_2730603947,6,False,0,1,0,18528,263,67,7.6,False,11,True,1,0,0,21056,239,52,7.8,True,29.792333333333332,-2528,-5,-1,330,291,39
BR1_2730512427,13,True,1,0,0,18507,180,52,7.2,True,4,False,0,0,0,14895,174,48,6.4,False,25.729733333333332,3612,9,1,232,222,10
BR1_2730797745,8,False,1,1,0,20160,274,72,7.8,True,3,True,0,0,0,15233,210,48,7.2,False,28.074816666666667,4927,5,1,346,258,88
BR1_2727117300,6,True,0,0,0,17063,233,51,7.0,True,4,False,0,0,0,16550,238,56,7.2,False,28.7372,513,2,0,284,294,-10
BR1_2704995691,1,False,1,0,0,14278,187,70,6.8,True,10,True,0,0,0,20396,267,60,7.6,False,29.64335,-6118,-9,1,257,327,-70
BR1_2704860612,4,True,0,1,0,18567,297,54,7.6,False,6,False,1,0,0,18683,264,62,7.6,True,29.296316666666666,-116,-2,-1,351,326,25
BR1_2704857627,9,True,1,0,0,19409,259,64,7.8,True,10,False,0,0,0,19105,229,52,7.4,False,27.921233333333333,304,-1,1,323,281,42
BR1_2731769679,4,False,0,0,0,16240,225,52,6.8,False,8,True,0,1,0,17400,225,68,7.4,True,26.9888,-1160,-4,0,277,293,-16
BR1_2731260427,8,False,0,0,0,18470,203,58,7.0,True,9,True,0,1,0,18805,216,48,7.2,False,29.420233333333332,-335,-1,0,261,264,-3
BR1_2730613876,4,True,1,0,0,16920,237,60,7.4,True,4,False,0,0,0,17519,253,64,7.2,False,27.54035,-599,0,1,297,317,-20
BR1_2731687795,4,True,1,0,0,17488,254,60,7.2,False,6,False,0,0,0,17325,249,48,7.2,True,28.41048333333333,163,-2,1,314,297,17
BR1_2731320478,4,False,0,0,0,16121,226,48,6.8,False,2,True,0,0,0,15220,194,60,6.8,True,25.18345,901,2,0,274,254,20
BR1_2730848403,8,False,0,0,0,18368,217,44,7.2,False,10,True,0,0,0,19910,218,56,7.2,True,29.131266666666665,-1542,-2,0,261,274,-13
BR1_2720863486,6,True,0,0,0,17955,217,71,7.2,False,13,False,1,1,0,22397,261,72,7.8,True,29.4299,-4442,-7,-1,288,333,-45
BR1_2731573908,1,False,0,0,0,13936,206,58,7.0,False,6,True,1,0,0,17453,255,74,7.2,True,25.042733333333334,-3517,-5,-1,264,329,-65
BR1_2731081880,9,True,0,1,0,18934,212,56,7.8,True,8,False,1,0,0,17870,220,64,7.6,False,29.738716666666665,1064,1,-1,268,284,-16
BR1_2730378134,7,False,1,1,0,19208,223,78,7.4,False,7,True,0,0,0,18908,253,54,7.4,True,29.028916666666667,300,0,1,301,307,-6
BR1_2726521357,6,False,0,1,0,16897,231,52,7.2,False,10,True,1,0,1,22421,238,80,7.4,True,28.419816666666666,-5524,-4,-1,283,318,-35
BR1_2723038814,12,False,0,0,0,18889,205,44,6.8,True,6,True,0,0,0,15298,189,48,6.4,False,25.654033333333334,3591,6,0,249,237,12
BR1_2729386336,1,False,0,0,0,14566,222,64,7.0,False,4,True,1,1,0,15731,210,56,7.0,True,26.901766666666667,-1165,-3,-1,286,266,20
BR1_2729947587,3,False,0,1,0,16207,205,75,7.2,True,3,True,1,0,0,16450,259,42,7.2,False,28.5779,-243,0,-1,280,301,-21
BR1_2731781481,5,False,1,1,1,19358,258,60,7.2,True,5,True,0,0,0,16741,215,60,7.4,False,28.086716666666668,2617,0,1,318,275,43
BR1_2731424885,7,True,0,1,0,19841,262,56,7.4,True,4,False,0,0,0,17000,216,68,7.4,False,28.3176,2841,3,0,318,284,34
BR1_2730809771,11,False,0,1,0,19767,214,49,7.0,True,7,True,1,0,0,18235,228,61,7.0,False,27.88233333333333,1532,4,-1,263,289,-26
BR1_2725123829,10,False,1,0,0,19235,227,60,7.4,False,10,True,0,0,0,18937,226,60,7.2,True,29.7562,298,0,1,287,286,1
BR1_2715891060,9,True,0,1,0,18899,238,53,7.4,True,8,False,0,0,0,15923,183,50,6.6,False,26.27165,2976,1,0,291,233,58
BR1_2731644181,5,False,0,0,0,16678,235,52,7.6,False,3,True,1,1,0,16720,233,60,7.6,True,29.83585,-42,2,-1,287,293,-6
BR1_2731272942,6,False,0,1,0,18244,209,54,7.4,False,8,True,0,0,0,19939,238,57,7.4,True,29.57685,-1695,-2,0,263,295,-32
BR1_2731820333,4,False,1,0,0,14904,197,60,6.4,True,9,True,0,1,0,19227,233,64,7.0,False,26.472216666666668,-4323,-5,1,257,297,-40
BR1_2686604592,4,True,0,0,0,15702,222,52,7.0,False,6,False,1,0,0,16217,237,63,7.2,True,26.569133333333333,-515,-2,-1,274,300,-26
BR1_2686288967,6,False,0,0,0,17655,209,67,7.2,False,11,True,1,0,0,20787,258,76,7.8,True,29.7955,-3132,-5,-1,276,334,-58
BR1_2726409465,7,True,1,0,0,18901,253,60,7.4,False,2,False,0,1,0,16522,231,72,7.2,True,28.482783333333334,2379,5,1,313,303,10
BR1_2727421154,7,False,0,1,0,16764,200,68,7.0,False,6,True,0,0,0,16904,210,52,6.6,True,25.928016666666668,-140,1,0,268,262,6
BR1_2731399228,7,False,1,0,0,18339,214,72,7.2,True,6,True,0,1,0,17425,209,64,7.2,False,28.099883333333334,914,1,1,286,273,13
BR1_2731607305,11,False,0,0,0,17570,175,29,6.0,True,12,True,1,1,0,19260,156,44,6.0,False,27.160283333333332,-1690,-1,-1,204,200,4
BR1_2731120470,8,False,0,1,0,17626,206,72,7.2,True,7,True,1,0,0,16977,221,44,6.6,False,27.0303,649,1,-1,278,265,13
BR1_2729635898,8,True,0,0,0,18787,250,80,8.0,True,5,False,1,1,0,17752,247,76,7.6,False,28.902566666666665,1035,3,-1,330,323,7
BR1_2729613326,7,True,1,0,0,18327,242,68,7.4,True,8,False,0,0,0,19359,226,60,7.4,False,29.366366666666668,-1032,-1,1,310,286,24
BR1_2730727553,10,True,0,0,0,19267,256,59,7.2,False,12,False,0,0,0,20056,226,52,7.2,True,27.665066666666668,-789,-2,0,315,278,37
BR1_2731932251,6,True,0,1,0,19477,254,72,7.8,True,3,False,0,0,0,17094,228,68,7.2,False,29.573983333333334,2383,3,0,326,296,30
BR1_2731921044,7,False,0,1,0,16612,208,42,7.0,False,6,True,1,0,0,15684,186,69,6.6,True,26.47455,928,1,-1,250,255,-5
BR1_2731908275,9,True,1,1,0,18132,203,62,7.2,True,4,False,0,0,0,15312,205,52,6.8,False,25.946783333333332,2820,5,1,265,257,8
BR1_2731424705,5,False,1,0,0,15877,212,60,7.2,False,7,True,0,1,0,17626,233,67,7.0,True,26.2363,-1749,-2,1,272,300,-28
BR1_2728666958,9,True,0,0,0,18217,220,48,7.4,True,7,False,0,0,0,18451,242,36,7.4,False,29.1253,-234,2,0,268,278,-10
BR1_2731703054,2,False,0,0,0,14273,197,56,6.6,False,9,True,1,0,0,17753,239,56,7.0,True,26.392566666666667,-3480,-7,-1,253,295,-42
BR1_2731618218,13,True,0,1,0,20754,202,64,7.4,True,5,False,0,0,0,17223,236,44,7.2,False,29.807816666666668,3531,8,0,266,280,-14
BR1_2730886553,6,False,0,1,0,16303,208,64,7.0,False,6,True,1,0,0,15974,205,52,6.8,True,27.360583333333334,329,0,-1,272,257,15
BR1_2730885214,6,True,1,0,0,16235,213,56,6.8,True,3,False,0,0,0,13924,200,56,6.8,False,27.438116666666666,2311,3,1,269,256,13
BR1_2731765388,8,True,0,0,0,20003,265,75,7.4,True,11,False,1,0,0,20337,239,68,7.6,False,29.683716666666665,-334,-3,-1,340,307,33
BR1_2723856868,6,False,0,0,0,17055,225,59,7.4,False,9,True,0,1,1,19505,217,45,7.4,True,27.601583333333334,-2450,-3,0,284,262,22
BR1_2723819717,7,True,1,0,0,16261,186,44,6.4,False,10,False,0,1,0,18347,205,44,6.8,True,26.9754,-2086,-3,1,230,249,-19
BR1_2724150738,20,True,0,0,0,21402,203,40,7.2,False,10,False,1,0,0,21132,256,58,7.4,True,27.831033333333334,270,10,-1,243,314,-71
BR1_2718133668,8,False,0,0,0,16193,172,36,6.6,False,14,True,1,0,0,19958,191,56,7.0,True,25.891883333333332,-3765,-6,-1,208,247,-39
BR1_2729650865,11,True,0,1,0,20581,267,64,7.4,False,8,False,1,0,0,18852,235,72,7.6,True,27.512616666666666,1729,3,-1,331,307,24
BR1_2730569487,11,True,1,0,0,20285,253,72,7.4,True,5,False,0,1,0,16971,213,48,7.4,False,29.333633333333335,3314,6,1,325,261,64
BR1_2731641298,5,True,0,0,0,17561,251,52,7.2,True,2,False,1,1,0,15758,190,64,7.0,False,27.823766666666668,1803,3,-1,303,254,49
BR1_2731417166,7,False,1,0,0,20085,251,52,7.6,True,9,True,0,1,0,21176,263,84,7.8,False,27.577733333333335,-1091,-2,1,303,347,-44
BR1_2731235612,8,False,0,1,0,18297,229,56,7.4,False,11,True,1,0,0,19509,244,48,7.4,True,28.392566666666667,-1212,-3,-1,285,292,-7
BR1_2731927894,2,False,0,1,0,16378,236,72,7.8,False,5,True,1,0,0,18237,276,60,7.6,True,27.5021,-1859,-3,-1,308,336,-28
BR1_2731898901,4,False,1,1,0,15580,197,68,6.8,True,5,True,0,0,0,16386,215,52,6.8,False,26.010633333333335,-806,-1,1,265,267,-2
BR1_2731343931,6,True,1,0,0,18110,242,64,7.2,True,4,False,0,0,0,17081,251,64,7.6,False,28.4101,1029,2,1,306,315,-9
BR1_2728233395,8,False,0,0,0,18638,221,76,7.6,False,10,True,1,1,0,19868,231,56,7.6,True,28.182,-1230,-2,-1,297,287,10
BR1_2731555801,12,True,0,0,0,18106,200,30,6.8,True,8,False,1,0,0,17248,193,60,6.8,False,25.938283333333334,858,4,-1,230,253,-23
BR1_2731545373,7,False,1,0,0,16529,218,44,6.8,False,5,True,0,1,0,17314,222,79,7.0,True,26.186033333333334,-785,2,1,262,301,-39
BR1_2731954684,2,False,0,0,0,16267,257,56,7.4,False,7,True,1,1,1,21779,244,79,7.8,True,29.137933333333333,-5512,-5,-1,313,323,-10
BR1_2731438253,5,False,0,0,0,17607,211,49,7.0,True,13,True,1,1,0,22608,254,63,7.6,False,29.929583333333333,-5001,-8,-1,260,317,-57
BR1_2730424868,8,False,0,0,0,17934,210,40,7.4,False,10,True,1,1,0,20375,244,76,7.4,True,29.447233333333333,-2441,-2,-1,250,320,-70
BR1_2731441577,7,False,1,0,0,18069,237,55,7.4,True,9,True,0,0,0,19222,223,64,7.4,False,29.461583333333333,-1153,-2,1,292,287,5
BR1_2730335720,7,False,1,0,0,17445,245,52,6.8,True,5,True,0,1,0,15924,220,56,6.8,False,26.258583333333334,1521,2,1,297,276,21
BR1_2730087861,4,True,0,1,0,16370,190,60,6.8,True,11,False,1,0,0,18030,232,56,7.0,False,26.244183333333332,-1660,-7,-1,250,288,-38
BR1_2729445270,5,True,0,1,0,15864,190,52,7.0,False,4,False,1,0,0,16723,247,48,7.4,True,26.69835,-859,1,-1,242,295,-53
BR1_2728310737,6,True,0,1,0,18448,260,60,7.4,True,8,False,1,0,0,20211,270,80,8.0,False,28.564133333333334,-1763,-2,-1,320,350,-30
BR1_2718872456,8,True,0,0,0,16122,191,44,6.4,False,8,False,0,0,0,17341,206,56,6.8,True,27.155116666666668,-1219,0,0,235,262,-27
BR1_2727343893,16,True,1,0,0,22030,229,72,7.4,False,10,False,0,0,0,20356,218,48,7.2,True,29.247533333333333,1674,6,1,301,266,35
BR1_2731592674,11,True,1,1,0,19371,197,64,7.2,False,8,False,0,0,0,17834,239,48,7.0,True,25.603883333333332,1537,3,1,261,287,-26
BR1_2731572511,2,False,1,0,0,15708,219,64,7.0,False,8,True,0,0,0,18932,240,52,6.8,True,25.352733333333333,-3224,-6,1,283,292,-9
BR1_2731302307,2,False,0,0,0,15258,201,56,6.6,False,12,True,0,0,0,19160,225,52,7.0,True,26.6696,-3902,-10,0,257,277,-20
BR1_2731278794,9,True,1,1,0,18359,197,64,6.8,True,13,False,0,0,0,19488,189,36,6.8,False,25.31736666666667,-1129,-4,1,261,225,36
BR1_2729416163,8,True,0,0,0,17257,210,44,6.8,False,6,False,0,0,0,16837,203,56,6.6,True,26.88993333333333,420,2,0,254,259,-5
BR1_2729225742,5,False,1,0,0,17355,246,64,7.2,False,8,True,0,1,0,19282,223,59,7.6,True,28.114483333333332,-1927,-3,1,310,282,28
BR1_2729216384,7,False,0,0,0,18174,203,48,7.0,False,7,True,1,1,0,19644,268,63,7.8,True,29.067766666666667,-1470,0,-1,251,331,-80
BR1_2728762729,7,True,0,0,0,16939,220,44,6.6,True,4,False,1,1,0,16273,217,68,7.2,False,26.360916666666668,666,3,-1,264,285,-21
BR1_2724777484,13,True,1,0,0,22006,240,68,7.6,True,5,False,0,0,0,18035,232,59,7.0,False,29.07035,3971,8,1,308,291,17
BR1_2720023400,2,False,0,0,0,14318,197,48,6.4,False,5,True,1,0,0,15948,227,52,6.8,True,25.21335,-1630,-3,-1,245,279,-34
BR1_2729724402,9,False,0,0,0,17396,177,53,6.4,False,11,True,0,0,0,21488,256,54,7.2,True,29.778566666666666,-4092,-2,0,230,310,-80
BR1_2731769445,12,True,1,1,0,19256,180,56,7.0,True,10,False,0,0,0,16653,176,52,6.8,False,26.155966666666668,2603,2,1,236,228,8
BR1_2731182851,5,False,1,0,0,16259,220,59,7.2,True,5,True,0,0,0,16378,220,52,6.8,False,25.61305,-119,0,1,279,272,7
BR1_2730795002,4,False,0,0,0,15355,193,56,6.8,False,13,True,0,1,1,23244,246,68,7.8,True,27.569,-7889,-9,0,249,314,-65
BR1_2731560030,8,False,1,1,0,16654,212,44,6.4,True,8,True,0,0,0,17023,179,64,6.6,False,25.663116666666667,-369,0,1,256,243,13
BR1_2731543280,8,True,0,0,0,18809,220,68,7.2,False,11,False,1,1,0,19624,202,68,7.2,True,29.492,-815,-3,-1,288,270,18
BR1_2731120063,6,True,0,0,0,17692,234,60,7.0,False,6,False,1,1,0,16980,224,46,7.0,True,28.05675,712,0,-1,294,270,24
BR1_2731033436,7,False,1,0,0,17773,241,72,7.2,True,6,True,0,0,0,16151,227,44,6.8,False,25.018316666666667,1622,1,1,313,271,42
BR1_2729641720,4,False,0,0,0,14770,208,64,6.8,True,7,True,0,0,0,16549,217,47,6.8,False,26.537466666666667,-1779,-3,0,272,264,8
BR1_2729447432,13,False,1,0,0,19533,215,48,7.0,True,8,True,0,0,0,16779,192,44,6.6,False,25.981916666666667,2754,5,1,263,236,27
BR1_2729059994,15,False,1,0,0,20697,207,64,7.4,True,2,True,0,0,0,15804,243,52,6.8,False,28.2194,4893,13,1,271,295,-24
BR1_2731797387,17,True,0,0,0,22971,231,72,7.8,True,9,False,0,0,0,18929,227,56,7.2,False,29.158616666666667,4042,8,0,303,283,20
BR1_2731781143,5,False,0,0,0,16092,215,52,6.8,False,7,True,0,0,0,17075,225,60,7.2,True,26.8824,-983,-2,0,267,285,-18
BR1_2731512733,5,False,0,0,0,16317,240,60,7.2,False,2,True,1,1,0,15773,214,72,7.0,True,27.128683333333335,544,3,-1,300,286,14
BR1_2730990693,4,False,0,0,0,16359,217,62,7.0,True,5,True,0,1,0,16578,223,56,7.0,False,26.800583333333332,-219,-1,0,279,279,0
BR1_2729394504,12,False,1,0,1,18818,237,48,7.2,True,10,True,0,0,0,19111,183,68,6.8,False,28.92025,-293,2,1,285,251,34
BR1_2729376163,9,False,1,0,0,20409,275,68,7.8,True,7,True,0,1,0,18150,208,64,7.4,False,28.750766666666667,2259,2,1,343,272,71
BR1_2729273925,6,True,1,0,0,17338,242,60,7.0,False,7,False,0,0,0,16512,209,48,6.8,True,27.15295,826,-1,1,302,257,45
BR1_2731805682,5,False,1,0,0,16340,238,60,6.8,True,6,True,0,1,0,16749,209,52,6.6,False,27.236466666666665,-409,-1,1,298,261,37
BR1_2731266207,4,True,0,0,0,16291,207,63,7.2,False,12,False,1,0,0,20018,256,63,7.6,True,29.5105,-3727,-8,-1,270,319,-49
BR1_2731842646,2,True,1,0,0,14640,210,60,6.6,False,7,False,0,0,0,17863,237,58,6.8,True,25.692233333333334,-3223,-5,1,270,295,-25
BR1_2731827852,14,True,0,0,0,19676,188,54,6.6,True,8,False,1,0,0,16956,183,52,6.6,False,26.1676,2720,6,-1,242,235,7
BR1_2731660431,12,True,0,0,0,19585,230,40,6.8,True,4,False,0,0,0,15170,179,56,7.0,False,25.980583333333332,4415,8,0,270,235,35
BR1_2731518236,4,True,1,0,0,16798,256,59,7.4,True,4,False,0,0,0,16788,221,52,7.2,False,29.63085,10,0,1,315,273,42
BR1_2730212970,7,True,1,0,0,17946,197,60,7.4,True,11,False,0,1,0,20590,278,60,7.6,False,28.300866666666668,-2644,-4,1,257,338,-81
BR1_2730180870,10,False,0,0,0,18912,226,44,7.0,True,8,True,1,0,0,18245,194,60,7.0,False,29.08215,667,2,-1,270,254,16
BR1_2729610663,3,False,0,0,0,17116,266,64,7.2,False,7,True,1,1,1,20533,271,64,7.8,True,28.066516666666665,-3417,-4,-1,330,335,-5
BR1_2707112221,6,False,1,0,0,16871,174,64,7.2,False,7,True,0,0,0,17616,229,64,7.4,True,29.21575,-745,-1,1,238,293,-55
BR1_2717769205,13,True,0,1,0,20654,238,52,7.6,False,11,False,1,0,0,19970,243,71,7.2,True,27.916033333333335,684,2,-1,290,314,-24
BR1_2717765176,7,False,0,0,0,17042,204,48,6.6,True,4,True,0,0,0,16042,232,48,6.6,False,25.050433333333334,1000,3,0,252,280,-28
BR1_2731521533,4,True,0,1,0,16089,235,49,7.0,False,11,False,1,0,0,21006,237,62,7.0,True,29.079116666666668,-4917,-7,-1,284,299,-15
BR1_2726780884,7,False,0,0,0,19546,265,65,7.6,True,10,True,0,0,0,19199,217,58,7.6,False,28.33565,347,-3,0,330,275,55
BR1_2731637131,3,False,1,1,0,17273,265,61,7.0,True,3,True,0,0,0,16388,247,52,7.2,False,29.166766666666668,885,0,1,326,299,27
BR1_2731462388,10,False,1,0,0,19098,232,63,7.6,False,7,True,0,1,1,20038,238,56,7.2,True,29.66225,-940,3,1,295,294,1
BR1_2730623580,5,False,0,1,0,17983,223,52,7.2,False,8,True,1,0,0,18600,225,68,7.6,True,29.04295,-617,-3,-1,275,293,-18
BR1_2727725588,6,False,1,1,0,17758,237,52,7.2,True,3,True,0,0,0,16257,238,68,7.0,False,27.59345,1501,3,1,289,306,-17
BR1_2722448208,14,False,1,1,0,21340,246,76,8.0,False,4,True,0,0,0,16999,212,72,7.2,True,28.262783333333335,4341,10,1,322,284,38
BR1_2731789341,13,True,0,0,0,21696,233,84,7.8,True,10,False,1,1,0,19299,209,44,7.2,False,28.267316666666666,2397,3,-1,317,253,64
BR1_2731764720,7,True,0,1,0,16387,195,48,6.8,False,9,False,0,0,0,17597,213,48,6.6,True,26.536183333333334,-1210,-2,0,243,261,-18
BR1_2731242360,9,True,1,1,0,17682,203,60,7.2,True,7,False,0,0,0,16872,202,63,7.0,False,26.682116666666666,810,2,1,263,265,-2
BR1_2731211758,8,True,1,1,1,21093,237,44,7.4,True,11,False,0,0,0,19897,279,56,7.6,False,29.05826666666667,1196,-3,1,281,335,-54
BR1_2731192022,10,True,1,0,0,17772,236,40,6.8,True,8,False,0,1,0,16759,210,44,6.8,False,26.57346666666667,1013,2,1,276,254,22
BR1_2729743414,8,False,0,0,0,18829,273,52,7.4,False,9,True,0,1,0,20548,256,68,7.8,True,29.459833333333332,-1719,-1,0,325,324,1
BR1_2730359963,12,True,1,0,1,21368,261,56,7.8,True,5,False,0,0,0,17975,258,76,7.2,False,29.903483333333334,3393,7,1,317,334,-17
BR1_2730142521,7,False,0,1,0,17149,231,52,7.0,False,9,True,0,0,0,17862,224,48,6.8,True,27.0357,-713,-2,0,283,272,11
BR1_2730110575,8,True,0,0,0,17507,216,43,6.8,True,8,False,1,0,0,18541,226,64,6.8,False,25.618916666666667,-1034,0,-1,259,290,-31
BR1_2723361511,3,False,0,0,0,14813,214,42,6.6,True,10,True,1,0,0,18979,208,72,7.0,False,27.040966666666666,-4166,-7,-1,256,280,-24
BR1_2724219721,9,False,0,0,0,18736,238,64,7.2,False,7,True,0,1,0,18305,229,68,7.6,True,29.6652,431,2,0,302,297,5
BR1_2724217249,4,False,0,0,0,14005,152,44,6.2,False,12,True,0,0,0,19563,218,60,7.0,True,25.58305,-5558,-8,0,196,278,-82
BR1_2729694470,10,True,1,1,0,20742,233,72,7.8,True,7,False,0,0,0,18183,242,64,7.4,False,29.663983333333334,2559,3,1,305,306,-1
BR1_2731701727,10,True,1,0,0,17970,217,44,7.2,False,11,False,0,1,0,20669,230,67,7.6,True,29.293216666666666,-2699,-1,1,261,297,-36
BR1_2731631704,6,False,0,0,0,15896,215,43,6.8,False,9,True,0,0,0,17776,215,58,6.6,True,26.6717,-1880,-3,0,258,273,-15
BR1_2730142445,5,False,0,0,0,15432,219,42,6.8,False,15,True,1,0,0,20331,228,55,7.2,True,25.10235,-4899,-10,-1,261,283,-22
BR1_2727639832,14,True,1,0,0,21638,234,60,7.4,True,6,False,0,0,0,18618,251,56,7.2,False,28.177066666666665,3020,8,1,294,307,-13
BR1_2731947303,7,False,1,0,0,18627,261,64,7.4,False,6,True,0,0,0,17783,247,56,7.4,True,28.72315,844,1,1,325,303,22
BR1_2731911176,4,True,1,0,0,15090,189,52,6.6,False,10,False,0,1,0,18182,205,76,7.2,True,25.03505,-3092,-6,1,241,281,-40
BR1_2725809184,4,False,0,0,0,14824,183,44,6.4,False,10,True,1,1,0,18766,211,40,6.6,True,27.481616666666667,-3942,-6,-1,227,251,-24
BR1_2721439957,5,False,0,0,0,15629,193,48,6.6,True,13,True,1,0,0,20881,261,55,7.2,False,25.178433333333334,-5252,-8,-1,241,316,-75
BR1_2731700115,3,False,0,0,0,14664,214,52,6.8,False,3,True,1,0,0,15788,218,72,7.2,True,25.992133333333335,-1124,0,-1,266,290,-24
BR1_2731845896,6,False,0,0,0,17637,227,52,7.4,True,6,True,1,1,0,17100,190,75,7.2,False,28.898016666666667,537,0,-1,279,265,14
BR1_2682306352,12,True,1,1,0,20130,237,52,7.6,True,7,False,0,0,0,18518,226,59,7.6,False,29.637016666666668,1612,5,1,289,285,4
BR1_2726057181,13,True,0,1,1,22419,250,62,7.4,True,2,False,0,0,0,14562,209,51,7.0,False,27.888666666666666,7857,11,0,312,260,52
BR1_2721651824,2,False,1,1,1,15804,199,64,6.6,False,6,True,0,0,1,17983,232,44,7.0,True,26.41815,-2179,-4,1,263,276,-13
BR1_2728680894,9,False,1,0,0,19334,227,90,7.6,True,7,True,0,1,0,17335,197,48,6.8,False,28.3436,1999,2,1,317,245,72
BR1_2728327075,11,True,0,0,0,18333,232,79,7.4,True,5,False,0,0,0,16171,213,44,7.0,False,25.074333333333332,2162,6,0,311,257,54
BR1_2731832697,10,True,1,0,0,20657,259,44,7.4,True,5,False,0,1,0,17956,265,52,7.4,False,29.468066666666665,2701,5,1,303,317,-14
BR1_2729156578,13,True,1,0,0,20629,183,47,6.4,False,16,False,0,1,0,21550,195,48,7.4,True,29.20985,-921,-3,1,230,243,-13
BR1_2729137834,11,True,0,0,0,17566,191,40,6.8,True,7,False,1,0,0,15792,177,32,6.6,False,27.4474,1774,4,-1,231,209,22
BR1_2728948960,9,False,0,0,0,16335,170,36,6.6,False,10,True,0,1,0,17693,174,56,6.8,True,26.799016666666667,-1358,-1,0,206,230,-24
BR1_2729623575,8,True,0,1,0,18524,214,56,7.2,True,9,False,1,0,0,18732,219,60,7.4,False,29.02405,-208,-1,-1,270,279,-9
BR1_2731505495,4,True,0,0,0,16833,250,60,7.6,False,8,False,1,1,0,19627,249,64,7.6,True,27.7266,-2794,-4,-1,310,313,-3
BR1_2715144402,8,False,1,0,0,17705,190,63,7.2,True,3,True,0,0,0,16370,222,56,7.0,False,29.966416666666667,1335,5,1,253,278,-25
BR1_2714519007,6,True,1,1,0,19184,253,68,7.4,True,4,False,0,0,0,16262,231,52,7.6,False,28.173966666666665,2922,2,1,321,283,38
BR1_2714497697,3,True,0,0,0,14865,226,46,6.8,False,6,False,1,0,0,17267,232,52,6.8,True,25.6132,-2402,-3,-1,272,284,-12
BR1_2731711179,4,False,0,0,0,15689,205,64,7.0,False,8,True,1,0,0,17021,199,60,6.6,True,25.2382,-1332,-4,-1,269,259,10
BR1_2731682399,11,True,1,0,0,18428,220,56,7.0,False,6,False,0,0,0,17514,201,59,7.0,True,29.440066666666667,914,5,1,276,260,16
BR1_2731737921,6,False,1,0,0,17804,251,62,7.4,False,6,True,0,1,0,19386,261,84,7.8,True,28.647816666666667,-1582,0,1,313,345,-32
BR1_2731920643,5,False,1,1,0,15608,191,51,6.6,False,7,True,0,0,0,16986,219,48,6.8,True,25.28145,-1378,-2,1,242,267,-25
BR1_2731399658,7,False,0,1,0,16003,208,52,6.6,True,12,True,1,0,0,18723,206,68,7.0,False,25.46538333333333,-2720,-5,-1,260,274,-14
BR1_2731190920,8,True,1,0,0,17708,234,68,7.0,True,4,False,0,0,0,15748,227,55,7.0,False,25.935983333333333,1960,4,1,302,282,20
BR1_2713422732,4,True,1,1,0,17386,244,61,7.4,False,5,False,0,0,0,18358,257,70,7.6,True,28.519983333333332,-972,-1,1,305,327,-22
BR1_2713386188,9,False,1,0,0,16704,170,59,6.4,False,9,True,0,0,0,17947,219,47,6.6,True,27.00965,-1243,0,1,229,266,-37
BR1_2713371275,3,False,0,0,0,15060,196,47,6.4,True,4,True,1,0,0,15893,219,48,6.6,False,26.6229,-833,-1,-1,243,267,-24
BR1_2714150271,8,True,0,0,0,18050,206,52,7.0,True,7,False,0,0,0,16770,204,56,6.8,False,27.106916666666667,1280,1,0,258,260,-2
BR1_2713673162,14,True,1,1,0,22330,218,55,7.4,False,11,False,0,0,0,21714,270,52,7.8,True,28.854066666666668,616,3,1,273,322,-49
BR1_2731708477,7,True,0,1,0,17009,233,48,7.0,True,11,False,1,0,0,19661,263,63,7.2,False,27.194566666666667,-2652,-4,-1,281,326,-45
BR1_2703075716,7,False,1,0,0,18082,238,77,7.4,True,7,True,0,0,0,17261,228,65,7.2,False,29.27713333333333,821,0,1,315,293,22
BR1_2731362123,7,False,1,0,0,18980,254,66,7.2,True,9,True,0,0,0,18562,227,49,7.4,False,29.414883333333332,418,-2,1,320,276,44
BR1_2731321676,9,True,0,1,0,17868,194,72,6.8,True,7,False,0,0,0,15860,210,36,6.8,False,26.892966666666666,2008,2,0,266,246,20
BR1_2720767115,5,True,0,0,0,17487,268,75,7.8,False,2,False,0,0,0,15847,249,48,7.4,True,29.265183333333333,1640,3,0,343,297,46
BR1_2725262214,6,True,0,0,0,15812,162,48,6.4,False,5,False,1,0,0,17603,236,72,7.0,True,26.387083333333333,-1791,1,-1,210,308,-98
BR1_2725241927,16,False,0,1,1,24677,205,64,7.0,True,16,True,1,0,0,21037,185,44,6.8,False,29.0772,3640,0,-1,269,229,40
BR1_2707157928,2,True,1,1,0,15642,218,64,7.0,True,6,False,0,0,0,17222,241,56,7.4,False,26.517416666666666,-1580,-4,1,282,297,-15
BR1_2707104156,5,False,0,1,0,18280,236,69,7.6,False,11,True,1,0,0,20439,240,58,7.4,True,28.561816666666665,-2159,-6,-1,305,298,7
BR1_2731874994,4,False,0,0,0,15426,214,60,7.0,False,7,True,0,0,0,17713,273,44,7.0,True,26.0676,-2287,-3,0,274,317,-43
BR1_2731674284,5,True,0,0,0,15008,192,44,6.2,False,10,False,0,0,0,18303,178,60,6.8,True,26.9935,-3295,-5,0,236,238,-2
BR1_2731648500,4,False,0,0,0,16783,238,62,7.4,False,12,True,1,0,0,20802,267,64,7.4,True,28.513683333333333,-4019,-8,-1,300,331,-31
BR1_2731746898,6,True,1,0,0,18854,276,56,7.8,False,4,False,0,0,0,18023,275,72,7.6,True,27.822533333333332,831,2,1,332,347,-15
BR1_2714220456,8,False,1,1,0,16585,197,48,6.6,False,7,True,0,0,0,16559,190,60,6.8,True,27.135283333333334,26,1,1,245,250,-5
BR1_2694699731,2,False,0,0,0,14952,215,48,6.4,False,7,True,1,0,0,16508,218,44,6.8,True,25.683766666666667,-1556,-5,-1,263,262,1
BR1_2694625168,3,True,1,1,0,15523,194,64,7.0,False,6,False,0,0,0,17970,249,64,7.2,True,25.817166666666665,-2447,-3,1,258,313,-55
BR1_2729692750,1,False,1,0,0,15327,236,82,7.2,False,4,True,0,0,0,17801,253,52,7.4,True,27.7001,-2474,-3,1,318,305,13
BR1_2731836851,5,True,1,0,0,16416,222,52,6.8,False,4,False,0,1,0,15754,204,60,6.8,True,26.18,662,1,1,274,264,10
BR1_2729865708,14,True,1,1,0,21825,240,60,7.6,True,5,False,0,0,0,17891,222,64,7.2,False,28.055683333333334,3934,9,1,300,286,14
BR1_2729465849,11,True,0,1,0,20851,219,60,7.4,False,16,False,1,0,0,21859,227,74,7.6,True,28.270583333333335,-1008,-5,-1,279,301,-22
BR1_2727040500,9,True,0,0,0,18646,227,56,7.0,False,11,False,0,1,0,20006,245,56,7.6,True,28.330183333333334,-1360,-2,0,283,301,-18
BR1_2720902481,10,False,0,0,0,17563,225,48,6.8,False,8,True,1,0,0,17733,224,48,6.6,True,25.02015,-170,2,-1,273,272,1
BR1_2716127423,6,True,0,0,0,17963,233,64,7.0,True,10,False,1,0,0,18694,229,48,7.2,False,28.45243333333333,-731,-4,-1,297,277,20
BR1_2715928269,5,False,0,1,0,17075,207,80,7.0,False,8,True,1,0,0,17534,195,44,7.0,True,26.00635,-459,-3,-1,287,239,48
BR1_2731953324,7,False,1,0,0,17458,200,68,7.0,True,12,True,0,1,0,18764,216,48,7.2,False,25.293616666666665,-1306,-5,1,268,264,4
BR1_2731907649,9,True,1,1,0,18265,205,64,7.0,True,6,False,0,0,0,17110,246,0,6.8,False,28.24605,1155,3,1,269,246,23
BR1_2730370927,6,False,0,1,0,16445,220,64,6.8,True,6,True,1,0,0,16711,206,52,6.8,False,26.979866666666666,-266,0,-1,284,258,26
BR1_2730111171,9,True,0,0,0,17370,228,48,6.8,False,10,False,1,1,0,18046,200,51,6.8,True,27.004016666666665,-676,-1,-1,276,251,25
BR1_2729002405,2,False,0,0,0,15391,173,64,6.8,False,10,True,1,0,0,19660,272,56,7.4,True,29.813483333333334,-4269,-8,-1,237,328,-91
BR1_2728965098,4,False,0,0,0,15075,201,68,7.0,False,6,True,0,1,0,17211,233,52,7.0,True,26.1093,-2136,-2,0,269,285,-16
BR1_2728904956,6,False,0,0,0,18036,229,48,7.0,False,9,True,0,1,0,19027,202,56,7.2,True,29.181333333333335,-991,-3,0,277,258,19
BR1_2731917781,8,True,1,0,0,17895,241,54,7.0,False,3,False,0,0,0,14800,182,51,6.8,True,26.137,3095,5,1,295,233,62
BR1_2731629994,5,True,0,0,0,16696,211,52,6.8,False,7,False,1,0,0,16675,212,48,7.0,True,26.77,21,-2,-1,263,260,3
BR1_2731567430,14,True,0,0,1,22712,265,63,7.8,False,6,False,1,0,0,17051,201,60,7.2,True,28.206116666666667,5661,8,-1,328,261,67
BR1_2729323981,13,False,0,0,0,19092,172,48,6.8,False,11,True,1,0,0,18551,193,64,7.2,True,26.242783333333332,541,2,-1,220,257,-37
BR1_2729308703,6,False,0,1,0,15703,203,40,6.8,False,7,True,0,0,0,17255,251,52,7.0,True,26.722966666666668,-1552,-1,0,243,303,-60
BR1_2699641646,4,True,1,1,0,15583,221,44,6.8,True,1,False,0,0,0,13485,202,48,6.4,False,25.86265,2098,3,1,265,250,15
BR1_2731265082,4,False,0,0,0,14523,214,52,6.6,False,9,True,0,0,0,17928,200,52,7.0,True,26.824616666666667,-3405,-5,0,266,252,14
BR1_2731954594,6,True,1,1,0,17331,242,64,7.2,True,4,False,0,0,0,15317,218,48,6.8,False,26.17866666666667,2014,2,1,306,266,40
BR1_2730459366,7,False,0,0,0,15692,167,56,6.2,False,12,True,1,1,0,19946,246,60,7.4,True,26.378866666666667,-4254,-5,-1,223,306,-83
BR1_2731682075,3,False,0,0,0,16973,243,64,7.4,False,4,True,1,0,0,17936,295,56,7.4,True,28.462033333333334,-963,-1,-1,307,351,-44
BR1_2731227579,8,True,0,1,0,19532,244,63,7.8,True,6,False,0,0,0,17856,264,48,7.4,False,28.724566666666668,1676,2,0,307,312,-5
BR1_2731171315,13,True,1,1,0,20259,235,52,7.6,True,5,False,0,0,0,17408,236,48,7.0,False,28.4281,2851,8,1,287,284,3
BR1_2731140844,11,True,0,1,0,20550,242,56,7.8,True,10,False,1,0,0,19457,267,64,7.4,False,29.783683333333332,1093,1,-1,298,331,-33
BR1_2731657731,6,False,1,1,0,15671,184,59,6.8,False,12,True,0,0,0,18447,202,48,6.6,True,26.329816666666666,-2776,-6,1,243,250,-7
BR1_2730789741,10,False,1,0,0,19575,201,48,7.2,True,11,True,0,1,0,20519,237,76,7.6,False,27.51171666666667,-944,-1,1,249,313,-64
BR1_2730064159,3,True,1,0,0,16317,253,61,7.0,True,0,False,0,1,0,14233,245,50,7.0,False,27.249666666666666,2084,3,1,314,295,19
BR1_2722920234,7,False,0,1,0,17678,231,49,7.4,True,6,True,1,0,0,16083,203,54,7.0,False,25.659433333333332,1595,1,-1,280,257,23
BR1_2730272386,15,True,1,0,0,20235,197,55,6.8,True,6,False,0,1,0,16452,183,68,6.6,False,25.157516666666666,3783,9,1,252,251,1
BR1_2731211405,5,True,0,0,0,16461,230,66,7.0,True,3,False,0,0,0,14565,193,52,6.4,False,26.282383333333332,1896,2,0,296,245,51
BR1_2729963459,6,False,1,1,0,16175,196,63,6.6,True,10,True,0,0,0,17992,211,52,6.8,False,25.939733333333333,-1817,-4,1,259,263,-4
BR1_2729898576,6,True,0,1,0,15958,188,54,6.6,True,6,False,1,0,0,15764,177,60,6.8,False,27.499083333333335,194,0,-1,242,237,5
BR1_2731917788,3,False,1,0,0,16656,237,76,7.4,False,6,True,0,1,0,18416,254,68,7.4,True,28.501916666666666,-1760,-3,1,313,322,-9
BR1_2728232993,7,False,0,0,0,19664,238,48,7.4,True,7,True,0,1,0,17788,223,64,7.0,False,28.557133333333333,1876,0,0,286,287,-1
BR1_2726803887,6,True,1,1,0,17257,239,48,7.0,True,4,False,0,0,0,15039,184,56,6.4,False,26.296233333333333,2218,2,1,287,240,47
BR1_2731182493,5,True,0,1,0,15771,188,56,6.8,True,8,False,1,0,0,16899,183,73,6.8,False,27.4273,-1128,-3,-1,244,256,-12
BR1_2731064045,6,False,0,0,0,17353,178,65,7.0,False,12,True,1,0,0,19658,226,66,7.8,True,28.672,-2305,-6,-1,243,292,-49
BR1_2726461990,8,True,0,0,0,18903,271,52,7.4,True,1,False,1,0,0,16286,251,68,7.6,False,27.849333333333334,2617,7,-1,323,319,4
BR1_2731596469,7,True,0,0,0,18416,235,64,7.2,False,6,False,1,1,0,18134,255,72,7.6,True,29.000616666666666,282,1,-1,299,327,-28
BR1_2730354297,7,False,0,1,0,18569,238,50,7.2,False,11,True,1,0,0,20136,229,62,7.2,True,28.523366666666668,-1567,-4,-1,288,291,-3
BR1_2728724453,5,True,0,1,0,15691,204,52,6.4,True,7,False,1,0,0,16853,220,56,6.6,False,25.050483333333332,-1162,-2,-1,256,276,-20
BR1_2728712198,10,False,0,0,0,18472,199,50,6.8,False,14,True,0,0,0,20869,247,64,7.4,True,28.507283333333334,-2397,-4,0,249,311,-62
BR1_2728496136,7,False,0,0,0,19459,248,68,7.4,True,5,True,0,0,0,17462,241,63,7.4,False,29.8207,1997,2,0,316,304,12
BR1_2699810894,7,True,1,0,0,17400,208,48,7.0,True,3,False,0,1,0,17611,261,72,7.4,False,29.614066666666666,-211,4,1,256,333,-77
BR1_2728015481,4,True,1,1,0,18164,280,60,7.6,True,2,False,0,0,0,14571,198,47,6.8,False,28.058316666666666,3593,2,1,340,245,95
BR1_2725895998,6,True,0,0,0,17416,231,44,7.2,False,14,False,0,0,0,21680,276,60,7.6,True,29.394816666666667,-4264,-8,0,275,336,-61
BR1_2725265740,4,True,1,1,0,18442,267,76,7.6,True,6,False,0,0,0,17833,270,45,7.8,False,27.569216666666666,609,-2,1,343,315,28
BR1_2730627113,5,False,0,0,0,15374,200,44,6.6,False,9,True,0,0,0,17709,208,41,7.0,True,27.195266666666665,-2335,-4,0,244,249,-5
BR1_2731829113,8,True,1,0,0,18523,231,56,7.0,False,10,False,0,1,0,20151,238,68,7.6,True,28.42645,-1628,-2,1,287,306,-19
BR1_2731632298,3,False,0,0,0,14197,211,52,6.6,False,7,True,1,1,0,17131,230,52,7.0,True,27.250666666666667,-2934,-4,-1,263,282,-19
BR1_2729980178,14,True,1,1,1,22878,203,48,6.8,False,10,False,0,0,0,19508,189,72,7.4,True,28.237766666666666,3370,4,1,251,261,-10
BR1_2675584744,7,True,0,1,0,16954,230,60,7.2,True,5,False,0,0,0,16921,229,68,7.2,False,27.106666666666666,33,2,0,290,297,-7
BR1_2730209707,7,False,0,1,0,18274,264,56,7.6,False,7,True,0,0,0,17023,228,48,7.4,True,28.5974,1251,0,0,320,276,44
BR1_2731708505,7,True,0,0,0,16366,188,48,6.6,False,8,False,0,0,0,19239,225,64,7.0,True,25.623,-2873,-1,0,236,289,-53
BR1_2731683532,12,False,0,0,0,18023,216,56,6.8,True,9,True,1,0,0,18343,228,60,6.6,False,27.205483333333333,-320,3,-1,272,288,-16
BR1_2731855596,12,True,1,0,0,20011,244,72,7.4,True,4,False,0,1,0,16802,210,60,7.2,False,28.202166666666667,3209,8,1,316,270,46
BR1_2705258245,7,True,1,0,0,16629,197,60,6.6,True,4,False,0,1,0,15413,199,52,6.4,False,26.721866666666667,1216,3,1,257,251,6
BR1_2731269802,6,False,0,0,1,19482,239,68,7.2,False,8,True,1,1,0,18601,252,72,7.6,True,28.71145,881,-2,-1,307,324,-17
BR1_2726158315,6,False,1,0,0,18178,250,56,7.2,False,8,True,0,1,0,19185,251,58,7.6,True,29.827483333333333,-1007,-2,1,306,309,-3
BR1_2728730412,6,True,0,0,0,15390,141,51,6.4,False,8,False,0,1,0,16511,176,32,6.4,True,26.994216666666667,-1121,-2,0,192,208,-16
BR1_2720353328,6,True,0,0,0,16600,203,60,6.8,False,7,False,1,0,0,18487,242,63,7.0,True,25.957066666666666,-1887,-1,-1,263,305,-42
BR1_2730264955,8,False,1,0,0,16369,172,36,5.8,False,18,True,0,0,0,22047,225,40,6.6,True,26.187416666666667,-5678,-10,1,208,265,-57
BR1_2730015984,11,False,0,0,0,20265,241,59,7.4,True,8,True,1,0,0,19715,253,80,7.6,False,27.60005,550,3,-1,300,333,-33
BR1_2713449008,11,False,0,0,0,20004,245,76,7.8,False,6,True,1,1,0,18929,253,44,7.4,True,27.949683333333333,1075,5,-1,321,297,24
BR1_2713422958,8,True,1,0,0,17890,216,64,7.0,False,12,False,0,1,0,20342,261,52,7.0,True,29.381,-2452,-4,1,280,313,-33
BR1_2727999880,13,False,1,1,0,21063,183,75,7.2,True,10,True,0,0,0,18121,180,44,6.8,False,28.079066666666666,2942,3,1,258,224,34
BR1_2731741944,6,False,1,0,0,16636,218,52,6.8,False,11,True,0,1,1,20257,213,62,7.2,True,26.645533333333333,-3621,-5,1,270,275,-5
BR1_2731788560,5,False,0,1,0,16359,229,47,6.4,False,6,True,1,0,0,16856,202,48,6.8,True,27.10065,-497,-1,-1,276,250,26
BR1_2731758918,7,True,1,0,0,17892,205,64,7.0,True,9,False,0,1,0,19610,225,64,7.4,False,29.14275,-1718,-2,1,269,289,-20
BR1_2731479608,6,False,1,0,1,18735,225,52,7.2,False,6,True,0,1,1,19936,250,68,7.4,True,28.0649,-1201,0,1,277,318,-41
BR1_2728736290,5,False,0,0,0,15398,212,55,6.6,False,8,True,1,1,0,18564,239,52,6.6,True,26.516983333333332,-3166,-3,-1,267,291,-24
BR1_2730353561,10,False,1,0,0,18947,212,56,7.0,True,5,True,0,0,0,15847,221,44,6.8,False,27.47655,3100,5,1,268,265,3
BR1_2731941570,10,False,0,0,0,19106,213,54,7.2,True,9,True,1,1,0,19656,253,52,7.6,False,27.89985,-550,1,-1,267,305,-38
BR1_2731931241,10,True,1,0,0,19866,279,52,7.6,True,6,False,0,0,0,17909,238,60,7.2,False,28.44305,1957,4,1,331,298,33
BR1_2731527157,15,True,1,0,0,20921,250,40,7.6,False,7,False,0,0,0,17684,223,51,7.2,True,29.086,3237,8,1,290,274,16
BR1_2720510349,14,True,1,0,0,20121,228,44,7.0,True,4,False,0,0,0,15087,199,56,6.8,False,26.990716666666668,5034,10,1,272,255,17
BR1_2730881665,11,True,1,1,0,19448,226,68,7.4,True,1,False,0,0,0,14195,221,35,6.2,False,25.4556,5253,10,1,294,256,38
BR1_2730873840,9,True,0,0,0,17647,207,52,6.8,False,8,False,0,1,0,17691,220,52,7.2,True,27.12105,-44,1,0,259,272,-13
BR1_2730580729,7,False,0,0,0,16945,157,52,7.0,False,16,True,1,0,1,21445,204,56,7.4,True,28.526916666666665,-4500,-9,-1,209,260,-51
BR1_2731950644,6,False,0,1,0,16541,204,56,7.2,False,5,True,1,0,0,16444,202,59,7.0,True,25.763233333333332,97,1,-1,260,261,-1
BR1_2731514373,9,True,1,1,0,18671,242,56,7.4,True,5,False,0,0,0,17675,253,57,7.4,False,29.871,996,4,1,298,310,-12
BR1_2731878174,11,False,1,1,0,19764,206,56,7.4,False,13,True,0,0,0,20414,187,51,7.0,True,28.9887,-650,-2,1,262,238,24
BR1_2731868472,9,False,1,1,0,19373,230,55,7.4,True,6,True,0,0,0,16964,221,52,7.0,False,28.739233333333335,2409,3,1,285,273,12
BR1_2731855717,10,True,1,1,0,20827,237,60,7.6,True,8,False,0,0,0,18056,196,56,7.2,False,28.909816666666668,2771,2,1,297,252,45
BR1_2731293789,9,True,0,1,0,20554,260,68,7.6,True,6,False,1,0,0,17076,217,64,7.0,False,28.088966666666668,3478,3,-1,328,281,47
BR1_2731244399,10,False,1,0,0,18507,193,52,6.8,True,7,True,0,1,0,17149,199,48,6.8,False,25.624383333333334,1358,3,1,245,247,-2
BR1_2730367904,7,True,0,0,0,17224,207,57,7.0,True,6,False,1,0,0,16388,209,45,6.8,False,26.817533333333333,836,1,-1,264,254,10
BR1_2698749039,5,True,0,1,0,17988,203,54,7.4,True,8,False,0,0,0,18515,212,60,7.2,False,28.742216666666668,-527,-3,0,257,272,-15
BR1_2694826761,8,True,0,0,0,16817,203,57,7.2,False,7,False,1,0,0,17301,179,50,6.6,True,26.917633333333335,-484,1,-1,260,229,31
BR1_2727611154,16,True,0,0,0,21423,215,68,7.4,False,11,False,1,0,0,20923,225,72,7.6,True,29.944783333333334,500,5,-1,283,297,-14
BR1_2727515090,9,True,0,1,0,16361,189,44,7.0,False,6,False,1,0,0,15057,193,60,6.6,True,26.87013333333333,1304,3,-1,233,253,-20
BR1_2729711467,12,False,1,0,0,19416,198,56,7.0,True,11,True,0,0,1,18807,220,12,6.6,False,26.624583333333334,609,1,1,254,232,22
BR1_2729685453,8,False,0,1,1,18921,202,60,7.4,False,11,True,1,0,0,21281,239,71,7.4,True,29.59225,-2360,-3,-1,262,310,-48
BR1_2702961764,7,True,1,0,0,17076,220,48,6.6,True,0,False,0,0,0,14000,218,56,6.8,False,26.229966666666666,3076,7,1,268,274,-6
BR1_2729625067,9,True,0,0,0,18260,235,49,7.2,True,5,False,0,0,0,14226,160,49,6.0,False,25.040916666666668,4034,4,0,284,209,75
BR1_2728444150,9,True,1,0,0,19987,264,55,7.2,False,11,False,0,1,0,19596,241,63,7.2,True,27.684033333333332,391,-2,1,319,304,15
BR1_2730683163,8,False,1,0,0,19462,233,64,7.4,True,6,True,0,0,0,18081,249,64,7.2,False,28.707533333333334,1381,2,1,297,313,-16
BR1_2730645657,8,True,0,0,0,18106,233,60,7.2,True,7,False,0,0,0,17079,241,56,7.4,False,25.99685,1027,1,0,293,297,-4
BR1_2697205916,10,True,1,0,0,17776,221,40,7.0,True,3,False,0,1,0,16169,229,86,7.2,False,25.891983333333332,1607,7,1,261,315,-54
BR1_2731762230,8,False,1,0,0,19258,217,64,7.2,False,5,True,0,1,0,18117,259,56,7.4,True,28.61231666666667,1141,3,1,281,315,-34
BR1_2731150414,11,True,0,0,1,21175,250,64,7.2,False,10,False,0,0,0,20138,189,68,7.0,True,28.856716666666667,1037,1,0,314,257,57
BR1_2729906470,7,True,0,0,0,17459,230,64,6.8,True,5,False,1,1,0,16345,240,68,7.2,False,25.49275,1114,2,-1,294,308,-14
BR1_2731838616,15,True,1,1,0,21443,196,68,7.4,True,6,False,0,0,0,16281,202,48,6.6,False,25.401683333333335,5162,9,1,264,250,14
BR1_2723596425,6,False,0,1,0,17176,222,52,7.0,True,8,True,1,0,0,17632,237,56,7.0,False,26.660583333333335,-456,-2,-1,274,293,-19
BR1_2723573653,9,False,1,0,0,17016,189,48,6.6,False,8,True,0,1,0,18420,226,59,7.0,True,25.6123,-1404,1,1,237,285,-48
BR1_2731779488,2,False,0,1,0,14725,210,60,6.4,False,9,True,1,0,0,16150,181,48,6.6,True,26.499133333333333,-1425,-7,-1,270,229,41
BR1_2731271475,8,False,1,0,0,16842,141,52,6.2,False,13,True,0,1,0,19084,187,52,6.6,True,26.868183333333334,-2242,-5,1,193,239,-46
BR1_2730762519,8,True,1,0,0,17347,220,64,7.2,True,10,False,0,0,0,19129,212,52,7.2,False,29.5938,-1782,-2,1,284,264,20
BR1_2731493682,9,False,0,1,0,18017,193,47,6.6,False,13,True,1,0,0,19375,188,56,6.6,True,25.42425,-1358,-4,-1,240,244,-4
BR1_2731603700,5,False,0,0,0,16977,198,60,7.2,False,8,True,0,1,0,18246,230,44,7.2,True,27.9593,-1269,-3,0,258,274,-16
BR1_2731564818,13,True,1,0,1,21131,226,56,7.6,True,8,False,0,0,0,17994,201,56,7.0,False,27.729266666666668,3137,5,1,282,257,25
BR1_2731225176,8,False,1,0,0,17908,224,72,7.4,False,7,True,0,0,0,19055,272,60,7.6,True,29.120783333333332,-1147,1,1,296,332,-36
BR1_2686928522,9,True,0,0,0,18173,230,52,7.0,True,8,False,1,0,0,16745,213,56,7.0,False,25.01275,1428,1,-1,282,269,13
BR1_2686860469,8,True,0,0,0,17584,242,54,7.6,False,7,False,1,1,0,18937,244,68,7.4,True,29.133483333333334,-1353,1,-1,296,312,-16
BR1_2686826836,9,False,0,1,1,19804,197,63,7.2,False,13,True,1,0,0,22679,275,56,7.4,True,28.646983333333335,-2875,-4,-1,260,331,-71
BR1_2731781797,8,False,1,0,0,19310,260,56,7.6,False,10,True,0,1,0,19655,219,64,7.4,True,27.607583333333334,-345,-2,1,316,283,33
BR1_2731750544,6,False,0,0,0,17461,262,61,7.6,False,9,True,1,0,0,17848,201,68,7.2,True,29.43505,-387,-3,-1,323,269,54
BR1_2731835252,18,True,0,1,0,22168,221,52,7.4,False,9,False,0,0,0,19132,229,64,7.2,True,28.04468333333333,3036,9,0,273,293,-20
BR1_2731244149,7,True,1,0,0,16497,174,64,7.0,True,7,False,0,1,0,16850,211,48,7.0,False,25.98415,-353,0,1,238,259,-21
BR1_2731680982,7,True,1,0,0,18684,249,60,7.4,True,3,False,0,1,0,16972,252,56,7.2,False,28.039833333333334,1712,4,1,309,308,1
BR1_2730662259,14,True,1,0,0,18910,188,58,6.4,True,3,False,0,1,0,14592,180,65,6.2,False,25.43035,4318,11,1,246,245,1
BR1_2730460631,6,True,1,0,0,17554,223,76,7.2,True,3,False,0,0,0,15474,227,60,7.0,False,25.252833333333335,2080,3,1,299,287,12
BR1_2685890494,13,True,0,0,0,20064,255,40,7.0,True,5,False,0,0,0,14802,182,51,6.6,False,26.3931,5262,8,0,295,233,62
BR1_2717542791,10,False,1,0,0,18411,198,56,7.4,False,13,True,0,0,0,20448,226,40,7.4,True,28.308416666666666,-2037,-3,1,254,266,-12
BR1_2708125161,8,True,1,1,0,17391,224,44,6.6,True,4,False,0,0,0,15639,210,60,6.8,False,27.4912,1752,4,1,268,270,-2
BR1_2708045362,9,False,0,0,0,17901,220,47,6.8,True,9,True,1,0,0,18606,222,62,7.0,False,26.981066666666667,-705,0,-1,267,284,-17
BR1_2724726206,10,True,1,0,0,19549,234,63,7.4,True,7,False,0,0,0,17293,225,52,7.4,False,29.276433333333333,2256,3,1,297,277,20
BR1_2724719384,11,True,0,1,0,21184,237,64,7.4,True,4,False,0,0,0,16085,188,48,6.8,False,29.7542,5099,7,0,301,236,65
BR1_2724709771,6,True,0,0,0,16149,236,72,7.2,True,2,False,1,0,0,14817,202,72,6.6,False,25.69386666666667,1332,4,-1,308,274,34
BR1_2731557500,11,True,1,1,0,20778,258,71,8.0,True,2,False,0,0,0,15560,263,49,7.4,False,29.013716666666667,5218,9,1,329,312,17
BR1_2731533577,10,True,0,1,0,20642,230,60,7.4,False,7,False,1,0,0,19200,222,64,7.0,True,28.534166666666668,1442,3,-1,290,286,4
BR1_2730949839,10,False,0,0,0,19090,226,52,7.2,False,9,True,1,1,0,20399,225,59,7.2,True,29.155083333333334,-1309,1,-1,278,284,-6
BR1_2731945473,12,True,1,0,0,21448,243,56,7.8,True,7,False,0,1,0,19214,253,68,7.6,False,28.183416666666666,2234,5,1,299,321,-22
BR1_2731927806,9,True,1,1,0,19930,281,60,7.8,True,3,False,0,0,0,16570,251,59,7.6,False,29.52253333333333,3360,6,1,341,310,31
BR1_2726282574,6,False,1,1,0,17994,209,52,7.2,True,9,True,0,0,0,19182,271,45,7.4,False,28.8413,-1188,-3,1,261,316,-55
BR1_2729106567,15,True,1,0,0,20729,164,60,6.6,True,8,False,0,0,0,17670,162,52,6.4,False,28.40615,3059,7,1,224,214,10
BR1_2731513258,4,True,1,0,0,15169,196,52,7.0,True,5,False,0,1,0,15841,210,48,6.8,False,26.86765,-672,-1,1,248,258,-10
BR1_2726065508,2,False,0,0,0,14602,229,48,6.8,False,7,True,1,1,0,17428,210,68,7.0,True,25.92815,-2826,-5,-1,277,278,-1
BR1_2731720036,9,True,1,0,0,17742,200,54,6.6,False,6,False,0,0,0,15443,162,44,6.4,True,25.87595,2299,3,1,254,206,48
BR1_2731602447,11,True,0,0,0,18741,227,56,7.0,True,6,False,0,0,0,15284,204,43,7.0,False,25.928216666666668,3457,5,0,283,247,36
BR1_2731772170,5,False,1,0,0,16418,213,40,6.8,False,7,True,0,1,0,18565,208,68,7.4,True,29.80145,-2147,-2,1,253,276,-23
BR1_2722075287,7,True,1,1,0,19286,236,67,7.2,False,7,False,0,0,0,18903,223,80,7.4,True,29.607716666666665,383,0,1,303,303,0
BR1_2731638566,7,True,0,0,0,17135,208,60,6.8,False,5,False,0,0,0,15710,208,40,6.8,True,26.194516666666665,1425,2,0,268,248,20
BR1_2725316551,18,False,0,0,0,22451,228,63,7.4,True,12,True,0,0,0,17983,170,40,6.2,False,26.652466666666665,4468,6,0,291,210,81
BR1_2731836219,4,False,1,1,0,17838,244,76,7.8,True,3,True,0,0,0,16388,272,48,7.6,False,28.9943,1450,1,1,320,320,0
BR1_2729878056,5,True,0,0,0,17271,241,54,7.4,True,7,False,1,0,0,19420,265,76,7.6,False,27.958566666666666,-2149,-2,-1,295,341,-46
BR1_2729861627,8,True,0,0,0,18663,262,51,7.4,False,9,False,1,0,0,19082,239,68,7.2,True,28.429833333333335,-419,-1,-1,313,307,6
BR1_2729242552,16,True,1,1,1,24057,237,60,7.4,True,7,False,0,0,0,19750,254,50,7.2,False,28.032516666666666,4307,9,1,297,304,-7
BR1_2731736198,7,False,1,1,0,17308,235,52,7.4,True,4,True,0,0,0,17087,257,48,7.2,False,27.93873333333333,221,3,1,287,305,-18
BR1_2731875412,4,False,0,0,0,16587,219,40,7.0,False,12,True,1,0,0,21700,285,44,7.4,True,29.438383333333334,-5113,-8,-1,259,329,-70
BR1_2731255194,3,False,0,0,0,16589,251,47,7.2,False,5,True,0,1,0,18462,244,84,7.4,True,29.3334,-1873,-2,0,298,328,-30
BR1_2730231931,4,False,0,0,0,15994,198,47,6.8,False,7,True,0,1,0,19160,257,72,7.6,True,28.671366666666668,-3166,-3,0,245,329,-84
BR1_2729731441,7,False,0,0,0,17195,217,49,6.8,True,4,True,0,1,0,14702,177,46,6.6,False,25.775183333333334,2493,3,0,266,223,43
BR1_2727096605,8,False,1,0,0,18391,238,50,7.0,False,7,True,0,1,0,19227,234,56,7.4,True,28.67585,-836,1,1,288,290,-2
BR1_2727082077,7,False,1,1,0,17469,198,40,6.6,False,11,True,0,0,0,18195,205,55,7.0,True,25.4479,-726,-4,1,238,260,-22
BR1_2731381470,7,False,1,1,1,19569,251,44,7.2,True,6,True,0,0,0,17599,216,63,7.0,False,28.046983333333333,1970,1,1,295,279,16
BR1_2729084899,11,False,1,1,0,17840,178,48,6.6,True,8,True,0,0,0,17012,212,51,6.8,False,26.384983333333334,828,3,1,226,263,-37
BR1_2729961403,11,True,1,0,1,21638,278,60,7.6,False,5,False,0,1,0,17739,245,65,7.0,True,28.65435,3899,6,1,338,310,28
BR1_2730590263,6,True,1,0,0,15958,197,60,6.6,False,4,False,0,1,0,16295,212,44,6.8,True,25.0172,-337,2,1,257,256,1
BR1_2729458244,12,False,1,1,0,19681,226,48,7.4,True,9,True,0,0,0,19150,218,51,7.4,False,28.04445,531,3,1,274,269,5
BR1_2729433404,8,False,0,1,0,18621,257,60,7.6,False,5,True,1,0,0,17909,264,68,7.6,True,28.892516666666666,712,3,-1,317,332,-15
BR1_2729408333,11,True,0,1,0,19984,250,53,7.2,True,7,False,1,0,0,18456,245,48,7.0,False,29.8948,1528,4,-1,303,293,10
BR1_2730666774,6,False,0,0,0,16755,200,40,6.6,False,7,True,0,0,0,16025,218,44,6.8,True,26.784683333333334,730,-1,0,240,262,-22
BR1_2731642848,2,False,1,0,0,16246,231,59,7.2,False,8,True,0,1,0,20881,281,64,7.8,True,29.613266666666668,-4635,-6,1,290,345,-55
BR1_2731546884,5,True,0,0,0,15567,183,43,6.4,False,12,False,1,0,0,19980,217,68,7.2,True,25.4928,-4413,-7,-1,226,285,-59
BR1_2731482296,12,True,0,0,0,18338,194,40,7.0,True,7,False,0,1,0,17561,235,56,6.8,False,26.0824,777,5,0,234,291,-57
BR1_2686626025,14,False,0,0,1,23384,232,52,7.4,True,10,True,0,0,0,19482,232,60,7.4,False,28.023633333333333,3902,4,0,284,292,-8
BR1_2685542846,2,False,1,0,0,13329,174,48,6.4,False,7,True,0,1,1,18504,242,52,7.2,True,27.482066666666668,-5175,-5,1,222,294,-72
BR1_2729666124,6,True,0,1,0,19609,213,75,7.6,False,2,False,1,0,0,15589,227,58,7.2,True,27.991816666666665,4020,4,-1,288,285,3
BR1_2729636682,3,True,1,0,0,15463,215,63,7.0,True,5,False,0,1,0,17325,225,72,7.2,False,26.428716666666666,-1862,-2,1,278,297,-19
BR1_2729616417,2,False,1,0,0,14907,202,68,7.0,True,4,True,0,0,0,15163,193,51,6.8,False,25.762733333333333,-256,-2,1,270,244,26
BR1_2678653023,4,False,0,0,0,15261,226,48,6.4,False,6,True,1,0,0,17523,212,56,7.0,True,27.250183333333332,-2262,-2,-1,274,268,6
BR1_2678642027,6,False,0,1,0,18989,252,56,7.4,True,6,True,0,0,0,18633,284,64,8.0,False,28.94465,356,0,0,308,348,-40
BR1_2729895766,8,False,0,1,0,18448,196,68,6.8,True,10,True,1,0,0,18380,198,68,7.0,False,26.890933333333333,68,-2,-1,264,266,-2
BR1_2729598039,8,False,0,0,0,19523,216,52,7.4,True,12,True,1,0,0,20454,229,66,7.4,False,28.330216666666665,-931,-4,-1,268,295,-27
BR1_2724373576,10,False,0,1,0,19130,204,56,7.4,True,10,True,1,0,0,19478,229,56,7.4,False,28.186433333333333,-348,0,-1,260,285,-25
BR1_2722594321,3,False,0,0,0,15205,198,51,6.6,True,10,True,0,0,0,17509,199,52,6.4,False,26.38535,-2304,-7,0,249,251,-2
BR1_2731370613,9,True,0,0,0,17583,235,36,7.0,True,11,False,0,0,0,19652,238,40,7.2,False,28.0573,-2069,-2,0,271,278,-7
BR1_2731364722,8,True,0,0,0,19599,248,64,7.4,False,3,False,1,1,0,16820,250,72,7.2,True,29.05,2779,5,-1,312,322,-10
BR1_2730595711,6,True,1,0,0,15546,203,52,7.0,False,10,False,0,0,0,18077,233,56,7.2,True,25.047666666666668,-2531,-4,1,255,289,-34
BR1_2726231838,7,True,0,0,0,17608,189,60,7.0,False,8,False,1,0,0,19161,231,59,7.2,True,29.093283333333332,-1553,-1,-1,249,290,-41
BR1_2731129873,9,True,1,0,0,19013,251,60,7.4,True,7,False,0,1,0,19453,242,64,7.6,False,29.643883333333335,-440,2,1,311,306,5
BR1_2731583516,8,True,1,1,0,19108,247,72,7.2,True,6,False,0,0,0,17111,237,48,7.4,False,28.913833333333333,1997,2,1,319,285,34
BR1_2731806870,10,True,0,0,0,18772,225,47,7.6,False,5,False,1,1,0,18057,260,68,7.4,True,28.397616666666668,715,5,-1,272,328,-56
BR1_2725004847,14,False,0,0,0,21391,253,52,7.4,False,14,True,0,1,1,23011,190,60,7.6,True,27.7165,-1620,0,0,305,250,55
BR1_2724988131,10,True,0,1,0,18245,225,56,6.6,False,9,False,0,0,0,17205,177,40,6.6,True,26.904466666666668,1040,1,0,281,217,64
BR1_2725230350,6,False,1,0,0,16796,226,56,7.2,True,6,True,0,0,0,16051,193,52,6.8,False,25.96555,745,0,1,282,245,37
BR1_2730831202,5,False,0,0,0,17814,266,60,7.2,False,9,True,1,0,0,19811,274,56,7.8,True,29.6196,-1997,-4,-1,326,330,-4
BR1_2731827547,7,False,0,1,0,16393,153,60,6.8,True,9,True,1,0,0,18091,223,58,7.0,False,26.610016666666667,-1698,-2,-1,213,281,-68
BR1_2731809498,3,False,0,0,0,17029,256,64,7.2,False,2,True,1,1,0,16214,234,76,7.4,True,29.1816,815,1,-1,320,310,10
BR1_2729122874,4,False,0,0,0,17396,250,40,7.0,True,11,True,0,0,0,20233,220,64,7.6,False,29.006066666666666,-2837,-7,0,290,284,6
BR1_2728357540,4,False,0,0,0,15392,198,64,6.8,True,4,True,1,0,0,15243,204,40,6.8,False,26.644883333333333,149,0,-1,262,244,18
BR1_2728338607,7,False,0,1,0,19185,231,64,7.2,False,8,True,1,0,0,18460,218,44,7.2,True,28.827333333333332,725,-1,-1,295,262,33
BR1_2730281402,5,False,0,1,0,16864,187,57,7.2,False,7,True,1,0,0,18955,232,58,7.2,True,27.763566666666666,-2091,-2,-1,244,290,-46
BR1_2729284588,7,False,1,1,0,18725,230,64,7.4,True,7,True,0,0,0,19596,227,56,7.0,False,27.6223,-871,0,1,294,283,11
BR1_2730746894,5,False,0,1,0,15595,187,56,6.8,False,11,True,0,0,0,18997,229,64,7.2,True,25.510733333333334,-3402,-6,0,243,293,-50
BR1_2730727338,9,True,0,0,0,19062,214,55,7.2,True,4,False,1,0,0,17212,231,64,7.6,False,28.235983333333333,1850,5,-1,269,295,-26
BR1_2730703115,4,True,1,0,0,16781,244,60,7.6,False,7,False,0,1,0,19261,261,68,7.8,True,28.501683333333332,-2480,-3,1,304,329,-25
BR1_2719688584,6,False,0,0,0,15906,180,48,6.2,False,16,True,1,1,1,21777,230,39,7.0,True,25.159216666666666,-5871,-10,-1,228,269,-41
BR1_2730052170,5,False,0,0,0,15910,159,63,6.6,False,15,True,1,0,0,21914,242,56,7.6,True,29.75945,-6004,-10,-1,222,298,-76
BR1_2731592486,10,False,0,0,0,20041,251,57,7.4,False,13,True,1,0,0,20286,229,66,7.4,True,27.622933333333332,-245,-3,-1,308,295,13
BR1_2731505503,3,True,0,1,0,14934,208,60,7.0,False,8,False,1,0,0,17945,240,64,7.2,True,25.034516666666665,-3011,-5,-1,268,304,-36
BR1_2731478545,8,True,0,0,0,18529,224,58,7.2,True,5,False,0,0,0,17215,246,52,7.2,False,27.5759,1314,3,0,282,298,-16
BR1_2723699344,11,False,0,1,0,18793,209,56,7.0,False,8,True,1,0,0,18272,194,60,6.8,True,26.17145,521,3,-1,265,254,11
BR1_2719164602,9,True,1,0,0,17731,229,66,6.8,True,7,False,0,0,0,16531,194,38,7.0,False,26.54665,1200,2,1,295,232,63
BR1_2719149957,12,True,1,0,0,19184,202,48,6.8,True,12,False,0,1,0,19673,197,53,6.8,False,26.1089,-489,0,1,250,250,0
BR1_2730080698,7,True,0,0,0,19659,299,60,7.6,False,3,False,1,0,0,16479,230,84,7.6,True,28.047233333333335,3180,4,-1,359,314,45
BR1_2728072092,13,False,0,0,0,21085,225,56,7.4,True,6,True,1,0,0,17493,241,79,7.0,False,29.88785,3592,7,-1,281,320,-39
BR1_2731541432,14,True,1,0,0,19411,231,57,6.8,True,9,False,0,0,0,18250,204,46,6.8,False,27.086783333333333,1161,5,1,288,250,38
BR1_2731158661,6,False,0,0,0,17041,235,44,6.8,False,4,True,0,0,0,15347,204,44,6.8,True,25.33565,1694,2,0,279,248,31
BR1_2730670245,6,False,1,0,0,17858,210,52,7.2,False,10,True,0,1,1,21066,235,63,7.6,True,28.445683333333335,-3208,-4,1,262,298,-36
BR1_2730494736,9,False,1,1,0,20073,245,67,7.6,True,6,True,0,0,0,18866,254,56,7.2,False,27.831,1207,3,1,312,310,2
BR1_2730459003,14,True,1,0,0,21402,227,68,7.4,False,8,False,0,1,0,19400,225,72,7.4,True,27.604066666666668,2002,6,1,295,297,-2
BR1_2731457709,9,True,1,0,0,17902,231,64,7.0,True,4,False,0,0,0,14545,202,52,7.0,False,27.34595,3357,5,1,295,254,41
BR1_2731445853,7,True,0,0,0,16869,231,39,7.2,False,4,False,0,1,0,17657,273,48,7.2,True,28.855133333333335,-788,3,0,270,321,-51
BR1_2731937995,6,True,0,0,0,16915,207,60,6.8,False,6,False,1,0,0,16465,194,59,6.6,True,26.068266666666666,450,0,-1,267,253,14
BR1_2731921430,11,True,1,0,0,19294,202,80,7.6,True,12,False,0,1,0,20263,235,56,7.2,False,28.31955,-969,-1,1,282,291,-9
BR1_2728915510,3,True,1,1,0,15509,205,59,6.8,False,8,False,0,0,0,17165,214,68,7.0,True,25.829916666666666,-1656,-5,1,264,282,-18
BR1_2727182481,6,True,0,0,0,15468,178,48,6.8,True,6,False,1,0,0,15509,196,56,6.6,False,27.2324,-41,0,-1,226,252,-26
BR1_2731677035,6,False,0,0,0,17193,221,56,7.2,False,8,True,0,1,0,19545,241,76,7.4,True,28.44085,-2352,-2,0,277,317,-40
BR1_2730602502,10,False,0,0,0,18982,222,56,7.2,False,12,True,1,0,0,20441,255,72,7.6,True,29.5587,-1459,-2,-1,278,327,-49
BR1_2731577391,13,False,1,0,0,18188,181,47,6.8,True,5,True,0,1,0,15493,170,81,6.8,False,26.707616666666667,2695,8,1,228,251,-23
BR1_2729501027,9,True,0,0,0,17720,214,52,6.8,False,4,False,1,0,0,15398,202,47,6.6,True,27.278983333333333,2322,5,-1,266,249,17
BR1_2729440892,11,True,0,0,0,20205,253,76,7.6,True,5,False,0,0,0,17430,251,59,7.2,False,27.82405,2775,6,0,329,310,19
BR1_2725888244,7,True,1,1,1,20319,222,68,7.2,False,6,False,0,0,0,16916,221,60,6.8,True,29.512416666666667,3403,1,1,290,281,9
BR1_2722407646,4,True,0,0,0,15379,200,56,6.8,False,9,False,1,0,0,17901,198,64,7.2,True,27.477733333333333,-2522,-5,-1,256,262,-6
BR1_2719930076,8,False,0,1,0,19322,227,60,7.2,True,9,True,1,0,0,19070,244,52,7.4,False,27.997666666666667,252,-1,-1,287,296,-9
BR1_2730935210,4,False,0,1,0,18469,257,60,7.4,True,2,True,1,0,0,15758,248,64,7.4,False,27.598666666666666,2711,2,-1,317,312,5
BR1_2730920495,9,True,1,0,0,18938,201,52,6.8,False,11,False,0,1,0,21251,224,48,7.2,True,29.348083333333335,-2313,-2,1,253,272,-19
BR1_2730914135,3,True,0,0,0,17321,277,64,7.4,False,4,False,1,1,1,19504,257,68,7.6,True,29.64825,-2183,-1,-1,341,325,16
BR1_2731754315,7,False,1,1,0,17557,228,56,7.0,True,3,True,0,0,0,14043,199,48,6.8,False,26.435416666666665,3514,4,1,284,247,37
BR1_2731204088,7,True,1,0,0,19370,263,68,7.4,False,10,False,0,1,1,21375,223,64,7.8,True,27.981066666666667,-2005,-3,1,331,287,44
BR1_2727457000,10,True,0,0,0,17957,206,52,7.0,True,2,False,1,1,0,14354,206,64,7.0,False,26.07375,3603,8,-1,258,270,-12
BR1_2729900203,8,True,1,0,0,18938,243,60,7.6,True,5,False,0,0,0,17046,214,56,7.4,False,29.132133333333332,1892,3,1,303,270,33
BR1_2730004071,3,True,0,0,0,14810,218,44,6.8,False,5,False,1,0,0,15950,227,46,7.2,True,26.084,-1140,-2,-1,262,273,-11
BR1_2729978980,7,True,0,0,0,17197,237,56,6.6,False,5,False,1,1,0,16741,209,64,7.0,True,26.886383333333335,456,2,-1,293,273,20
BR1_2726292007,3,False,0,0,0,15714,218,55,7.0,False,9,True,0,1,1,20665,222,56,7.2,True,27.968716666666666,-4951,-6,0,273,278,-5
BR1_2731188376,11,False,0,1,0,18604,187,44,6.4,True,11,True,1,0,0,17753,182,48,6.6,False,26.503166666666665,851,0,-1,231,230,1
BR1_2729842438,4,True,0,0,0,16835,237,52,7.2,False,5,False,1,1,0,17232,219,68,7.2,True,29.14591666666667,-397,-1,-1,289,287,2
BR1_2728843284,10,False,1,0,0,19049,230,52,7.2,True,6,True,0,0,0,17778,206,54,7.0,False,29.523633333333333,1271,4,1,282,260,22
BR1_2731764410,7,False,0,0,0,16191,183,48,6.4,False,13,True,1,0,0,18537,183,60,6.8,True,25.086266666666667,-2346,-6,-1,231,243,-12
BR1_2712124409,6,True,0,0,0,14829,177,48,6.2,False,6,False,0,0,0,16127,195,60,7.0,True,26.613816666666665,-1298,0,0,225,255,-30
BR1_2711949902,9,False,1,0,0,17972,202,55,7.4,False,13,True,0,0,0,21002,246,55,7.2,True,28.129683333333332,-3030,-4,1,257,301,-44
BR1_2731161618,8,False,0,0,0,17535,228,64,7.0,False,6,True,1,0,0,15461,194,52,6.6,True,27.133933333333335,2074,2,-1,292,246,46
BR1_2730649050,7,True,1,1,0,16672,195,63,6.6,False,9,False,0,0,0,17999,201,58,7.2,True,27.141866666666665,-1327,-2,1,258,259,-1
BR1_2729800198,18,True,0,0,0,21554,214,60,7.2,True,8,False,0,0,0,17443,215,40,6.6,False,27.419583333333332,4111,10,0,274,255,19
BR1_2729813343,6,False,0,0,0,15853,169,55,6.8,False,12,True,0,0,0,20655,232,52,7.2,True,28.054183333333334,-4802,-6,0,224,284,-60
BR1_2730728418,8,False,1,0,0,16864,186,56,7.4,False,10,True,0,1,0,19313,196,64,7.2,True,27.692283333333332,-2449,-2,1,242,260,-18
BR1_2729490329,8,True,1,0,0,16948,169,60,6.8,True,7,False,0,0,0,16254,199,56,6.4,False,26.15395,694,1,1,229,255,-26
BR1_2730886585,14,True,1,0,0,19843,210,44,7.0,True,11,False,0,0,0,16839,168,50,6.4,False,25.02665,3004,3,1,254,218,36
BR1_2731075933,6,True,1,1,0,17640,229,60,7.4,False,3,False,0,0,0,16164,254,64,7.4,True,28.71388333333333,1476,3,1,289,318,-29
BR1_2731046515,8,True,0,0,0,18471,225,65,7.2,True,10,False,1,0,0,19205,197,56,7.6,False,28.23585,-734,-2,-1,290,253,37
BR1_2731793974,10,True,1,1,0,17551,226,44,6.8,False,13,False,0,0,0,18798,210,47,7.2,True,26.96655,-1247,-3,1,270,257,13
BR1_2731895674,2,False,0,0,0,17181,274,72,7.2,True,7,True,0,1,0,19196,274,60,7.6,False,27.598816666666668,-2015,-5,0,346,334,12
BR1_2730221680,7,True,0,0,0,18470,272,68,7.4,True,6,False,1,0,0,17659,236,56,7.2,False,28.528683333333333,811,1,-1,340,292,48
BR1_2730834994,7,False,0,0,0,18893,221,47,7.2,False,11,True,1,1,0,20476,216,60,7.4,True,28.703883333333334,-1583,-4,-1,268,276,-8
BR1_2731330275,3,True,1,1,0,16237,240,64,7.0,True,8,False,0,0,0,16413,201,60,7.0,False,27.105266666666665,-176,-5,1,304,261,43
BR1_2731305634,12,True,1,0,0,20723,223,47,7.2,True,15,False,0,1,0,21981,225,60,7.2,False,29.60755,-1258,-3,1,270,285,-15
BR1_2731628152,11,False,0,0,0,18889,228,60,7.2,True,6,True,0,0,0,17030,199,64,6.8,False,27.1049,1859,5,0,288,263,25
BR1_2731489859,3,False,0,0,0,16028,244,56,7.2,False,8,True,1,1,0,18531,241,63,7.6,True,28.010566666666666,-2503,-5,-1,300,304,-4
BR1_2729609608,7,False,1,0,0,18608,222,60,7.4,False,5,True,0,1,0,18502,253,60,7.6,True,28.201633333333334,106,2,1,282,313,-31
BR1_2729587496,5,False,0,1,0,15638,187,56,6.6,True,8,True,0,0,0,17865,212,42,6.8,False,26.206183333333332,-2227,-3,0,243,254,-11
BR1_2729522599,8,True,0,1,0,19129,252,67,7.8,True,6,False,1,0,0,17866,207,56,7.4,False,28.72675,1263,2,-1,319,263,56
BR1_2729487681,7,False,1,0,0,19170,260,67,7.6,False,6,True,0,1,0,17297,230,49,7.0,True,29.331616666666665,1873,1,1,327,279,48
BR1_2726282871,1,False,1,0,0,14245,240,54,6.8,False,6,True,0,1,0,18007,236,70,7.6,True,26.953016666666667,-3762,-5,1,294,306,-12
BR1_2725752526,7,True,1,0,0,16875,211,52,7.0,True,9,False,0,0,0,17059,200,44,7.0,False,26.34135,-184,-2,1,263,244,19
BR1_2724936121,14,True,0,0,0,19723,194,47,6.6,True,10,False,0,0,0,16679,173,52,6.4,False,25.415483333333334,3044,4,0,241,225,16
BR1_2731052978,4,False,0,0,0,15446,228,52,7.0,True,4,True,1,1,0,16565,219,74,7.0,False,26.618466666666666,-1119,0,-1,280,293,-13
BR1_2731422600,6,True,1,0,0,16397,206,48,6.8,True,4,False,0,1,0,15080,171,64,6.8,False,25.737333333333332,1317,2,1,254,235,19
BR1_2730050354,7,True,0,0,0,16815,227,48,6.8,True,4,False,1,0,0,14943,173,72,6.8,False,25.967183333333335,1872,3,-1,275,245,30
BR1_2730789003,8,False,0,1,0,19983,239,52,7.2,True,8,True,1,0,0,19318,255,75,7.6,False,29.03685,665,0,-1,291,330,-39
BR1_2730746524,5,False,0,0,0,17008,232,56,7.4,False,5,True,1,1,0,17981,273,68,7.4,True,28.533083333333334,-973,0,-1,288,341,-53
BR1_2726302156,6,False,0,0,0,17212,214,71,7.6,False,4,True,0,0,0,17391,290,48,7.2,True,28.01945,-179,2,0,285,338,-53
BR1_2725789470,5,True,0,0,0,16849,222,39,6.8,False,7,False,0,0,0,16279,182,68,6.6,True,27.35695,570,-2,0,261,250,11
BR1_2725765193,6,True,0,0,0,16254,216,68,7.0,False,11,False,0,1,1,20990,226,52,7.0,True,26.367316666666667,-4736,-5,0,284,278,6
BR1_2717581343,4,False,0,0,0,16008,231,59,6.8,False,6,True,1,0,0,16665,220,44,6.8,True,27.276083333333332,-657,-2,-1,290,264,26
BR1_2731050079,4,True,0,0,0,17650,267,68,7.6,False,5,False,1,0,0,17156,241,60,7.2,True,28.0067,494,-1,-1,335,301,34
BR1_2730988804,6,False,0,0,0,15838,188,52,6.6,False,10,True,1,1,0,18535,219,76,7.0,True,26.14678333333333,-2697,-4,-1,240,295,-55
BR1_2731750528,11,False,0,0,0,18543,172,44,6.4,True,16,True,0,0,0,19684,194,28,6.6,False,25.737,-1141,-5,0,216,222,-6
BR1_2731559736,11,True,1,0,0,20714,248,60,7.6,True,6,False,0,1,0,18542,228,68,7.4,False,28.664383333333333,2172,5,1,308,296,12
BR1_2731884226,3,False,0,1,0,14937,231,48,6.8,False,7,True,1,0,0,16647,233,56,7.0,True,26.104283333333335,-1710,-4,-1,279,289,-10
BR1_2731873476,6,False,1,0,0,17272,227,55,7.6,True,9,True,0,1,0,19686,211,64,7.4,False,28.254916666666666,-2414,-3,1,282,275,7
BR1_2731388133,11,True,1,1,0,20820,247,63,7.6,True,4,False,0,0,0,16794,247,44,7.2,False,28.14565,4026,7,1,310,291,19
BR1_2731274148,4,True,0,0,0,16094,234,52,7.0,False,3,False,1,0,0,14087,192,50,6.6,True,26.36815,2007,1,-1,286,242,44
BR1_2713692266,13,True,0,0,0,20756,226,52,7.4,True,10,False,1,0,0,20594,225,68,7.2,False,27.5594,162,3,-1,278,293,-15
BR1_2709184207,6,False,0,1,0,17469,260,40,6.8,False,8,True,0,0,0,19641,236,63,7.2,True,28.48785,-2172,-2,0,300,299,1
BR1_2731548260,13,False,1,0,0,19302,194,50,6.6,False,14,True,0,0,0,19419,210,50,6.8,True,25.133616666666665,-117,-1,1,244,260,-16
BR1_2731528522,3,True,1,1,0,17819,262,64,7.4,False,9,False,0,0,0,19588,263,64,7.6,True,29.181033333333332,-1769,-6,1,326,327,-1
BR1_2729726471,8,False,0,1,0,20491,256,56,7.6,False,9,True,0,0,0,18728,209,64,7.6,True,27.537133333333333,1763,-1,0,312,273,39
BR1_2729123645,8,False,0,0,0,18688,224,52,7.4,False,15,True,1,1,0,22814,228,67,7.6,True,27.54265,-4126,-7,-1,276,295,-19
BR1_2731863059,12,True,1,0,0,19170,207,44,7.0,False,10,False,0,1,0,20606,225,80,7.4,True,28.438383333333334,-1436,2,1,251,305,-54
BR1_2731334034,7,False,1,1,0,15796,191,42,6.6,True,10,True,0,0,0,17562,167,41,6.6,False,26.6719,-1766,-3,1,233,208,25
BR1_2731818909,8,True,0,0,0,16936,224,48,7.0,False,3,False,1,0,0,15197,240,64,7.0,True,25.61535,1739,5,-1,272,304,-32
BR1_2730989414,7,False,0,0,0,17577,225,52,6.8,False,12,True,0,0,0,19351,220,44,6.6,True,25.096766666666667,-1774,-5,0,277,264,13
BR1_2728335683,10,True,0,1,0,19783,240,68,7.6,False,12,False,1,0,0,19565,245,64,7.8,True,28.24265,218,-2,-1,308,309,-1
BR1_2726475213,6,False,0,0,0,18194,260,56,7.8,True,5,True,0,0,0,16809,218,60,7.2,False,29.58385,1385,1,0,316,278,38
BR1_2731923564,8,True,0,1,0,18011,249,60,7.4,True,8,False,1,0,0,20016,287,60,7.6,False,28.683766666666667,-2005,0,-1,309,347,-38
BR1_2731712227,5,True,0,0,0,15809,209,40,7.0,False,7,False,1,0,0,16937,207,60,7.0,True,25.01785,-1128,-2,-1,249,267,-18
BR1_2731683646,7,True,0,0,0,17650,239,47,7.2,False,12,False,1,1,0,21795,242,76,7.6,True,29.0922,-4145,-5,-1,286,318,-32
BR1_2728867196,0,False,1,0,0,12801,191,64,6.8,False,4,True,0,0,0,15256,219,48,7.0,True,27.10135,-2455,-4,1,255,267,-12
BR1_2728628946,7,True,0,0,0,17673,209,48,7.4,False,2,False,1,0,0,14891,208,72,7.2,True,27.53933333333333,2782,5,-1,257,280,-23
BR1_2728621975,11,True,0,0,0,18660,200,52,7.0,True,7,False,0,0,0,15679,185,36,6.4,False,27.17705,2981,4,0,252,221,31
BR1_2728613798,8,True,1,1,1,19513,230,72,7.6,True,4,False,0,0,0,16200,205,52,7.2,False,29.451816666666666,3313,4,1,302,257,45
BR1_2731929808,11,True,1,1,0,19641,214,71,7.2,False,4,False,0,0,0,15795,207,52,6.8,True,27.3837,3846,7,1,285,259,26
BR1_2731443179,8,False,0,1,0,18210,240,62,7.4,False,8,True,1,0,0,18612,243,48,7.0,True,28.286983333333332,-402,0,-1,302,291,11
BR1_2731430363,6,True,0,1,0,18829,221,68,7.8,False,7,False,1,0,0,19148,290,60,7.8,True,27.979616666666665,-319,-1,-1,289,350,-61
BR1_2723489256,6,False,1,1,0,16106,217,42,6.6,False,11,True,0,0,0,19683,226,60,7.2,True,25.16935,-3577,-5,1,259,286,-27
BR1_2708502001,6,True,1,0,0,15699,218,52,7.0,False,5,False,0,1,0,16410,214,56,6.6,True,25.983866666666668,-711,1,1,270,270,0
BR1_2731829312,13,True,0,0,0,20279,219,59,7.2,True,9,False,1,0,0,18500,206,47,6.6,False,29.62445,1779,4,-1,278,253,25
BR1_2730234763,10,False,0,0,0,19874,235,58,7.4,False,10,True,1,1,1,21826,274,64,7.4,True,29.02765,-1952,0,-1,293,338,-45
BR1_2730229445,8,True,0,0,0,18313,238,56,7.0,False,3,False,0,0,0,16378,235,60,7.2,True,28.42725,1935,5,0,294,295,-1
BR1_2730198847,7,False,0,0,0,16037,197,44,6.8,False,12,True,0,0,0,17994,197,48,6.8,True,25.667733333333334,-1957,-5,0,241,245,-4
BR1_2729227240,5,False,1,0,0,15688,209,43,7.0,True,4,True,0,1,0,16406,221,80,7.0,False,26.9359,-718,1,1,252,301,-49
BR1_2729213718,9,False,0,0,0,16840,211,39,6.8,False,5,True,1,0,0,16842,235,60,7.0,True,26.2545,-2,4,-1,250,295,-45
BR1_2701484865,8,True,0,1,0,17572,223,52,7.2,True,5,False,1,0,0,16263,229,64,7.0,False,25.645333333333333,1309,3,-1,275,293,-18
BR1_2701456439,9,False,0,0,0,18777,246,56,7.6,False,5,True,1,0,0,16774,254,52,7.4,True,29.852216666666667,2003,4,-1,302,306,-4
BR1_2700977473,8,True,1,0,0,18327,233,63,7.6,True,4,False,0,1,0,17150,241,64,7.2,False,27.56335,1177,4,1,296,305,-9
BR1_2731146981,12,False,1,0,0,21070,223,64,7.8,True,10,True,0,0,0,19825,247,55,7.4,False,29.494,1245,2,1,287,302,-15
BR1_2730576398,11,True,0,0,0,19050,238,52,7.2,True,10,False,1,0,0,19641,245,59,7.4,False,27.87885,-591,1,-1,290,304,-14
BR1_2730532184,4,True,1,0,0,15855,214,68,6.8,False,7,False,0,0,0,17046,253,60,7.2,True,25.5286,-1191,-3,1,282,313,-31
BR1_2729264580,5,False,0,0,0,18171,241,68,7.2,False,6,True,1,0,0,17989,234,60,7.4,True,29.5172,182,-1,-1,309,294,15
BR1_2731754296,2,False,0,0,0,14003,165,44,6.4,False,12,True,1,0,0,19099,176,75,7.2,True,25.719566666666665,-5096,-10,-1,209,251,-42
BR1_2731211437,7,False,0,1,0,18331,218,68,7.0,False,13,True,1,0,0,19517,230,43,7.4,True,27.654783333333334,-1186,-6,-1,286,273,13
BR1_2730972766,5,False,0,0,0,15734,208,32,6.6,False,7,True,1,0,0,17305,202,56,6.8,True,25.577883333333332,-1571,-2,-1,240,258,-18
BR1_2729804422,9,False,0,0,0,19774,213,72,7.2,True,5,True,1,1,0,18683,252,44,7.4,False,29.044283333333333,1091,4,-1,285,296,-11
BR1_2713341337,3,False,0,0,0,16725,246,60,7.4,False,3,True,1,1,0,17532,247,53,7.4,True,29.423733333333335,-807,0,-1,306,300,6
BR1_2730328225,7,True,0,0,0,16809,216,52,6.6,True,8,False,1,0,0,17383,200,56,7.0,False,25.884733333333333,-574,-1,-1,268,256,12
BR1_2731910315,8,True,1,0,0,17834,220,50,6.8,True,5,False,0,0,0,16248,201,56,7.0,False,26.076716666666666,1586,3,1,270,257,13
BR1_2731819900,7,False,0,1,0,18629,263,56,7.4,False,9,True,1,0,0,20744,255,75,7.6,True,29.32925,-2115,-2,-1,319,330,-11
BR1_2731798873,5,True,1,1,0,16676,240,56,7.2,True,3,False,0,0,0,14912,206,52,6.8,False,25.614116666666668,1764,2,1,296,258,38
BR1_2731699487,6,False,0,1,0,18820,224,52,7.2,True,8,True,1,0,0,17664,225,60,7.0,False,28.666633333333333,1156,-2,-1,276,285,-9
BR1_2731262576,10,False,0,0,0,18795,204,52,7.0,False,12,True,1,1,0,20435,238,52,7.4,True,28.6349,-1640,-2,-1,256,290,-34
BR1_2719220490,10,True,0,1,0,19788,229,60,7.6,True,3,False,0,0,0,17144,251,60,7.4,False,27.97575,2644,7,0,289,311,-22
BR1_2719205528,8,True,1,0,0,17627,234,64,7.0,True,5,False,0,0,0,16267,212,56,6.6,False,26.937133333333332,1360,3,1,298,268,30
BR1_2727402443,7,True,0,1,0,19425,270,54,7.4,True,4,False,1,0,0,15826,217,54,7.2,False,28.35215,3599,3,-1,324,271,53
BR1_2731820989,5,True,1,0,0,16899,235,52,7.0,True,6,False,0,0,0,15894,179,51,7.0,False,27.341,1005,-1,1,287,230,57
BR1_2730559971,0,False,0,0,0,14453,232,48,6.8,True,4,True,1,0,0,14926,193,64,6.8,False,25.558083333333332,-473,-4,-1,280,257,23
BR1_2731194821,6,True,0,0,0,17471,218,72,7.0,False,8,False,1,1,0,19789,245,63,7.6,True,28.683283333333332,-2318,-2,-1,290,308,-18
BR1_2718512154,10,True,0,0,0,18599,226,44,7.4,True,11,False,1,1,0,20907,260,86,7.8,False,29.290766666666666,-2308,-1,-1,270,346,-76
BR1_2728621273,12,True,0,1,0,18378,162,55,6.6,True,6,False,1,0,0,16372,218,56,6.8,False,25.94265,2006,6,-1,217,274,-57
BR1_2731698089,4,False,1,0,0,15116,221,56,7.0,True,3,True,0,0,0,14325,189,48,6.4,False,26.330933333333334,791,1,1,277,237,40
BR1_2727533494,6,True,0,0,0,16915,196,48,7.0,False,10,False,1,0,0,19442,218,56,7.6,True,28.1068,-2527,-4,-1,244,274,-30
BR1_2727508671,9,True,1,0,0,17707,186,44,7.0,False,8,False,0,1,0,16171,162,52,6.4,True,26.212716666666665,1536,1,1,230,214,16
BR1_2730629722,6,False,0,0,0,16042,157,44,6.4,False,11,True,1,0,0,18295,188,60,7.0,True,26.452466666666666,-2253,-5,-1,201,248,-47
BR1_2731837273,5,False,0,0,0,14758,160,56,7.0,False,4,True,1,0,0,15025,217,42,7.0,True,26.766266666666667,-267,1,-1,216,259,-43
BR1_2731781480,3,True,1,0,0,15517,244,44,6.8,True,2,False,0,0,0,14222,196,64,6.8,False,27.479133333333333,1295,1,1,288,260,28
BR1_2729627130,9,True,0,1,0,18730,238,44,7.0,True,6,False,0,0,0,17552,252,56,7.2,False,28.7342,1178,3,0,282,308,-26
BR1_2729442356,4,False,0,1,0,17306,217,78,7.4,False,7,True,1,0,0,18143,230,68,7.2,True,28.07015,-837,-3,-1,295,298,-3
BR1_2729346740,9,False,0,0,0,19136,228,60,7.2,True,10,True,0,0,0,19212,231,60,7.2,False,29.262733333333333,-76,-1,0,288,291,-3
BR1_2731930677,13,True,0,1,0,21955,265,68,8.2,True,5,False,1,0,0,16787,216,72,7.0,False,28.4988,5168,8,-1,333,288,45
BR1_2731219402,10,True,0,0,0,18066,192,40,6.8,False,7,False,0,0,0,16622,202,48,6.6,True,25.89988333333333,1444,3,0,232,250,-18
BR1_2728608925,9,False,0,1,0,20325,243,76,7.4,True,12,True,1,0,0,21746,282,59,7.8,False,29.589133333333333,-1421,-3,-1,319,341,-22
BR1_2729008829,7,False,1,1,0,17011,206,68,7.0,True,4,True,0,0,0,14407,181,44,6.6,False,26.890466666666665,2604,3,1,274,225,49
BR1_2722471281,11,False,0,0,0,17825,182,56,6.6,True,5,True,0,0,0,15719,211,60,6.6,False,27.36938333333333,2106,6,0,238,271,-33
BR1_2710141541,5,True,1,0,0,15585,208,51,6.8,True,6,False,0,1,0,16742,222,52,7.0,False,26.383216666666666,-1157,-1,1,259,274,-15
BR1_2708385802,10,True,0,1,0,20425,255,52,7.6,False,7,False,1,0,0,18116,216,56,7.0,True,29.1703,2309,3,-1,307,272,35
BR1_2731204736,11,False,1,1,0,19451,236,59,7.6,True,8,True,0,0,0,19165,240,48,7.4,False,29.21216666666667,286,3,1,295,288,7
BR1_2730203685,9,False,1,0,0,19427,242,60,7.4,False,10,True,0,0,0,20500,262,60,7.6,True,28.6577,-1073,-1,1,302,322,-20
BR1_2729772537,5,False,0,0,0,17495,246,67,7.6,False,10,True,1,0,0,20270,297,56,8.0,True,28.84645,-2775,-5,-1,313,353,-40
BR1_2729598915,2,False,1,0,1,15334,213,60,7.0,False,7,True,0,1,0,20082,219,58,7.4,True,29.428616666666667,-4748,-5,1,273,277,-4
BR1_2714995477,5,False,0,0,0,15732,196,48,6.8,True,4,True,1,0,0,16188,252,61,6.6,False,26.204633333333334,-456,1,-1,244,313,-69
BR1_2711930450,8,True,1,0,0,18875,236,62,7.4,True,4,False,0,1,0,16965,227,68,7.4,False,29.0208,1910,4,1,298,295,3
BR1_2731121697,5,False,0,0,0,15534,208,47,6.6,False,9,True,1,0,0,17962,223,67,7.0,True,25.963433333333334,-2428,-4,-1,255,290,-35
BR1_2730682961,9,True,0,0,0,18441,232,54,6.8,True,5,False,0,0,0,15437,171,43,7.0,False,27.3058,3004,4,0,286,214,72
BR1_2730162596,1,False,0,0,0,15920,259,53,7.4,False,5,True,1,0,0,18767,272,52,7.4,True,28.1927,-2847,-4,-1,312,324,-12
BR1_2730124922,4,True,0,0,0,15960,251,52,6.8,True,6,False,1,0,0,16536,251,52,7.2,False,27.211383333333334,-576,-2,-1,303,303,0
BR1_2729282215,9,True,0,0,0,18956,238,56,7.2,False,10,False,0,1,0,20485,256,60,7.4,True,29.667883333333332,-1529,-1,0,294,316,-22
BR1_2727548845,13,False,1,0,0,19454,182,55,6.8,False,10,True,0,1,1,20684,233,54,7.4,True,29.717883333333333,-1230,3,1,237,287,-50
BR1_2731859314,8,False,1,0,0,18446,213,48,7.2,True,8,True,0,0,0,19864,262,47,7.2,False,27.60245,-1418,0,1,261,309,-48
BR1_2731867507,7,True,1,0,0,17569,202,67,7.4,True,4,False,0,0,0,17114,219,72,7.4,False,29.10365,455,3,1,269,291,-22
BR1_2731611044,8,True,0,1,0,19302,218,70,7.2,False,8,False,1,0,0,19679,246,40,7.4,True,28.4669,-377,0,-1,288,286,2
BR1_2723257305,7,False,1,1,0,17915,215,80,7.4,True,8,True,0,0,0,18005,248,52,7.2,False,29.10405,-90,-1,1,295,300,-5
BR1_2722017131,5,False,1,0,0,16021,193,72,7.0,True,7,True,0,0,0,16592,236,52,7.0,False,27.211166666666667,-571,-2,1,265,288,-23
BR1_2721862060,5,False,1,0,0,16238,189,76,7.0,False,8,True,0,1,0,18573,244,68,7.6,True,29.313883333333333,-2335,-3,1,265,312,-47
BR1_2729824966,8,True,0,0,0,18452,234,48,7.0,True,8,False,0,0,0,17066,210,48,6.6,False,25.939183333333332,1386,0,0,282,258,24
BR1_2728951627,7,True,1,0,0,18463,255,56,7.6,True,6,False,0,0,0,18272,222,64,7.2,False,29.660716666666666,191,1,1,311,286,25
BR1_2729947972,9,False,0,0,0,18047,198,56,7.0,True,9,True,1,1,0,17544,190,49,6.6,False,25.674266666666668,503,0,-1,254,239,15
BR1_2729935709,9,True,1,0,0,18785,221,64,7.6,True,7,False,0,0,0,19051,264,68,7.4,False,29.451483333333332,-266,2,1,285,332,-47
BR1_2729381349,12,True,1,0,0,19274,195,56,7.2,False,6,False,0,1,0,18390,240,72,7.8,True,29.573383333333332,884,6,1,251,312,-61
BR1_2721565616,9,False,0,1,0,18093,193,68,7.2,True,5,True,0,0,0,15183,182,52,6.6,False,25.430866666666667,2910,4,0,261,234,27
BR1_2731429558,5,False,0,0,0,16810,216,52,7.0,False,9,True,1,0,0,18523,234,64,7.2,True,28.402033333333332,-1713,-4,-1,268,298,-30
BR1_2731720733,8,True,1,0,0,17001,213,52,7.0,True,10,False,0,0,0,19009,214,48,7.0,False,25.643766666666668,-2008,-2,1,265,262,3
BR1_2731695373,5,False,1,0,0,15909,227,48,7.2,True,6,True,0,0,0,17243,210,72,7.2,False,26.819333333333333,-1334,-1,1,275,282,-7
BR1_2730780638,7,True,0,0,0,17581,189,68,7.0,False,10,False,1,0,0,19716,217,60,7.6,True,28.65745,-2135,-3,-1,257,277,-20
BR1_2731781405,4,True,0,0,0,15934,228,40,7.2,False,7,False,0,1,0,19179,247,80,7.8,True,29.21335,-3245,-3,0,268,327,-59
BR1_2731510980,7,True,1,1,0,18115,245,64,7.6,False,7,False,1,0,0,18964,249,60,7.8,True,28.2857,-849,0,0,309,309,0
BR1_2731289251,6,True,1,0,0,15349,177,60,7.0,True,1,False,0,0,0,13835,209,52,6.6,False,25.196566666666666,1514,5,1,237,261,-24
BR1_2731347083,12,False,1,0,0,20486,235,64,7.6,True,7,True,0,1,0,17525,179,67,7.0,False,29.731016666666665,2961,5,1,299,246,53
BR1_2731951692,10,True,0,1,0,19333,221,68,7.6,True,5,False,1,0,0,17077,211,64,7.2,False,29.869633333333333,2256,5,-1,289,275,14
BR1_2730616685,7,True,1,0,0,17914,242,55,7.2,True,2,False,0,1,0,14983,218,72,7.0,False,25.566966666666666,2931,5,1,297,290,7
BR1_2729286743,4,True,0,0,0,16275,254,64,7.0,True,4,False,0,0,0,15944,204,72,7.2,False,27.168416666666666,331,0,0,318,276,42
BR1_2729936464,1,False,1,0,0,13193,191,47,6.6,True,5,True,0,0,0,16160,214,64,6.8,False,26.81175,-2967,-4,1,238,278,-40
BR1_2730577536,7,False,1,0,1,17884,250,60,7.4,True,3,True,0,0,0,17590,238,44,7.2,False,28.06373333333333,294,4,1,310,282,28
BR1_2730542563,8,False,1,1,0,19164,196,71,7.4,True,9,True,0,0,0,19451,261,52,7.2,False,29.26705,-287,-1,1,267,313,-46
BR1_2731800194,13,True,1,1,0,21421,239,57,7.4,True,8,False,0,0,0,19898,247,56,7.4,False,29.109366666666666,1523,5,1,296,303,-7
BR1_2731352238,11,False,1,0,1,19855,231,62,7.2,True,3,True,0,1,0,14632,189,58,6.8,False,25.45875,5223,8,1,293,247,46
BR1_2731342315,7,True,1,0,0,17305,213,40,7.2,False,6,False,0,0,0,17203,237,47,7.2,True,25.3646,102,1,1,253,284,-31
BR1_2731455078,10,False,1,0,0,18008,214,50,7.4,False,7,True,0,1,0,17995,246,51,7.2,True,29.4077,13,3,1,264,297,-33
BR1_2731444230,4,False,0,0,0,15143,211,44,6.8,False,6,True,1,1,0,16401,207,76,7.2,True,27.0683,-1258,-2,-1,255,283,-28
BR1_2728433967,9,False,0,1,1,20762,227,52,7.4,False,7,True,1,0,0,18486,195,52,7.2,True,28.8198,2276,2,-1,279,247,32
BR1_2728229890,7,True,1,0,0,17321,211,56,6.6,True,6,False,0,0,0,15797,186,48,6.4,False,26.72015,1524,1,1,267,234,33
BR1_2728989927,4,False,0,1,0,15811,222,49,6.6,False,12,True,1,0,0,19997,252,46,7.0,True,27.04981666666667,-4186,-8,-1,271,298,-27
BR1_2728519963,11,True,1,0,0,18504,218,38,6.8,True,3,False,0,0,0,15140,204,60,6.6,False,25.01481666666667,3364,8,1,256,264,-8
BR1_2728464471,7,False,1,0,0,17254,185,48,6.6,True,13,True,0,0,0,21082,229,32,7.0,False,28.4882,-3828,-6,1,233,261,-28
BR1_2731494997,5,True,1,0,0,17499,250,56,7.4,False,9,False,0,1,0,19947,241,52,7.6,True,28.7268,-2448,-4,1,306,293,13
BR1_2731288545,8,True,0,0,0,18492,231,52,7.2,False,10,False,1,1,0,19979,229,44,7.4,True,28.06655,-1487,-2,-1,283,273,10
BR1_2730790883,8,True,1,0,0,17835,245,56,7.0,True,5,False,0,0,0,15930,214,47,6.6,False,27.290666666666667,1905,3,1,301,261,40
BR1_2728675380,12,True,0,0,0,18676,228,38,7.0,False,8,False,0,0,0,18544,223,46,7.0,True,28.27215,132,4,0,266,269,-3
BR1_2728668070,6,False,1,0,0,18318,232,67,7.4,False,10,True,0,0,0,20519,276,68,7.6,True,29.9454,-2201,-4,1,299,344,-45
BR1_2728658865,9,True,1,0,0,17258,201,60,7.0,True,9,False,0,0,0,18756,237,52,7.2,False,26.177083333333332,-1498,0,1,261,289,-28
BR1_2723463217,6,False,0,1,0,17503,225,51,7.2,False,6,True,1,0,0,18067,238,84,7.4,True,29.94285,-564,0,-1,276,322,-46
BR1_2723434955,6,True,0,0,0,18459,255,68,7.6,True,7,False,1,0,0,20020,255,64,7.8,False,28.52675,-1561,-1,-1,323,319,4
BR1_2731243698,5,False,0,1,0,17728,241,51,7.0,True,4,True,1,0,0,18025,236,62,7.6,False,29.3073,-297,1,-1,292,298,-6
BR1_2730815288,6,False,0,0,0,19520,272,66,7.6,False,7,True,0,1,0,18686,245,58,7.4,True,28.24425,834,-1,0,338,303,35
BR1_2731052754,6,True,0,0,0,16420,230,46,7.0,True,9,False,1,0,0,16895,210,62,7.0,False,26.682683333333333,-475,-3,-1,276,272,4
BR1_2723075419,9,True,1,1,0,18005,234,60,7.0,False,9,False,0,0,0,18743,224,46,6.8,True,25.613783333333334,-738,0,1,294,270,24
BR1_2723038646,5,True,0,0,0,17732,256,48,7.4,False,4,False,1,0,0,16915,224,60,7.4,True,29.541083333333333,817,1,-1,304,284,20
BR1_2722808006,6,True,0,0,0,17143,214,64,6.8,False,10,False,1,1,0,18329,218,56,6.6,True,28.5466,-1186,-4,-1,278,274,4
BR1_2722782742,4,True,0,0,0,17612,225,60,7.0,False,12,False,0,1,0,22332,249,60,7.6,True,27.851883333333333,-4720,-8,0,285,309,-24
BR1_2722778548,9,False,0,0,0,17938,211,41,7.0,True,8,True,1,0,0,16839,206,51,6.6,False,26.572433333333333,1099,1,-1,252,257,-5
BR1_2716894595,13,True,1,0,0,18697,227,46,7.2,True,7,False,0,0,0,15783,174,56,6.8,False,26.834783333333334,2914,6,1,273,230,43
BR1_2714166439,8,False,0,1,0,18190,229,48,7.0,True,6,True,0,0,0,15766,192,44,7.0,False,25.32485,2424,2,0,277,236,41
BR1_2726407563,5,False,0,1,0,16590,224,56,7.4,False,5,True,1,0,0,18364,273,56,7.4,True,28.972133333333332,-1774,0,-1,280,329,-49
BR1_2730638895,8,True,0,0,0,17784,200,47,6.8,True,9,False,1,1,0,16818,197,48,6.6,False,27.004966666666668,966,-1,-1,247,245,2
BR1_2730620825,10,False,0,0,0,17475,203,40,6.8,False,13,True,0,0,0,19533,204,32,7.0,True,25.003533333333333,-2058,-3,0,243,236,7
BR1_2730593062,6,True,0,0,0,16920,234,48,7.0,True,6,False,0,1,0,18136,241,63,7.4,False,28.509716666666666,-1216,0,0,282,304,-22
BR1_2730169742,7,False,0,0,0,17569,239,52,7.4,False,8,True,1,1,0,18931,264,54,7.6,True,28.01343333333333,-1362,-1,-1,291,318,-27
BR1_2731030328,12,True,0,0,0,20106,210,60,6.8,True,9,False,0,0,0,18173,193,60,6.8,False,25.709116666666667,1933,3,0,270,253,17
BR1_2731688133,5,False,0,0,0,16406,183,60,7.2,False,7,True,1,0,0,17769,218,52,7.4,True,28.273183333333332,-1363,-2,-1,243,270,-27
BR1_2731825083,11,True,0,0,0,17334,212,52,7.0,True,6,False,0,0,0,15639,218,40,6.6,False,26.96751666666667,1695,5,0,264,258,6
BR1_2731782656,7,False,0,0,0,18337,229,64,7.0,False,8,True,1,0,0,18144,238,59,6.8,True,27.8038,193,-1,-1,293,297,-4
BR1_2731752249,5,True,0,0,0,17316,228,44,6.8,False,9,False,1,1,0,20739,257,75,7.8,True,27.628083333333333,-3423,-4,-1,272,332,-60
BR1_2731145757,5,True,1,1,0,18655,237,60,7.2,False,13,False,0,0,0,19518,203,60,7.4,True,28.890716666666666,-863,-8,1,297,263,34
BR1_2730744088,12,True,1,0,0,19453,222,55,7.6,True,7,False,0,1,0,17980,195,64,7.2,False,29.667583333333333,1473,5,1,277,259,18
BR1_2731061448,3,False,1,0,0,16429,234,52,7.0,False,5,True,0,1,0,18489,295,60,7.8,True,29.496816666666668,-2060,-2,1,286,355,-69
BR1_2728629962,8,True,1,0,0,17889,228,59,7.0,True,5,False,0,1,0,15199,183,64,6.8,False,25.852116666666667,2690,3,1,287,247,40
BR1_2730697217,7,False,1,0,0,16701,198,63,7.2,False,6,True,0,0,0,17467,218,64,7.2,True,29.814316666666667,-766,1,1,261,282,-21
BR1_2731660137,8,True,1,0,1,19271,232,46,7.0,True,9,False,0,0,0,20047,250,52,7.4,False,28.22975,-776,-1,1,278,302,-24
BR1_2730103780,9,True,1,0,0,18934,227,68,7.8,False,2,False,0,1,0,16273,246,68,7.4,True,27.914533333333335,2661,7,1,295,314,-19
BR1_2731809194,7,False,0,0,1,16310,201,62,6.8,False,9,True,0,0,0,19524,226,54,6.8,True,25.467216666666666,-3214,-2,0,263,280,-17
BR1_2730535335,5,False,0,1,0,18040,248,72,7.8,False,7,True,0,0,0,19923,277,68,7.6,True,28.33695,-1883,-2,0,320,345,-25
BR1_2728103303,19,True,0,0,0,21071,210,56,7.4,True,6,False,0,0,0,18388,216,48,7.2,False,28.072616666666665,2683,13,0,266,264,2
BR1_2728092051,6,True,0,0,0,17265,200,56,7.6,True,4,False,0,0,0,17090,262,67,7.6,False,28.14705,175,2,0,256,329,-73
BR1_2731113802,7,False,0,0,0,19641,268,67,7.2,True,3,True,0,0,0,17381,241,52,7.0,False,28.116216666666666,2260,4,0,335,293,42
BR1_2731017595,8,False,1,0,0,18956,236,80,7.2,True,9,True,0,0,0,17728,202,47,6.8,False,28.997883333333334,1228,-1,1,316,249,67
BR1_2726556398,8,False,0,0,0,19638,220,64,7.2,False,12,True,1,0,0,19982,223,36,7.2,True,27.67355,-344,-4,-1,284,259,25
BR1_2731877943,8,True,0,0,0,19046,253,56,7.4,False,7,False,1,0,0,17696,222,68,7.4,True,29.2491,1350,1,-1,309,290,19
BR1_2731772891,4,False,0,0,0,14748,196,44,6.4,False,8,True,0,1,0,17231,198,48,7.2,True,26.4776,-2483,-4,0,240,246,-6
BR1_2731157212,6,True,0,0,0,17912,221,52,7.6,False,5,False,1,0,0,16870,225,48,7.2,True,29.704766666666668,1042,1,-1,273,273,0
BR1_2727821986,7,False,0,0,0,17117,180,52,6.8,False,14,True,0,1,1,20541,206,48,7.2,True,27.198833333333333,-3424,-7,0,232,254,-22
BR1_2730936804,11,False,0,0,0,19072,209,64,7.0,True,9,True,1,0,0,17416,202,56,6.8,False,26.0145,1656,2,-1,273,258,15
BR1_2730433941,4,True,0,0,0,16123,188,64,6.8,False,6,False,1,0,0,16478,223,64,7.2,True,26.009716666666666,-355,-2,-1,252,287,-35
BR1_2721571929,8,True,0,0,0,17979,210,52,6.8,True,8,False,1,1,0,16405,182,38,7.0,False,25.091216666666668,1574,0,-1,262,220,42
BR1_2720191037,12,True,1,0,0,20275,271,52,7.4,True,7,False,0,0,0,17942,196,60,7.0,False,29.967133333333333,2333,5,1,323,256,67
BR1_2729063197,6,False,1,0,0,17698,235,67,7.4,False,8,True,0,0,0,19736,231,60,7.6,True,28.972,-2038,-2,1,302,291,11
BR1_2731775483,7,False,0,0,0,16592,183,44,6.6,False,10,True,0,0,0,18809,212,64,7.0,True,26.15425,-2217,-3,0,227,276,-49
BR1_2731803578,8,False,0,0,0,18584,227,53,7.2,False,6,True,1,0,0,17782,212,51,7.2,True,28.085633333333334,802,2,-1,280,263,17
BR1_2731746842,10,True,1,0,0,17829,222,46,7.0,True,4,False,0,0,0,14402,181,48,6.2,False,25.640766666666668,3427,6,1,268,229,39
BR1_2728675132,6,False,0,0,0,17778,220,71,7.2,False,8,True,1,0,1,19914,231,52,7.0,True,29.669966666666667,-2136,-2,-1,291,283,8
BR1_2722750121,10,False,1,0,0,17984,194,48,7.0,False,9,True,0,1,0,18378,203,56,7.0,True,25.66885,-394,1,1,242,259,-17
BR1_2731776209,12,True,1,0,0,19110,204,48,7.0,True,7,False,0,1,0,17482,239,36,7.0,False,29.611183333333333,1628,5,1,252,275,-23
BR1_2731130371,4,True,0,0,0,17455,229,64,7.0,True,6,False,2,1,1,19149,255,60,7.2,False,29.621416666666665,-1694,-2,-2,293,315,-22
BR1_2731112477,4,True,1,0,0,16543,263,68,7.0,True,2,False,0,0,0,13770,204,52,6.6,False,26.359466666666666,2773,2,1,331,256,75
BR1_2726825277,4,True,1,1,0,16241,231,51,6.8,True,3,False,0,0,0,15458,213,68,6.8,False,26.465416666666666,783,1,1,282,281,1
BR1_2731469976,7,False,0,0,0,17886,225,44,6.6,False,15,True,1,0,0,20576,207,44,7.2,True,28.593183333333332,-2690,-8,-1,269,251,18
BR1_2730322095,10,True,1,0,0,17823,193,56,6.6,True,4,False,0,0,0,14186,171,47,6.4,False,25.1102,3637,6,1,249,218,31
BR1_2731228500,6,False,0,0,0,17530,247,60,7.0,False,10,True,0,0,0,19169,232,60,6.8,True,26.49405,-1639,-4,0,307,292,15
BR1_2731203218,3,False,1,0,0,14672,202,64,6.8,False,6,True,0,1,0,16634,201,44,6.8,True,26.61505,-1962,-3,1,266,245,21
BR1_2730734043,4,False,0,0,0,15864,229,60,7.0,False,8,True,1,1,0,17961,205,60,7.0,True,26.07775,-2097,-4,-1,289,265,24
BR1_2730226713,6,False,1,1,0,18216,250,58,7.6,True,6,True,0,0,0,18039,262,53,7.6,False,28.795716666666667,177,0,1,308,315,-7
BR1_2731722496,9,False,0,0,0,17540,196,46,6.6,True,9,True,0,0,0,18212,200,56,7.0,False,27.355766666666668,-672,0,0,242,256,-14
BR1_2720226767,6,False,0,0,0,15417,205,60,6.6,True,6,True,0,0,0,15807,211,52,7.0,False,26.581916666666668,-390,0,0,265,263,2
BR1_2720215031,8,False,1,1,1,19133,215,68,7.0,True,8,True,0,0,0,17877,227,44,6.8,False,27.12085,1256,0,1,283,271,12
BR1_2731572187,15,False,1,0,0,19317,193,34,6.6,True,14,True,0,1,0,20221,185,57,6.6,False,27.449166666666667,-904,1,1,227,242,-15
BR1_2731529969,7,False,0,0,0,17928,249,56,7.6,True,5,True,0,0,0,17606,256,56,7.0,False,29.42225,322,2,0,305,312,-7
BR1_2730955149,10,False,0,1,0,18440,210,50,7.0,True,9,True,0,0,0,17196,193,40,6.8,False,25.253566666666668,1244,1,0,260,233,27
BR1_2730637718,7,True,1,0,0,15950,171,44,6.6,False,7,False,0,0,0,17189,195,52,7.0,True,27.12911666666667,-1239,0,1,215,247,-32
BR1_2730061990,14,True,1,0,0,19137,182,60,6.8,False,10,False,0,0,0,17340,178,47,6.4,True,25.69765,1797,4,1,242,225,17
BR1_2730036338,5,True,0,0,0,16910,237,43,7.0,True,4,False,1,0,0,15177,194,52,6.8,False,25.73068333333333,1733,1,-1,280,246,34
BR1_2730206781,3,True,0,1,0,17390,233,62,7.2,False,5,False,1,0,0,17794,239,64,7.4,True,29.296783333333334,-404,-2,-1,295,303,-8
BR1_2728898921,6,True,1,0,0,15277,167,50,6.4,False,9,False,0,0,0,17127,210,55,6.8,True,25.9656,-1850,-3,1,217,265,-48
BR1_2729671409,8,True,0,1,0,18495,229,56,7.4,False,6,False,1,0,0,18298,246,48,7.0,True,29.7421,197,2,-1,285,294,-9
BR1_2729642611,8,False,0,0,0,16253,165,47,6.6,False,9,True,1,0,0,17685,202,48,6.8,True,27.180216666666666,-1432,-1,-1,212,250,-38
BR1_2727799753,10,False,0,0,0,19450,220,58,7.0,False,13,True,1,0,0,21343,251,64,7.6,True,28.48966666666667,-1893,-3,-1,278,315,-37
BR1_2729575993,10,True,0,1,0,19177,251,48,7.8,False,9,False,0,0,0,18839,226,76,7.6,True,29.096016666666667,338,1,0,299,302,-3
BR1_2731773547,4,True,0,0,0,16558,210,60,7.2,False,13,False,1,0,0,21588,247,63,7.6,True,28.744183333333332,-5030,-9,-1,270,310,-40
BR1_2729910741,7,False,0,0,0,18461,205,62,7.2,False,17,True,1,0,0,22116,222,52,7.4,True,28.07435,-3655,-10,-1,267,274,-7
BR1_2729886360,4,False,0,0,0,14966,209,40,6.8,False,5,True,1,0,0,16879,199,72,6.6,True,26.586,-1913,-1,-1,249,271,-22
BR1_2731768911,12,False,1,1,0,21263,228,72,7.4,False,11,True,0,0,0,19643,197,56,7.2,True,28.43015,1620,1,1,300,253,47
BR1_2726018656,7,False,1,0,0,16781,207,59,7.0,True,5,True,0,1,0,16007,202,52,7.0,False,26.590483333333335,774,2,1,266,254,12
BR1_2731728057,7,True,1,0,0,16757,188,55,6.8,True,7,False,0,1,0,15764,172,56,6.2,False,26.92653333333333,993,0,1,243,228,15
BR1_2731549339,5,True,0,0,0,17793,231,56,7.0,True,6,False,1,1,0,15677,200,48,7.0,False,26.030483333333333,2116,-1,-1,287,248,39
BR1_2731726328,9,True,0,1,0,18682,233,52,7.2,True,14,False,1,0,0,21086,253,56,7.6,False,28.607233333333333,-2404,-5,-1,285,309,-24
BR1_2727989899,8,False,0,1,0,17962,238,64,7.0,True,3,True,0,0,0,14996,181,56,6.8,False,26.944533333333332,2966,5,0,302,237,65
BR1_2731858433,4,True,1,0,0,16256,233,44,7.0,False,2,False,0,1,0,16619,229,68,7.0,True,29.507666666666665,-363,2,1,277,297,-20
BR1_2725496847,7,True,0,1,0,17959,209,56,6.8,True,8,False,1,0,0,17438,184,64,6.8,False,27.0553,521,-1,-1,265,248,17
BR1_2724448266,9,True,0,1,0,19230,227,76,7.4,False,10,False,1,0,0,21387,243,60,7.4,True,27.502316666666665,-2157,-1,-1,303,303,0
BR1_2706769206,11,False,1,0,0,21123,268,54,7.6,True,7,True,0,0,0,19075,238,48,7.2,False,28.0114,2048,4,1,322,286,36
BR1_2705137029,12,False,1,0,0,18618,231,56,7.2,True,4,True,0,0,0,15361,199,55,6.6,False,26.461883333333333,3257,8,1,287,254,33
BR1_2730069315,6,True,0,0,0,15745,194,43,6.8,False,6,False,1,0,0,17510,262,52,7.2,True,27.018583333333332,-1765,0,-1,237,314,-77
BR1_2729583205,9,False,0,1,0,18638,212,52,7.2,True,7,True,0,0,0,16024,207,56,6.8,False,25.590183333333332,2614,2,0,264,263,1
BR1_2730247970,10,True,0,0,0,18396,211,40,6.6,False,13,False,0,0,0,20008,188,56,6.8,True,26.465683333333335,-1612,-3,0,251,244,7
BR1_2728103014,6,False,0,1,0,17417,217,62,7.4,True,10,True,1,0,0,20683,253,76,7.8,False,28.275383333333334,-3266,-4,-1,279,329,-50
BR1_2731711630,12,False,0,1,0,20445,217,48,7.4,False,17,True,0,0,0,22640,226,40,7.2,True,28.441483333333334,-2195,-5,0,265,266,-1
BR1_2731590170,8,False,0,0,0,19003,218,55,7.4,False,10,True,1,1,0,19740,220,70,7.6,True,27.890283333333333,-737,-2,-1,273,290,-17
BR1_2731219731,8,True,0,1,0,17906,199,51,7.2,False,7,False,1,0,0,17417,208,60,7.2,True,28.145583333333335,489,1,-1,250,268,-18
BR1_2730711953,6,False,0,1,0,16850,199,68,6.8,False,9,True,1,0,0,18267,249,47,7.0,True,26.207133333333335,-1417,-3,-1,267,296,-29
BR1_2730388685,7,False,1,0,0,18047,246,56,7.2,True,5,True,0,1,1,17839,203,52,7.0,False,27.63596666666667,208,2,1,302,255,47
BR1_2730376481,7,True,0,1,0,18756,234,72,7.4,False,6,False,1,0,0,17541,247,56,7.2,True,29.5705,1215,1,-1,306,303,3
BR1_2721427174,9,True,1,1,1,20648,275,58,7.8,True,2,False,0,0,0,15846,238,64,7.2,False,28.560116666666666,4802,7,1,333,302,31
BR1_2731032485,5,False,0,1,0,15527,184,60,7.0,False,6,True,0,0,0,16427,220,72,7.2,True,26.953033333333334,-900,-1,0,244,292,-48
BR1_2730708520,2,False,0,0,0,16371,220,52,6.8,False,11,True,1,1,0,18908,218,60,7.6,True,28.111583333333332,-2537,-9,-1,272,278,-6
BR1_2730687099,8,False,0,0,0,15838,174,44,6.6,False,8,True,1,0,0,17404,209,56,7.0,True,26.779466666666668,-1566,0,-1,218,265,-47
BR1_2723489813,9,True,0,0,0,18698,253,48,7.2,False,9,False,1,1,0,18820,262,59,7.6,True,29.040983333333333,-122,0,-1,301,321,-20
BR1_2728982153,10,False,1,0,0,18515,207,52,6.8,True,7,True,0,0,0,16104,171,44,6.4,False,26.863983333333334,2411,3,1,259,215,44
BR1_2730782628,4,False,0,1,0,16203,224,68,7.0,True,8,True,1,0,0,17997,229,60,6.8,False,26.41965,-1794,-4,-1,292,289,3
BR1_2729547234,14,True,0,0,0,19332,189,47,6.6,True,8,False,0,0,0,16807,173,56,6.6,False,26.1336,2525,6,0,236,229,7
BR1_2731594251,9,True,1,0,0,19688,249,60,7.6,True,7,False,0,1,0,18899,247,72,7.4,False,28.56235,789,2,1,309,319,-10
BR1_2728421473,6,False,1,0,0,17761,229,64,7.6,False,9,True,0,1,0,20989,288,60,7.6,True,28.301983333333332,-3228,-3,1,293,348,-55
BR1_2724575184,5,False,0,0,0,15788,192,44,6.4,False,7,True,1,0,0,16981,233,51,6.8,True,26.631383333333332,-1193,-2,-1,236,284,-48
BR1_2731921206,5,True,1,0,0,15565,224,56,6.8,False,9,False,0,1,0,18784,245,68,7.6,True,27.08155,-3219,-4,1,280,313,-33
BR1_2731013831,6,False,0,1,0,18141,253,65,7.8,True,8,True,1,0,0,18899,238,56,7.2,False,28.977666666666668,-758,-2,-1,318,294,24
BR1_2731644425,7,False,0,0,0,18162,200,52,7.0,False,9,True,0,0,0,19158,240,59,7.2,True,29.598033333333333,-996,-2,0,252,299,-47
BR1_2724190828,11,True,1,0,0,18069,181,68,6.6,True,5,False,0,0,0,15469,218,47,7.0,False,26.046716666666665,2600,6,1,249,265,-16
BR1_2728155563,4,False,1,1,0,18243,265,84,8.0,True,3,True,0,0,0,16894,245,60,7.4,False,27.781666666666666,1349,1,1,349,305,44
BR1_2729668012,9,False,0,1,0,18618,195,36,7.4,False,16,True,1,0,0,22741,231,80,7.8,True,27.72355,-4123,-7,-1,231,311,-80
BR1_2725896848,8,True,0,0,0,18489,220,47,7.2,False,12,False,0,1,0,20324,212,52,7.4,True,27.512933333333333,-1835,-4,0,267,264,3
BR1_2715973734,2,False,0,1,0,16122,224,76,7.0,False,7,True,1,0,0,19382,256,60,7.6,True,28.34345,-3260,-5,-1,300,316,-16
BR1_2715479779,5,True,0,0,0,16392,194,64,6.8,True,4,False,0,0,0,15232,225,60,6.8,False,26.376633333333334,1160,1,0,258,285,-27
BR1_2713201340,6,False,0,0,0,17959,260,66,7.4,True,8,True,0,0,0,16216,185,42,6.8,False,26.204616666666666,1743,-2,0,326,227,99
BR1_2712719019,9,True,1,0,0,17234,242,56,7.0,False,6,False,0,0,0,16397,201,68,6.8,True,25.4264,837,3,1,298,269,29
BR1_2722547743,8,False,0,0,0,19227,241,84,7.8,False,7,True,1,0,0,17458,229,44,7.0,True,29.6915,1769,1,-1,325,273,52
BR1_2721881812,4,False,0,0,0,15613,235,52,7.0,True,5,True,1,0,0,15448,207,50,6.4,False,25.488016666666667,165,-1,-1,287,257,30
BR1_2726144973,7,False,0,0,0,17855,192,60,7.2,False,12,True,1,0,0,21009,238,56,7.4,True,29.857116666666666,-3154,-5,-1,252,294,-42
BR1_2731004960,7,True,0,0,0,17947,239,51,7.2,True,3,False,1,0,0,17048,251,74,7.4,False,29.893016666666668,899,4,-1,290,325,-35
BR1_2728715533,3,False,0,1,0,15666,236,60,7.0,True,6,True,1,0,0,17761,254,72,7.4,False,26.140133333333335,-2095,-3,-1,296,326,-30
BR1_2731330649,11,False,1,1,1,20987,227,68,7.0,True,12,True,0,0,0,20837,210,60,7.4,False,29.730516666666666,150,-1,1,295,270,25
BR1_2731488489,3,False,0,0,0,14901,228,49,7.0,False,5,True,1,1,0,16553,211,78,7.2,True,27.288433333333334,-1652,-2,-1,277,289,-12
BR1_2731029998,6,False,0,1,0,17349,218,55,7.0,False,8,True,1,0,0,16316,181,60,7.2,True,26.761066666666668,1033,-2,-1,273,241,32
BR1_2729974760,6,False,1,0,0,15511,192,72,7.0,False,8,True,0,0,0,18232,223,52,6.8,True,25.38596666666667,-2721,-2,1,264,275,-11
BR1_2731629514,8,True,0,1,0,19618,236,56,7.2,False,11,False,1,0,0,21288,252,72,7.8,True,28.3047,-1670,-3,-1,292,324,-32
BR1_2731873012,9,True,1,1,0,19492,234,60,7.0,True,13,False,0,0,0,20149,213,48,7.0,False,28.965,-657,-4,1,294,261,33
BR1_2731855825,6,True,0,0,0,16467,229,39,7.2,False,6,False,1,0,0,17200,220,63,6.8,True,26.780566666666665,-733,0,-1,268,283,-15
BR1_2729685070,9,False,1,0,0,18885,231,55,7.2,True,3,True,0,1,0,16302,209,64,7.2,False,27.601766666666666,2583,6,1,286,273,13
BR1_2729657089,9,True,0,0,0,19352,255,48,7.4,True,4,False,0,0,0,17409,217,62,7.2,False,28.810283333333334,1943,5,0,303,279,24
BR1_2728513767,8,False,0,1,0,17116,188,65,7.2,True,6,True,0,0,0,16292,227,34,6.6,False,27.01185,824,2,0,253,261,-8
BR1_2728484232,4,False,0,0,0,15157,182,48,6.6,False,11,True,0,0,1,20043,227,56,7.0,True,25.6752,-4886,-7,0,230,283,-53
BR1_2728451291,10,True,0,0,0,17381,190,40,6.6,True,7,False,0,0,0,16193,196,60,6.6,False,25.14405,1188,3,0,230,256,-26
BR1_2728847071,8,False,1,0,0,16525,223,43,6.8,True,4,True,0,0,0,14806,199,51,6.4,False,25.0141,1719,4,1,266,250,16
BR1_2729822914,8,True,1,0,0,17702,216,56,7.0,True,4,False,0,0,0,14588,180,48,6.6,False,27.467016666666666,3114,4,1,272,228,44
BR1_2729823563,11,False,0,1,0,19457,216,40,7.2,True,12,True,1,0,0,21075,215,52,7.4,False,28.63365,-1618,-1,-1,256,267,-11
BR1_2729812973,1,True,0,0,0,14219,201,68,6.8,False,8,False,1,1,0,17935,229,56,7.2,True,26.94195,-3716,-7,-1,269,285,-16
BR1_2722073465,9,False,0,0,0,18423,211,48,6.4,True,8,True,0,0,0,16469,173,44,6.8,False,27.24075,1954,1,0,259,217,42
BR1_2722065445,15,False,1,0,0,22328,249,49,7.4,True,6,True,0,0,0,17405,218,58,6.6,False,29.628266666666665,4923,9,1,298,276,22
BR1_2731803920,8,False,0,0,0,16610,178,60,7.2,False,3,True,1,0,0,16442,242,60,7.0,True,26.042933333333334,168,5,-1,238,302,-64
BR1_2730897790,8,False,0,1,0,17436,180,68,7.0,True,9,True,1,0,0,16903,205,43,6.8,False,26.2742,533,-1,-1,248,248,0
BR1_2730895615,9,False,1,0,0,17719,246,55,6.8,True,4,True,0,0,0,15324,219,48,7.0,False,26.843533333333333,2395,5,1,301,267,34
BR1_2730889605,6,True,0,0,0,16947,215,52,7.0,False,6,False,0,1,0,16537,200,60,7.2,True,25.798633333333335,410,0,0,267,260,7
BR1_2730774601,2,True,0,0,0,15515,198,48,7.0,False,3,False,1,0,0,16201,231,68,7.2,True,29.658883333333332,-686,-1,-1,246,299,-53
BR1_2730753274,1,False,0,0,0,12749,142,68,6.6,False,10,True,0,0,0,18671,233,56,7.0,True,25.234833333333334,-5922,-9,0,210,289,-79
BR1_2723360478,9,True,0,1,0,19660,219,60,7.2,False,5,False,1,0,0,16606,206,43,6.6,True,29.098883333333333,3054,4,-1,279,249,30
BR1_2731932574,2,False,0,1,0,14884,200,52,6.8,False,6,True,1,0,0,16986,222,57,7.4,True,26.30245,-2102,-4,-1,252,279,-27
BR1_2722487022,4,False,1,0,0,16482,233,68,7.2,True,1,True,0,0,0,13753,221,52,6.6,False,26.01535,2729,3,1,301,273,28
BR1_2731922573,7,True,0,1,1,19938,250,56,7.2,False,4,False,1,0,0,16798,219,64,7.2,True,28.0905,3140,3,-1,306,283,23
BR1_2731544629,11,True,1,0,0,20119,264,60,7.6,True,8,False,0,1,0,18428,229,76,7.4,False,29.757933333333334,1691,3,1,324,305,19
BR1_2730547533,7,True,1,0,0,16676,199,58,7.0,True,4,False,0,0,0,15483,204,56,6.8,False,27.430716666666665,1193,3,1,257,260,-3
BR1_2730537119,6,False,0,0,0,17115,210,56,6.8,False,9,True,1,0,0,18267,207,67,7.2,True,26.525466666666667,-1152,-3,-1,266,274,-8
BR1_2729390710,14,True,1,0,0,20437,237,52,7.2,False,10,False,0,1,0,20163,204,48,6.8,True,28.554383333333334,274,4,1,289,252,37
BR1_2731672671,12,True,0,0,0,19612,236,52,7.2,False,7,False,1,0,0,18024,228,52,6.8,True,29.779733333333333,1588,5,-1,288,280,8
BR1_2731480792,5,False,0,0,0,17900,229,56,7.0,False,8,True,1,0,0,19276,239,68,7.2,True,29.263033333333333,-1376,-3,-1,285,307,-22
BR1_2729980370,8,True,0,0,0,17118,177,44,6.6,False,8,False,1,1,0,17665,223,52,7.0,True,25.80105,-547,0,-1,221,275,-54
BR1_2729900722,9,True,0,0,0,17260,196,36,6.4,False,9,False,1,0,0,17674,208,60,6.6,True,25.397633333333335,-414,0,-1,232,268,-36
BR1_2729876305,7,True,0,0,0,18299,205,60,7.6,True,6,False,1,0,0,17266,244,68,7.2,False,28.113683333333334,1033,1,-1,265,312,-47
BR1_2731787048,6,False,0,0,0,15240,171,40,6.6,False,11,True,0,0,0,18917,218,51,6.8,True,25.944433333333333,-3677,-5,0,211,269,-58
BR1_2730792612,10,True,1,0,0,17539,195,48,7.0,True,7,False,0,0,0,16586,199,48,6.6,False,26.43485,953,3,1,243,247,-4
BR1_2718682160,9,False,0,1,0,19733,261,68,7.4,True,6,True,1,0,0,17803,215,60,7.2,False,29.35408333333333,1930,3,-1,329,275,54
BR1_2717769961,5,False,0,1,0,17554,212,60,7.2,False,6,True,1,0,0,17814,261,51,7.4,True,29.644666666666666,-260,-1,-1,272,312,-40
BR1_2717768638,8,True,1,1,1,19404,236,48,7.4,False,5,False,0,0,0,17654,227,79,7.4,True,28.65355,1750,3,1,284,306,-22
BR1_2730835873,10,False,0,0,0,18788,214,52,7.0,False,6,True,1,0,0,16495,196,60,7.0,True,25.051683333333333,2293,4,-1,266,256,10
BR1_2730799736,11,True,0,0,0,18878,240,48,7.2,False,5,False,1,1,0,18427,219,80,7.2,True,29.9941,451,6,-1,288,299,-11
BR1_2731360203,7,True,0,0,0,16951,209,30,6.6,False,6,False,0,0,0,16237,218,62,7.0,True,27.493533333333332,714,1,0,239,280,-41
BR1_2728190423,5,True,0,1,0,16552,220,68,7.2,False,5,False,1,0,0,16187,230,60,7.0,True,25.023533333333333,365,0,-1,288,290,-2
BR1_2730934642,4,False,0,1,0,17533,280,58,7.6,False,7,True,1,0,0,19428,263,56,7.4,True,29.927516666666666,-1895,-3,-1,338,319,19
BR1_2730656034,7,True,0,1,0,16859,205,60,6.8,False,9,False,1,0,0,17528,209,60,7.0,True,27.312883333333332,-669,-2,-1,265,269,-4
BR1_2730941541,8,True,0,0,0,19332,278,50,7.2,True,4,False,1,0,0,16870,246,78,7.2,False,29.670866666666665,2462,4,-1,328,324,4
BR1_2727862552,3,False,0,0,0,15474,207,56,6.8,True,10,True,1,0,0,18421,223,60,7.2,False,27.289266666666666,-2947,-7,-1,263,283,-20
BR1_2727377240,13,True,1,0,0,19412,203,44,6.4,True,15,False,0,0,0,20030,182,52,6.8,False,27.451516666666667,-618,-2,1,247,234,13
BR1_2731055049,9,False,0,1,0,17079,197,52,6.8,True,10,True,1,0,0,17401,185,48,7.0,False,26.136183333333335,-322,-1,-1,249,233,16
BR1_2722829279,9,False,0,0,0,18214,189,64,7.2,True,3,True,1,0,0,14994,192,72,6.6,False,26.031666666666666,3220,6,-1,253,264,-11
BR1_2729962118,8,False,0,0,0,17602,212,67,7.4,False,5,True,0,1,0,17065,227,60,7.4,True,28.3912,537,3,0,279,287,-8
BR1_2731576699,5,False,0,1,0,18261,265,52,7.4,True,7,True,0,0,0,18081,218,56,7.4,False,29.802583333333335,180,-2,0,317,274,43
BR1_2726451361,5,True,0,0,0,17111,210,67,7.0,False,4,False,1,0,0,17172,264,64,7.4,True,29.029533333333333,-61,1,-1,277,328,-51
BR1_2731769336,5,False,1,0,0,17687,241,52,7.4,False,6,True,0,1,0,17532,241,72,7.6,True,29.38693333333333,155,-1,1,293,313,-20
BR1_2731705882,11,True,1,0,0,17022,207,52,7.0,False,9,False,0,1,0,18084,237,52,7.0,True,27.490766666666666,-1062,2,1,259,289,-30
BR1_2723878469,7,True,0,1,0,17404,193,56,7.2,False,9,False,1,0,0,19152,226,52,7.4,True,29.595916666666668,-1748,-2,-1,249,278,-29
BR1_2731267771,3,False,0,1,0,14259,181,40,6.6,False,10,True,1,0,0,19142,222,64,7.0,True,26.147283333333334,-4883,-7,-1,221,286,-65
BR1_2731422434,7,True,0,1,1,21513,291,48,7.6,True,4,False,0,0,0,16229,216,60,7.2,False,27.797016666666668,5284,3,0,339,276,63
BR1_2731321098,11,True,1,0,0,18747,228,52,7.0,True,3,False,0,1,0,15379,212,42,6.6,False,27.459716666666665,3368,8,1,280,254,26
BR1_2731296540,7,True,0,0,0,18199,225,52,7.4,False,7,False,1,0,0,18242,235,55,7.2,True,27.692983333333334,-43,0,-1,277,290,-13
BR1_2731259367,10,False,0,0,0,17926,187,47,6.6,False,10,True,1,0,0,19030,191,64,6.8,True,25.443316666666668,-1104,0,-1,234,255,-21
BR1_2731480643,6,False,0,0,0,16862,207,39,6.6,True,7,True,1,0,0,16970,225,51,6.6,False,25.3483,-108,-1,-1,246,276,-30
BR1_2730657335,2,True,1,0,0,14235,179,64,6.6,True,5,False,0,0,0,14792,172,44,6.6,False,25.185533333333332,-557,-3,1,243,216,27
BR1_2730608369,5,True,0,1,0,15202,169,58,7.0,True,7,False,1,0,0,16413,208,53,6.8,False,25.67745,-1211,-2,-1,227,261,-34
BR1_2731915831,10,True,1,0,0,19978,256,56,7.4,True,8,False,0,0,0,20001,252,44,7.6,False,28.512766666666668,-23,2,1,312,296,16
BR1_2724719184,11,False,1,0,0,18166,213,44,7.0,True,6,True,0,0,0,15893,151,44,6.6,False,25.233016666666668,2273,5,1,257,195,62
BR1_2731619545,8,True,0,0,0,18761,232,52,7.6,False,6,False,0,0,0,19072,282,60,7.4,True,28.961333333333332,-311,2,0,284,342,-58
BR1_2731569341,3,False,1,0,0,16023,228,56,7.0,False,15,True,0,1,0,22375,261,67,7.8,True,27.996616666666668,-6352,-12,1,284,328,-44
BR1_2730849361,9,True,0,0,0,18958,224,48,7.0,True,5,False,1,0,0,15105,199,43,6.2,False,26.504266666666666,3853,4,-1,272,242,30
BR1_2730831810,11,True,1,1,0,20022,179,76,7.2,True,10,False,0,0,1,21592,245,46,7.2,False,28.3427,-1570,1,1,255,291,-36
BR1_2730817500,8,True,0,0,0,19495,239,60,7.6,False,7,False,1,0,0,18553,274,56,7.2,True,27.71613333333333,942,1,-1,299,330,-31
BR1_2731652164,8,False,0,0,0,18889,247,62,7.4,False,7,True,1,0,0,18275,216,69,7.2,True,29.953783333333334,614,1,-1,309,285,24
BR1_2731044887,6,True,0,1,0,17570,247,58,7.0,True,2,False,1,0,0,14143,193,62,6.6,False,25.0553,3427,4,-1,305,255,50
BR1_2727348865,5,True,1,0,0,16255,205,56,6.8,True,7,False,0,1,0,17075,227,60,7.0,False,25.848766666666666,-820,-2,1,261,287,-26
BR1_2728698160,14,False,1,0,0,21028,241,80,7.4,True,9,True,0,0,0,18903,204,47,7.4,False,29.906833333333335,2125,5,1,321,251,70
BR1_2722648034,7,True,0,0,0,18030,227,60,7.4,False,6,False,1,0,0,17617,204,68,7.4,True,27.7081,413,1,-1,287,272,15
BR1_2730200992,6,False,0,0,0,16875,234,44,6.8,True,3,True,1,0,0,15315,219,53,6.6,False,25.157066666666665,1560,3,-1,278,272,6
BR1_2729748918,12,False,0,0,0,21533,237,48,6.8,False,12,True,1,1,0,21158,236,72,7.8,True,28.87255,375,0,-1,285,308,-23
BR1_2731498855,11,True,0,0,0,20873,232,64,7.4,False,14,False,0,1,0,20541,206,48,7.6,True,29.701266666666665,332,-3,0,296,254,42
BR1_2731487302,12,True,0,0,0,18153,213,44,6.8,True,4,False,1,0,0,14271,155,56,6.2,False,26.730933333333333,3882,8,-1,257,211,46
BR1_2731473442,11,False,1,1,0,18302,197,44,6.6,True,8,True,0,0,0,16949,212,48,6.8,False,26.356266666666667,1353,3,1,241,260,-19
BR1_2729923072,4,True,0,0,0,15196,201,52,6.8,False,6,False,1,0,0,16420,228,48,6.8,True,26.88625,-1224,-2,-1,253,276,-23
BR1_2731753818,7,False,1,0,0,17422,230,68,7.0,True,6,True,0,0,0,15189,171,44,6.8,False,26.171216666666666,2233,1,1,298,215,83
BR1_2731604075,5,False,0,1,1,17604,230,54,7.2,True,4,True,0,0,0,15574,199,46,6.6,False,26.4371,2030,1,0,284,245,39
BR1_2731299406,21,True,0,0,0,23657,207,67,7.2,True,6,False,0,0,0,17653,167,49,6.6,False,27.70405,6004,15,0,274,216,58
BR1_2729637657,3,True,0,0,0,16892,266,60,7.6,False,6,False,1,1,0,18587,255,68,7.8,True,29.163,-1695,-3,-1,326,323,3
BR1_2730606760,12,True,1,1,0,19547,234,40,7.2,True,10,False,0,0,0,19740,235,51,7.4,False,28.036383333333333,-193,2,1,274,286,-12
BR1_2724642218,7,True,1,1,0,19047,256,80,7.8,True,4,False,0,0,0,16947,244,68,7.2,False,29.847,2100,3,1,336,312,24
BR1_2724612942,9,True,0,0,0,19499,229,60,7.0,True,3,False,0,1,0,16543,230,66,7.2,False,29.026516666666666,2956,6,0,289,296,-7
BR1_2729762111,11,False,0,1,0,21522,244,60,7.8,True,8,True,0,0,0,18057,219,64,7.2,False,27.5765,3465,3,0,304,283,21
BR1_2718576085,7,False,0,0,0,18040,243,56,7.6,True,2,True,0,0,0,15460,230,48,7.0,False,28.157116666666667,2580,5,0,299,278,21
BR1_2731367172,8,False,0,0,0,16483,174,60,6.6,False,18,True,1,1,0,22226,235,54,7.8,True,27.504383333333333,-5743,-10,-1,234,289,-55
BR1_2731347165,9,True,0,1,0,19052,211,68,7.2,False,7,False,1,0,0,17808,195,52,7.4,True,29.358483333333332,1244,2,-1,279,247,32
BR1_2731430655,12,True,1,0,0,20063,225,60,7.4,True,3,False,0,1,0,15652,219,52,7.0,False,28.072016666666666,4411,9,1,285,271,14
BR1_2731089962,6,False,0,0,0,16746,219,69,6.8,False,5,True,0,0,0,15895,207,42,6.6,True,26.19236666666667,851,1,0,288,249,39
BR1_2731843532,6,False,0,0,0,17643,220,60,7.4,False,8,True,0,0,0,18197,204,48,7.4,True,28.185116666666666,-554,-2,0,280,252,28
BR1_2731814961,14,False,0,0,0,19810,187,55,7.4,False,8,True,0,1,0,19082,211,60,7.2,True,29.053633333333334,728,6,0,242,271,-29
BR1_2731628436,5,True,0,1,0,18531,263,72,7.4,True,7,False,1,0,0,18611,239,56,7.6,False,28.900666666666666,-80,-2,-1,335,295,40
BR1_2730464343,3,True,0,1,0,14668,185,52,6.4,False,7,False,1,0,0,17177,208,68,6.8,True,25.84855,-2509,-4,-1,237,276,-39
BR1_2720611312,13,True,1,0,0,20511,202,56,7.0,False,11,False,0,0,0,19709,228,59,7.4,True,29.4044,802,2,1,258,287,-29
BR1_2731274438,6,False,1,0,0,17120,248,60,7.4,True,8,True,0,1,0,19623,274,80,8.0,False,29.79606666666667,-2503,-2,1,308,354,-46
BR1_2731749409,5,False,0,1,0,15757,180,64,6.8,False,7,True,1,0,0,16154,200,52,6.8,True,26.549666666666667,-397,-2,-1,244,252,-8
BR1_2731717863,6,True,0,0,0,17152,216,36,6.6,True,8,False,1,0,0,17266,224,59,7.0,False,25.427,-114,-2,-1,252,283,-31
BR1_2731388258,12,True,0,0,1,20687,229,68,7.4,True,5,False,1,1,0,17016,236,64,7.4,False,28.531966666666666,3671,7,-1,297,300,-3
BR1_2730673612,6,False,0,1,0,18713,260,54,7.6,True,6,True,1,0,0,18344,268,60,7.2,False,29.211383333333334,369,0,-1,314,328,-14
BR1_2731809087,8,True,0,0,0,16596,200,36,6.6,False,12,False,1,0,0,19488,217,48,7.0,True,26.2707,-2892,-4,-1,236,265,-29
BR1_2731758339,6,False,0,0,0,16820,207,61,6.8,False,8,True,0,1,0,17494,226,48,6.8,True,25.873316666666668,-674,-2,0,268,274,-6
BR1_2731836269,9,True,0,0,1,19945,226,52,7.4,True,4,False,0,0,0,16331,252,55,7.4,False,29.433,3614,5,0,278,307,-29
BR1_2731820123,6,True,1,0,0,17182,218,44,7.0,True,4,False,0,0,0,16021,235,56,6.6,False,25.817083333333333,1161,2,1,262,291,-29
BR1_2731949605,9,False,1,0,1,19557,206,60,6.8,False,18,True,0,1,1,25776,230,63,7.4,True,27.98415,-6219,-9,1,266,293,-27
BR1_2731908979,12,False,1,1,0,19548,189,68,7.4,True,16,True,0,0,0,22526,213,52,7.4,False,28.542733333333334,-2978,-4,1,257,265,-8
BR1_2725318793,7,False,1,1,0,16416,213,52,6.8,False,6,True,0,0,0,17350,216,56,6.8,True,25.909016666666666,-934,1,1,265,272,-7
BR1_2731964123,4,False,0,0,0,17749,282,62,7.6,True,5,True,0,1,0,17979,258,52,7.6,False,28.739366666666665,-230,-1,0,344,310,34
BR1_2726299554,7,True,1,1,0,18115,247,60,7.4,True,7,False,0,0,0,17872,217,54,7.4,False,29.5307,243,0,1,307,271,36
BR1_2722676261,10,False,1,1,0,19542,221,48,7.2,False,9,True,0,0,0,19102,245,52,7.2,True,29.120833333333334,440,1,1,269,297,-28
BR1_2722660843,10,True,0,0,0,19947,227,52,7.0,False,9,False,1,1,0,18587,232,60,7.4,True,28.671983333333333,1360,1,-1,279,292,-13
BR1_2722649227,7,True,0,0,0,16676,206,40,6.8,True,7,False,0,1,0,16240,185,56,6.8,False,26.6767,436,0,0,246,241,5
BR1_2730737759,12,False,0,0,0,18897,211,52,7.0,True,8,True,0,0,0,18121,179,64,6.8,False,25.610566666666667,776,4,0,263,243,20
BR1_2731711277,8,False,1,0,0,19620,250,60,7.6,False,7,True,0,0,0,18977,239,72,7.8,True,27.731883333333332,643,1,1,310,311,-1
BR1_2728314546,9,True,1,0,0,18196,214,59,7.0,True,5,False,0,0,0,17476,239,64,7.2,False,29.517783333333334,720,4,1,273,303,-30
BR1_2726988127,8,True,0,0,0,17692,211,50,6.8,True,6,False,1,0,0,16515,188,72,6.8,False,26.7548,1177,2,-1,261,260,1
BR1_2725279136,6,False,1,0,0,17572,228,60,7.0,False,10,True,0,0,0,19087,209,52,7.2,True,27.592266666666667,-1515,-4,1,288,261,27
BR1_2725253581,9,False,1,0,0,17741,219,76,7.2,True,6,True,0,0,0,16544,212,44,6.8,False,27.193166666666666,1197,3,1,295,256,39
BR1_2729778186,8,False,1,1,0,17429,210,55,7.4,True,5,True,0,0,0,15981,205,56,6.8,False,27.338483333333333,1448,3,1,265,261,4
BR1_2717709484,6,False,1,0,0,16999,201,56,7.0,False,5,True,0,0,0,15893,195,51,6.6,True,26.4332,1106,1,1,257,246,11
BR1_2730863175,11,True,1,0,0,18132,181,60,7.0,False,8,False,0,1,0,17062,188,68,7.0,True,26.070166666666665,1070,3,1,241,256,-15
BR1_2728422342,7,True,0,0,0,17407,184,60,6.8,False,9,False,1,0,0,19158,256,52,7.6,True,29.517116666666666,-1751,-2,-1,244,308,-64
BR1_2727891814,7,True,0,0,0,16558,190,52,6.4,False,12,False,0,0,0,18892,226,56,7.4,True,26.61815,-2334,-5,0,242,282,-40
BR1_2727870783,12,True,1,0,0,20062,211,60,7.2,True,6,False,0,1,0,14764,193,47,6.4,False,26.992916666666666,5298,6,1,271,240,31
BR1_2731938232,6,False,0,1,0,19624,259,84,7.6,False,7,True,1,0,0,18660,213,68,7.4,True,27.5807,964,-1,-1,343,281,62
BR1_2731928033,0,False,0,0,0,14463,250,60,7.2,False,9,True,0,1,0,18664,233,67,7.4,True,26.908166666666666,-4201,-9,0,310,300,10
BR1_2731408494,7,True,0,0,0,18171,238,63,7.4,False,8,False,0,1,0,17560,207,63,7.2,True,29.65886666666667,611,-1,0,301,270,31
BR1_2731633510,9,True,0,0,0,19611,248,60,7.8,False,7,False,1,0,0,18614,248,64,7.4,True,29.493033333333333,997,2,-1,308,312,-4
BR1_2731517645,7,False,0,0,0,17533,230,56,7.0,False,13,True,1,1,1,22815,240,60,7.2,True,27.696633333333335,-5282,-6,-1,286,300,-14
BR1_2731191902,4,False,1,1,0,17265,251,64,7.2,True,3,True,0,0,0,16581,230,48,6.8,False,28.556083333333333,684,1,1,315,278,37
BR1_2719548577,11,False,0,0,0,19694,262,51,7.2,True,7,True,0,1,0,19056,247,52,7.4,False,28.56185,638,4,0,313,299,14
BR1_2730701816,16,True,1,0,0,21376,198,47,7.0,True,8,False,0,1,0,18233,205,67,7.0,False,28.5317,3143,8,1,245,272,-27
BR1_2730676517,10,True,0,1,0,17118,165,52,6.6,False,8,False,1,0,0,17333,182,56,7.0,True,27.009033333333335,-215,2,-1,217,238,-21
BR1_2719956879,12,True,0,1,0,19344,194,56,7.0,True,5,False,1,0,0,16269,184,56,6.6,False,25.16646666666667,3075,7,-1,250,240,10
BR1_2719944594,10,False,1,0,0,17058,186,48,7.0,False,6,True,0,0,0,17911,217,68,7.0,True,27.4084,-853,4,1,234,285,-51
BR1_2731707675,7,True,1,0,0,18034,211,52,7.0,True,6,False,0,1,0,18025,223,60,7.4,False,29.695566666666668,9,1,1,263,283,-20
BR1_2731933760,7,True,1,0,0,16660,206,52,7.0,False,7,False,0,0,0,18269,233,64,7.0,True,27.105883333333335,-1609,0,1,258,297,-39
BR1_2731444050,12,True,0,0,0,20434,222,60,7.6,True,12,False,1,1,0,20113,219,56,7.2,False,28.93135,321,0,-1,282,275,7
BR1_2731396156,5,False,0,0,0,15941,220,64,7.0,True,6,True,0,1,0,16916,218,52,7.2,False,27.481116666666665,-975,-1,0,284,270,14
BR1_2730774246,15,False,0,1,2,23142,224,80,7.8,True,12,True,1,0,0,22287,241,44,7.0,False,28.484666666666666,855,3,-1,304,285,19
BR1_2730747282,13,True,0,0,0,19740,192,53,7.6,False,9,False,0,0,1,21627,255,63,7.6,True,27.849633333333333,-1887,4,0,245,318,-73
BR1_2729023515,8,False,0,0,0,16021,166,46,6.6,False,9,True,0,1,0,18350,224,79,7.2,True,26.456016666666667,-2329,-1,0,212,303,-91
BR1_2731876582,3,False,0,1,0,14731,208,44,6.8,False,5,True,1,0,0,14941,194,60,6.8,True,26.837483333333335,-210,-2,-1,252,254,-2
BR1_2731627721,12,False,0,0,0,17536,209,37,6.6,False,10,True,0,0,0,18011,201,54,7.0,True,26.416916666666665,-475,2,0,246,255,-9
BR1_2731273009,15,True,1,0,0,20517,201,44,7.4,True,5,False,0,0,0,17932,236,72,7.2,False,28.985533333333333,2585,10,1,245,308,-63
BR1_2731065164,10,False,0,0,0,17875,166,75,7.0,True,9,True,1,1,0,17156,192,52,7.0,False,25.988866666666667,719,1,-1,241,244,-3
BR1_2731179912,6,True,0,0,0,17832,223,64,7.6,True,6,False,0,0,0,17640,249,52,7.8,False,29.825383333333335,192,0,0,287,301,-14
BR1_2731579652,11,False,1,1,0,20197,222,64,7.4,True,12,True,0,0,0,19230,223,67,7.2,False,28.551566666666666,967,-1,1,286,290,-4
BR1_2731952187,9,True,0,1,0,20880,275,70,7.8,True,4,False,1,0,0,17971,255,68,7.6,False,28.172983333333335,2909,5,-1,345,323,22
BR1_2731445119,8,False,0,0,0,17113,243,40,7.2,False,14,True,0,1,0,21255,251,63,7.4,True,28.771816666666666,-4142,-6,0,283,314,-31
BR1_2731429920,11,True,0,0,0,20775,256,62,7.6,True,9,False,1,0,0,18886,223,52,7.4,False,29.053166666666666,1889,2,-1,318,275,43
BR1_2731254867,7,True,1,0,0,18573,236,48,7.2,False,7,False,0,0,0,18018,205,60,7.0,True,29.463216666666668,555,0,1,284,265,19
BR1_2727002915,5,False,1,0,0,18057,261,60,7.6,True,8,True,0,1,0,18369,242,64,7.2,False,28.893233333333335,-312,-3,1,321,306,15
BR1_2730140317,12,True,1,0,0,19307,213,57,7.0,False,8,False,0,0,0,17154,200,52,6.8,True,27.14985,2153,4,1,270,252,18
BR1_2728905832,6,False,0,0,0,17025,175,48,6.6,False,11,True,1,0,0,20166,179,62,7.0,True,28.315633333333334,-3141,-5,-1,223,241,-18
BR1_2730254990,9,True,0,0,0,19178,223,48,7.0,True,8,False,0,0,0,18047,205,56,7.0,False,29.456716666666665,1131,1,0,271,261,10
BR1_2731822966,5,True,0,1,0,15726,196,62,6.8,True,2,False,0,0,0,14664,193,60,6.8,False,25.549266666666668,1062,3,0,258,253,5
BR1_2722871949,7,False,0,0,0,17668,205,54,7.0,False,10,True,1,0,0,20452,244,60,7.4,True,29.088933333333333,-2784,-3,-1,259,304,-45
BR1_2730244797,6,False,1,0,0,16282,213,56,7.0,False,6,True,0,1,0,17050,206,41,6.8,True,25.67031666666667,-768,0,1,269,247,22
BR1_2731856640,13,False,1,0,0,19733,182,62,7.0,False,9,True,0,0,0,19998,226,53,7.2,True,29.461616666666668,-265,4,1,244,279,-35
BR1_2727538843,5,True,1,0,0,18276,249,72,7.4,True,5,False,0,1,0,18769,251,56,7.4,False,27.74665,-493,0,1,321,307,14
BR1_2727054530,12,True,0,0,0,20840,221,48,7.4,True,9,False,0,1,0,19561,198,68,7.0,False,28.590816666666665,1279,3,0,269,266,3
BR1_2731248809,10,True,0,1,1,22727,295,59,8.0,True,3,False,1,0,0,16027,239,52,7.4,False,29.027366666666666,6700,7,-1,354,291,63
BR1_2731473783,7,True,1,0,0,17539,218,63,7.0,True,3,False,0,0,0,14093,212,51,6.6,False,26.849166666666665,3446,4,1,281,263,18
BR1_2730528335,4,True,0,0,0,18113,271,64,7.6,True,2,False,1,0,0,15782,239,56,7.4,False,28.111183333333333,2331,2,-1,335,295,40
BR1_2728268282,8,False,1,0,0,17010,187,56,6.6,True,8,True,0,1,0,17968,211,56,7.0,False,25.182683333333333,-958,0,1,243,267,-24
BR1_2731693543,9,True,0,0,0,17877,199,64,7.0,False,9,False,1,0,0,16779,168,56,6.8,True,25.570866666666667,1098,0,-1,263,224,39
BR1_2731291780,13,True,1,0,0,20729,222,44,7.4,True,9,False,0,1,0,19010,186,64,7.2,False,27.610633333333332,1719,4,1,266,250,16
BR1_2731556578,10,False,1,0,0,18997,205,50,7.2,False,9,True,0,0,0,18365,196,68,7.2,True,27.63725,632,1,1,255,264,-9
BR1_2728021665,8,True,0,1,1,20584,261,55,7.4,True,3,False,0,0,0,15647,208,56,7.2,False,29.408516666666667,4937,5,0,316,264,52
BR1_2731789586,3,True,0,1,0,16702,223,60,6.8,True,3,False,0,0,0,15074,230,52,6.8,False,27.06511666666667,1628,0,0,283,282,1
BR1_2731720237,8,True,1,1,0,17421,204,56,6.8,True,3,False,0,0,0,14516,207,52,6.8,False,26.13735,2905,5,1,260,259,1
BR1_2731834153,7,False,0,0,0,16771,199,52,6.8,False,8,True,0,1,0,16282,172,52,7.0,True,26.547266666666665,489,-1,0,251,224,27
BR1_2727231346,10,False,0,1,0,19285,239,52,7.4,False,10,True,1,0,0,19209,212,72,7.4,True,27.714083333333335,76,0,-1,291,284,7
BR1_2728666981,7,True,0,0,0,16333,189,48,6.6,True,8,False,0,1,0,17220,213,48,6.8,False,26.529566666666668,-887,-1,0,237,261,-24
BR1_2729623127,12,True,1,0,0,20403,231,59,7.4,True,8,False,0,0,0,18749,220,56,7.4,False,28.70065,1654,4,1,290,276,14
BR1_2729591821,12,True,0,0,0,19888,238,52,7.2,True,5,False,0,0,0,18226,246,55,7.0,False,29.9541,1662,7,0,290,301,-11
BR1_2729921135,5,True,1,1,0,16917,233,52,7.0,True,4,False,0,0,0,14074,169,56,6.8,False,26.214,2843,1,1,285,225,60
BR1_2729640316,12,True,1,0,0,19032,204,44,7.2,True,7,False,0,0,0,17694,187,44,6.8,False,28.80366666666667,1338,5,1,248,231,17
BR1_2728334070,5,True,0,0,0,17370,237,57,7.4,True,7,False,1,1,0,18388,257,58,7.4,False,28.53611666666667,-1018,-2,-1,294,315,-21
BR1_2722748627,6,False,0,0,0,16649,217,56,6.6,False,9,True,0,0,0,17665,201,64,7.2,True,25.8307,-1016,-3,0,273,265,8
BR1_2720648148,7,True,1,0,0,16406,210,56,7.2,False,4,False,0,1,0,16117,216,59,7.0,True,27.4251,289,3,1,266,275,-9
BR1_2730790023,8,True,1,1,0,17744,222,48,6.4,True,2,False,0,0,0,13498,161,47,6.4,False,25.549566666666667,4246,6,1,270,208,62
BR1_2731855760,12,True,1,1,0,17967,198,48,7.2,True,3,False,0,0,0,14271,184,60,6.6,False,27.366133333333334,3696,9,1,246,244,2
BR1_2731836195,8,False,0,0,0,19616,238,55,7.2,False,12,True,1,1,0,21389,247,68,7.6,True,27.598566666666667,-1773,-4,-1,293,315,-22
BR1_2731089198,8,False,0,1,1,17450,179,50,6.8,False,12,True,1,0,0,17688,207,48,6.8,True,26.450766666666667,-238,-4,-1,229,255,-26
BR1_2728841197,4,False,0,0,0,16308,232,63,6.8,False,7,True,1,1,0,17470,248,56,7.0,True,26.748833333333334,-1162,-3,-1,295,304,-9
BR1_2728821392,15,True,1,0,0,21384,203,48,7.2,False,9,False,0,1,0,19554,209,64,7.2,True,29.594433333333335,1830,6,1,251,273,-22
BR1_2731111619,2,True,0,0,0,14271,210,52,6.6,False,7,False,0,0,0,16648,199,48,6.8,True,25.5438,-2377,-5,0,262,247,15
BR1_2730637927,4,False,0,1,0,18021,230,52,7.4,False,9,True,1,0,0,18521,223,52,7.2,True,29.04235,-500,-5,-1,282,275,7
BR1_2729437495,14,True,0,0,0,20831,222,45,7.2,True,4,False,1,0,0,14409,152,43,6.4,False,26.997466666666668,6422,10,-1,267,195,72
BR1_2729432250,11,True,0,0,0,18413,170,68,7.0,False,8,False,0,1,0,16626,192,52,7.0,True,26.61795,1787,3,0,238,244,-6
BR1_2731949202,0,False,0,0,0,15052,207,72,6.8,False,8,True,0,1,0,17552,238,52,7.2,True,25.143733333333333,-2500,-8,0,279,290,-11
BR1_2731777267,6,True,0,1,0,17168,198,56,7.4,False,5,False,1,0,0,19040,259,78,7.8,True,28.90325,-1872,1,-1,254,337,-83
BR1_2731744953,9,False,0,0,0,19024,203,53,7.4,True,13,True,0,0,0,20023,235,36,7.2,False,28.99825,-999,-4,0,256,271,-15
BR1_2731679768,6,False,0,1,0,18350,223,52,7.4,False,9,True,1,0,0,18122,191,60,7.4,True,29.015766666666668,228,-3,-1,275,251,24
BR1_2731874552,7,True,0,0,0,16707,198,47,6.6,True,9,False,0,0,0,18392,198,64,7.0,False,26.9223,-1685,-2,0,245,262,-17
BR1_2731471844,6,False,1,1,0,16263,197,60,6.8,True,3,True,0,0,0,14664,203,59,6.6,False,25.81125,1599,3,1,257,262,-5
BR1_2731641221,6,False,0,1,0,17559,220,56,7.2,False,8,True,1,0,0,19579,243,68,7.2,True,28.600683333333333,-2020,-2,-1,276,311,-35
BR1_2730831344,5,False,0,0,1,15765,195,48,6.4,False,10,True,1,1,0,19639,195,60,7.0,True,25.93188333333333,-3874,-5,-1,243,255,-12
BR1_2729199727,7,False,0,0,0,15983,189,56,6.6,False,8,True,1,1,0,18338,214,84,7.4,True,26.151583333333335,-2355,-1,-1,245,298,-53
BR1_2727635966,8,True,1,1,0,21066,279,84,7.6,False,9,False,0,0,0,19298,249,52,7.4,True,29.871733333333335,1768,-1,1,363,301,62
BR1_2730789833,12,True,1,1,0,19860,193,72,7.6,True,5,False,0,0,0,17371,232,50,7.0,False,29.33785,2489,7,1,265,282,-17
BR1_2729009726,6,False,0,0,0,18685,226,60,7.2,False,16,True,1,1,0,22672,261,56,7.8,True,27.98325,-3987,-10,-1,286,317,-31
BR1_2730090848,8,False,1,0,0,18397,226,64,7.4,True,8,True,0,0,0,18396,214,64,7.2,False,29.452116666666665,1,0,1,290,278,12
BR1_2730074048,1,False,0,0,0,14583,219,72,7.0,False,6,True,1,0,0,16407,201,59,6.6,True,26.71535,-1824,-5,-1,291,260,31
BR1_2728998411,7,True,0,0,0,17272,197,52,7.2,False,9,False,1,0,0,19169,244,64,7.2,True,29.724533333333333,-1897,-2,-1,249,308,-59
BR1_2731123886,5,False,1,0,0,15718,184,52,7.2,False,9,True,0,0,0,18365,213,55,7.4,True,27.702883333333332,-2647,-4,1,236,268,-32
BR1_2730590621,4,False,0,0,0,14990,207,51,6.6,False,8,True,0,0,0,16456,218,52,7.2,True,25.38085,-1466,-4,0,258,270,-12
BR1_2731752182,12,False,0,1,0,19379,213,52,7.2,False,6,True,1,0,0,16021,212,52,6.6,True,27.437816666666667,3358,6,-1,265,264,1
BR1_2730938353,1,False,1,0,0,16142,252,83,7.4,True,5,True,0,1,0,17098,237,68,7.8,False,29.839933333333335,-956,-4,1,335,305,30
BR1_2729864894,6,False,1,0,0,16875,201,58,6.8,False,14,True,0,0,0,19420,176,56,7.0,True,27.0248,-2545,-8,1,259,232,27
BR1_2730295359,3,False,0,0,0,16361,208,79,6.8,False,14,True,1,1,0,21874,246,72,7.6,True,27.880766666666666,-5513,-11,-1,287,318,-31
BR1_2730185581,12,False,0,0,0,18622,153,45,6.4,False,15,True,1,1,0,21430,178,48,6.6,True,29.0791,-2808,-3,-1,198,226,-28
BR1_2730776890,8,True,0,0,0,17653,220,49,6.8,True,2,False,0,0,0,13753,181,47,6.6,False,25.4377,3900,6,0,269,228,41
BR1_2731515308,5,False,1,0,0,18044,242,48,7.2,False,7,True,0,0,0,17943,248,80,7.6,True,28.933866666666667,101,-2,1,290,328,-38
BR1_2731021791,7,False,0,0,0,16195,201,48,6.6,False,6,True,0,1,0,16792,217,70,7.2,True,26.251966666666668,-597,1,0,249,287,-38
BR1_2729306441,7,False,1,0,0,17670,262,43,7.2,False,6,True,0,1,0,19003,259,64,7.6,True,29.848733333333332,-1333,1,1,305,323,-18
BR1_2728082488,8,True,0,0,0,16386,234,32,6.6,False,5,False,0,0,0,15720,208,40,6.8,True,26.545933333333334,666,3,0,266,248,18
BR1_2731781767,7,True,1,0,0,15744,179,52,6.4,False,6,False,0,0,0,16167,215,60,6.8,True,27.137033333333335,-423,1,1,231,275,-44
BR1_2723556134,8,False,0,1,0,19601,251,53,7.4,False,6,True,1,0,0,18397,246,61,7.4,True,29.592633333333332,1204,2,-1,304,307,-3
BR1_2722784349,0,False,0,0,0,16016,283,62,7.4,False,6,True,1,1,0,17653,237,56,7.4,True,28.133283333333335,-1637,-6,-1,345,293,52
BR1_2730712516,5,False,0,0,0,15791,183,56,7.0,False,5,True,1,0,0,17743,225,59,7.2,True,29.726066666666668,-1952,0,-1,239,284,-45
BR1_2724075407,12,True,1,1,0,21237,226,59,7.6,False,12,False,0,0,0,21616,254,51,7.6,True,29.035833333333333,-379,0,1,285,305,-20
BR1_2731332297,6,False,1,0,0,14873,157,34,6.6,False,10,True,0,0,0,17426,201,53,6.8,True,26.616266666666668,-2553,-4,1,191,254,-63
BR1_2721966340,10,True,1,0,0,17772,170,56,6.8,True,4,False,0,0,0,14853,196,52,6.6,False,26.395183333333332,2919,6,1,226,248,-22
BR1_2731714748,9,False,0,0,0,19932,267,60,7.6,False,12,True,0,1,0,20897,204,72,7.2,True,27.813,-965,-3,0,327,276,51
BR1_2731103190,5,False,1,1,0,14712,184,48,6.6,False,7,True,0,0,0,17556,209,71,6.8,True,26.323533333333334,-2844,-2,1,232,280,-48
BR1_2725875138,3,False,0,0,0,14432,196,42,6.6,False,9,True,0,0,0,18469,196,53,6.8,True,26.984216666666665,-4037,-6,0,238,249,-11
BR1_2725845396,7,False,0,0,0,18248,223,56,7.2,False,14,True,1,0,0,21698,229,60,7.2,True,29.453433333333333,-3450,-7,-1,279,289,-10
BR1_2728460698,8,True,0,0,0,16884,197,56,7.0,False,11,False,1,0,0,19499,211,52,7.0,True,27.197016666666666,-2615,-3,-1,253,263,-10
BR1_2728432513,8,False,0,0,0,18862,240,56,7.0,False,14,True,0,1,0,21712,234,52,7.0,True,29.473733333333332,-2850,-6,0,296,286,10
BR1_2728408354,8,False,1,0,0,17996,226,56,7.2,True,8,True,0,0,0,17092,211,56,7.0,False,25.6662,904,0,1,282,267,15
BR1_2731607351,12,True,1,1,0,21248,255,80,7.6,False,7,False,0,0,0,17582,203,52,7.4,True,28.29075,3666,5,1,335,255,80
BR1_2730617176,7,True,0,0,0,16189,185,52,6.4,False,9,False,0,0,0,17228,207,60,6.8,True,26.528266666666667,-1039,-2,0,237,267,-30
BR1_2729532235,7,True,1,0,0,16049,235,50,7.2,True,4,False,0,1,0,16057,244,48,7.0,False,26.082916666666666,-8,3,1,285,292,-7
BR1_2726892361,13,True,0,0,0,19553,221,56,7.0,True,7,False,1,0,0,16481,204,56,6.8,False,27.136516666666665,3072,6,-1,277,260,17
BR1_2731460577,7,False,0,1,0,15808,205,56,6.8,False,9,True,0,0,0,17702,225,40,6.6,True,25.285533333333333,-1894,-2,0,261,265,-4
BR1_2731098158,4,False,0,0,0,17629,270,60,7.6,True,6,True,0,0,0,17827,233,59,7.2,False,27.947766666666666,-198,-2,0,330,292,38
BR1_2730917922,12,True,0,0,0,20696,254,62,7.2,True,6,False,1,1,0,15869,208,57,6.8,False,25.719866666666668,4827,6,-1,316,265,51
BR1_2730545704,12,False,0,1,0,20805,210,43,7.0,False,14,True,1,0,1,21929,242,44,7.4,True,29.828233333333333,-1124,-2,-1,253,286,-33
BR1_2729330987,8,False,0,1,0,18961,227,60,7.4,False,10,True,1,0,0,18671,218,72,7.4,True,29.0899,290,-2,-1,287,290,-3
BR1_2725561802,5,False,1,0,0,15871,214,52,7.2,False,7,True,0,1,0,18711,239,76,7.0,True,26.65285,-2840,-2,1,266,315,-49
BR1_2731718172,8,True,1,0,0,17642,213,60,6.4,True,8,False,0,1,0,18057,212,56,6.8,False,27.14828333333333,-415,0,1,273,268,5
BR1_2729476824,10,True,0,0,0,19956,217,51,7.2,False,9,False,1,0,0,20162,226,64,7.4,True,28.693883333333332,-206,1,-1,268,290,-22
BR1_2729434887,13,True,1,1,0,22218,252,80,7.4,False,6,False,0,0,0,17797,215,40,7.0,True,29.63465,4421,7,1,332,255,77
BR1_2728003391,4,False,0,0,0,16501,234,56,7.2,False,9,True,1,1,0,19427,237,64,7.4,True,29.644183333333334,-2926,-5,-1,290,301,-11
BR1_2730461417,14,False,0,1,0,22628,265,64,7.4,False,8,True,1,0,0,19671,227,60,7.2,True,29.386566666666667,2957,6,-1,329,287,42
BR1_2730558687,8,False,1,0,0,17874,231,38,6.8,True,4,True,0,1,0,16682,212,68,7.0,False,26.47025,1192,4,1,269,280,-11
BR1_2730541769,5,True,0,0,1,18259,196,56,6.6,True,11,False,1,1,0,17781,192,52,7.0,False,26.573566666666668,478,-6,-1,252,244,8
BR1_2730486552,8,True,1,1,0,17505,224,66,7.0,True,4,False,0,0,0,15008,210,53,6.6,False,25.246666666666666,2497,4,1,290,263,27
BR1_2731799393,1,False,0,0,0,16713,243,72,7.4,False,4,True,0,0,0,15588,189,56,7.2,True,28.097833333333334,1125,-3,0,315,245,70
BR1_2731776449,3,False,0,0,0,15297,205,56,6.8,True,10,True,0,0,0,19213,259,60,7.0,False,26.847533333333335,-3916,-7,0,261,319,-58
BR1_2731317032,6,True,1,0,0,17847,256,48,7.6,True,4,False,0,1,0,17138,245,64,7.2,False,28.9965,709,2,1,304,309,-5
BR1_2730944485,12,False,0,0,0,21412,228,60,7.6,True,7,True,0,0,0,17523,213,56,7.2,False,27.955033333333333,3889,5,0,288,269,19
BR1_2722831435,3,False,0,1,0,14732,184,52,6.8,False,5,True,1,0,0,16937,247,56,7.0,True,25.6908,-2205,-2,-1,236,303,-67
BR1_2722745772,2,False,1,0,0,14471,204,35,6.8,False,9,True,0,1,1,21982,240,59,7.4,True,27.613933333333332,-7511,-7,1,239,299,-60
BR1_2721106740,6,True,1,0,0,15842,211,44,6.6,False,2,False,0,0,0,14618,202,64,7.0,True,26.037816666666668,1224,4,1,255,266,-11
BR1_2730884772,4,False,0,0,0,15579,192,46,6.6,False,7,True,1,0,0,16585,210,62,6.6,True,27.03548333333333,-1006,-3,-1,238,272,-34
BR1_2731927734,11,True,1,0,0,18697,219,56,7.0,True,8,False,0,0,0,16709,190,48,6.4,False,26.138066666666667,1988,3,1,275,238,37
BR1_2731842431,6,False,0,1,0,16617,221,52,6.8,True,9,True,1,0,0,18743,259,56,7.4,False,25.942183333333332,-2126,-3,-1,273,315,-42
BR1_2731862239,14,True,1,1,0,20015,189,55,7.2,True,7,False,0,0,0,17073,211,44,6.6,False,25.987683333333333,2942,7,1,244,255,-11
BR1_2731829056,9,True,1,1,0,18694,234,60,6.8,True,8,False,0,0,0,17780,214,52,7.2,False,27.4218,914,1,1,294,266,28
BR1_2730265456,10,True,1,0,0,20977,280,56,7.4,True,5,False,0,1,0,17617,242,76,7.4,False,29.431833333333334,3360,5,1,336,318,18
BR1_2728880073,13,True,1,1,1,22307,240,64,7.6,True,9,False,0,0,0,19447,213,56,7.2,False,27.5344,2860,4,1,304,269,35
BR1_2731204396,6,False,1,0,0,18662,238,60,7.6,False,9,True,0,1,0,18678,215,68,7.8,True,29.6836,-16,-3,1,298,283,15
BR1_2730994484,3,False,1,0,0,15271,219,53,6.8,False,10,True,0,1,0,19014,203,62,7.2,True,25.411883333333332,-3743,-7,1,272,265,7
BR1_2730386315,7,False,0,1,0,18632,201,60,7.2,True,10,True,1,0,0,18541,218,63,7.4,False,28.067316666666667,91,-3,-1,261,281,-20
BR1_2730333982,5,True,0,0,0,16088,214,63,6.8,True,5,False,0,0,0,15887,193,48,6.6,False,27.490666666666666,201,0,0,277,241,36
BR1_2728626288,10,True,1,0,0,18497,227,52,7.2,True,4,False,0,1,0,15875,217,56,7.0,False,26.706216666666666,2622,6,1,279,273,6
BR1_2727606176,11,False,1,1,0,20022,203,84,7.6,True,9,True,0,0,0,19312,237,56,7.6,False,28.021283333333333,710,2,1,287,293,-6
BR1_2731368438,10,True,0,0,0,18472,225,76,7.4,True,7,False,1,1,0,17817,228,56,7.4,False,29.65085,655,3,-1,301,284,17
BR1_2731860378,9,True,1,0,0,19222,259,50,7.6,True,5,False,0,0,0,15315,190,55,6.4,False,27.685316666666665,3907,4,1,309,245,64
BR1_2731676518,4,False,0,0,0,16241,246,60,6.8,False,8,True,1,1,0,17590,231,52,7.2,True,25.45765,-1349,-4,-1,306,283,23
BR1_2731368354,2,True,0,0,0,16462,256,60,7.4,False,5,False,1,1,0,18050,267,72,7.6,True,29.181516666666667,-1588,-3,-1,316,339,-23
BR1_2731348785,12,False,0,0,0,19635,218,52,7.4,True,10,True,0,0,0,17759,211,60,6.8,False,25.8445,1876,2,0,270,271,-1
BR1_2731193485,11,True,0,1,0,20246,235,60,7.2,False,7,False,1,0,0,17971,234,59,7.4,True,28.2782,2275,4,-1,295,293,2
BR1_2731844762,8,False,0,0,0,18198,242,9,6.0,False,13,True,0,0,0,21819,200,74,7.6,True,28.119,-3621,-5,0,251,274,-23
BR1_2718085336,4,False,1,0,0,16379,207,67,7.2,True,10,True,0,0,0,20496,258,80,7.6,False,28.851366666666667,-4117,-6,1,274,338,-64
BR1_2718033092,5,False,0,0,0,16557,212,64,7.2,False,3,True,1,1,0,15169,215,64,7.2,True,25.1165,1388,2,-1,276,279,-3
BR1_2718006724,9,True,1,0,0,16997,203,36,6.6,True,9,False,0,0,0,17368,211,54,7.0,False,27.042316666666668,-371,0,1,239,265,-26
BR1_2731594599,6,True,0,0,0,15994,222,44,7.0,False,7,False,0,0,0,16667,240,52,6.6,True,26.653033333333333,-673,-1,0,266,292,-26
BR1_2731571115,8,True,1,0,0,16360,188,48,6.2,True,10,False,0,0,0,18203,216,47,7.0,False,27.06255,-1843,-2,1,236,263,-27
BR1_2731367483,10,True,1,0,0,19286,264,56,7.6,False,7,False,0,1,0,17798,231,44,7.2,True,29.243833333333335,1488,3,1,320,275,45
BR1_2731855958,10,True,1,1,0,20085,202,84,7.4,True,10,False,0,0,0,19137,229,44,7.2,False,28.1743,948,0,1,286,273,13
BR1_2731538019,10,True,0,0,0,20257,253,71,7.4,True,9,False,1,1,0,19014,218,63,7.2,False,28.617833333333333,1243,1,-1,324,281,43
BR1_2712524095,5,True,0,0,0,17420,222,64,7.2,False,8,False,1,0,0,18393,225,72,7.6,True,28.1256,-973,-3,-1,286,297,-11
BR1_2708939901,10,False,1,0,0,20360,210,64,7.4,False,11,True,0,1,0,20173,242,56,7.4,True,28.6519,187,-1,1,274,298,-24
BR1_2730027372,9,False,0,0,0,18382,198,56,7.0,False,17,True,1,0,0,24283,250,56,7.6,True,29.136183333333335,-5901,-8,-1,254,306,-52
BR1_2728846548,5,True,0,1,0,18150,225,40,7.6,False,6,False,1,0,0,17300,228,63,7.2,True,29.985283333333335,850,-1,-1,265,291,-26
BR1_2731324069,4,False,1,0,0,16935,231,64,7.2,True,8,True,0,1,0,19329,225,67,7.4,False,28.805283333333332,-2394,-4,1,295,292,3
BR1_2731303354,5,False,1,0,0,15662,198,52,6.8,False,7,True,0,0,0,17757,219,56,7.0,True,26.145883333333334,-2095,-2,1,250,275,-25
BR1_2731684031,9,True,1,0,0,19954,264,64,7.6,True,7,False,0,0,0,18527,219,60,7.2,False,29.098033333333333,1427,2,1,328,279,49
BR1_2715230658,9,True,0,0,0,18844,239,60,7.0,True,3,False,1,0,0,14448,195,60,6.8,False,26.941516666666665,4396,6,-1,299,255,44
BR1_2714393567,8,False,0,0,0,18431,245,48,7.4,False,11,True,0,0,0,20385,250,37,7.2,True,28.70065,-1954,-3,0,293,287,6
BR1_2714376716,4,False,1,0,0,16807,230,67,7.2,False,6,True,0,0,0,17140,226,48,7.6,True,29.2883,-333,-2,1,297,274,23
BR1_2714361551,9,True,1,0,0,18144,222,54,7.0,True,6,False,0,0,0,16531,203,54,6.6,False,27.293416666666666,1613,3,1,276,257,19
BR1_2714345158,10,True,0,0,0,19021,225,68,7.0,True,8,False,0,0,0,16947,199,56,6.8,False,25.173233333333332,2074,2,0,293,255,38
BR1_2731299263,9,True,1,1,0,18421,229,64,7.4,True,4,False,0,0,0,15144,185,56,6.6,False,26.41208333333333,3277,5,1,293,241,52
BR1_2721772333,5,False,0,0,0,15319,169,60,6.6,False,8,True,0,0,0,17065,219,56,7.0,True,25.164233333333332,-1746,-3,0,229,275,-46
BR1_2731609517,3,False,1,0,1,17436,240,56,7.0,True,6,True,0,0,0,16345,215,39,6.8,False,26.657416666666666,1091,-3,1,296,254,42
BR1_2731436853,8,False,0,0,0,16866,200,40,6.6,False,13,True,0,0,0,19738,201,51,6.8,True,26.4547,-2872,-5,0,240,252,-12
BR1_2730082340,7,True,0,0,0,17277,200,72,7.0,False,7,False,1,0,0,16949,212,56,6.8,True,26.471233333333334,328,0,-1,272,268,4
BR1_2731442257,12,False,0,0,0,20029,217,44,7.0,True,14,True,1,0,0,20145,216,46,7.4,False,29.85345,-116,-2,-1,261,262,-1
BR1_2731485010,7,True,0,0,0,17248,215,56,6.8,True,6,False,0,0,0,15460,203,44,6.8,False,25.496733333333335,1788,1,0,271,247,24
BR1_2730432259,7,True,1,1,0,19924,278,64,7.6,True,4,False,0,0,0,16959,246,80,7.8,False,28.527733333333334,2965,3,1,342,326,16
BR1_2729849799,3,False,0,0,0,15939,239,56,6.8,False,10,True,1,0,0,19919,274,60,7.8,True,28.666166666666665,-3980,-7,-1,295,334,-39
BR1_2731947843,11,True,0,1,1,21262,189,54,7.0,False,13,False,1,0,0,21885,246,58,7.4,True,29.650516666666668,-623,-2,-1,243,304,-61
BR1_2731917185,5,True,0,0,0,17752,255,76,7.6,False,6,False,1,1,0,18379,265,60,7.6,True,29.759366666666665,-627,-1,-1,331,325,6
BR1_2730704025,7,False,1,0,0,17394,241,56,7.4,True,8,True,0,0,0,19273,227,64,7.0,False,28.22815,-1879,-1,1,297,291,6
BR1_2730259270,11,False,0,0,0,18755,217,52,7.0,False,7,True,1,0,0,18328,215,52,6.8,True,28.37335,427,4,-1,269,267,2
BR1_2731503828,10,True,1,0,0,18931,257,52,7.4,True,4,False,0,1,0,16740,220,64,7.2,False,28.994366666666668,2191,6,1,309,284,25
BR1_2731012018,4,True,1,0,0,17007,212,64,7.2,True,3,False,0,1,0,17842,232,60,7.4,False,29.61655,-835,1,1,276,292,-16
BR1_2726734847,4,False,1,0,0,15006,185,44,6.6,False,6,True,0,1,0,17162,230,60,7.0,True,25.463383333333333,-2156,-2,1,229,290,-61
BR1_2727187186,4,True,1,0,0,16647,229,56,7.2,False,6,False,0,1,0,17736,248,72,7.8,True,27.993533333333332,-1089,-2,1,285,320,-35
BR1_2727022501,12,True,0,0,0,19007,183,52,6.4,False,9,False,0,0,0,18034,190,48,6.8,True,26.518216666666667,973,3,0,235,238,-3
BR1_2731855864,11,True,0,0,0,20256,196,59,7.0,True,14,False,0,0,0,20736,221,56,7.2,False,28.93948333333333,-480,-3,0,255,277,-22
BR1_2716536069,5,False,0,0,0,16197,222,52,7.0,True,6,True,1,0,0,16599,204,68,6.8,False,26.63965,-402,-1,-1,274,272,2
BR1_2731285341,5,False,1,0,0,17521,237,60,7.2,False,9,True,0,1,0,21610,251,60,7.8,True,29.417133333333332,-4089,-4,1,297,311,-14
BR1_2731261156,13,False,1,1,0,21032,215,56,6.8,True,7,True,0,0,0,17432,197,56,6.8,False,28.449283333333334,3600,6,1,271,253,18
BR1_2730364000,7,True,0,0,0,16593,224,44,6.6,False,9,False,0,0,0,19285,256,60,7.2,True,25.73966666666667,-2692,-2,0,268,316,-48
BR1_2730359424,7,True,0,0,0,18902,255,48,7.4,True,5,False,0,0,0,17304,239,56,7.4,False,29.0137,1598,2,0,303,295,8
BR1_2731182400,12,True,0,1,0,21068,273,65,7.6,True,4,False,1,0,0,16437,223,75,7.0,False,27.594583333333333,4631,8,-1,338,298,40
BR1_2730735698,5,False,0,0,0,15253,188,48,6.8,False,7,True,1,0,0,17997,213,64,7.0,True,26.154183333333332,-2744,-2,-1,236,277,-41
BR1_2730038570,6,True,0,0,0,16745,210,56,6.8,True,4,False,0,0,0,13786,161,40,6.4,False,25.8146,2959,2,0,266,201,65
BR1_2731581220,6,False,1,0,0,18470,221,80,7.6,False,9,True,0,1,0,19294,231,64,7.4,True,28.491983333333334,-824,-3,1,301,295,6
BR1_2731522981,10,False,0,1,0,17658,193,48,6.6,True,6,True,1,0,0,17684,216,68,6.8,False,26.511816666666668,-26,4,-1,241,284,-43
BR1_2731072244,14,True,1,0,0,20014,249,71,7.4,True,4,False,0,1,0,13912,176,36,6.4,False,25.380583333333334,6102,10,1,320,212,108
BR1_2730525331,11,False,1,0,2,20342,228,56,7.4,False,12,True,0,1,0,23227,252,52,7.6,True,27.568133333333332,-2885,-1,1,284,304,-20
BR1_2730492949,6,True,0,0,0,15386,196,48,6.6,False,8,False,1,0,0,17679,204,60,7.0,True,27.0302,-2293,-2,-1,244,264,-20
BR1_2722297868,5,True,1,0,0,15317,165,52,6.4,False,10,False,0,1,0,18180,208,56,6.8,True,26.661366666666666,-2863,-5,1,217,264,-47
BR1_2720561700,11,False,0,0,0,19470,206,60,7.2,False,13,True,1,0,0,20147,222,56,7.2,True,28.702,-677,-2,-1,266,278,-12
BR1_2726518828,7,True,0,1,1,19918,256,55,7.4,True,3,False,1,0,0,16331,209,60,7.0,False,28.2582,3587,4,-1,311,269,42
BR1_2720190530,8,False,1,1,0,17879,205,52,6.8,False,9,True,0,0,0,19396,224,40,7.4,True,28.11541666666667,-1517,-1,1,257,264,-7
BR1_2720173385,4,True,0,1,0,16043,208,52,6.4,False,6,False,1,0,0,16393,223,52,6.8,True,25.192116666666667,-350,-2,-1,260,275,-15
BR1_2711018097,10,False,1,0,0,19542,220,40,7.0,True,13,True,0,0,0,20400,234,36,7.0,False,28.650783333333333,-858,-3,1,260,270,-10
BR1_2729983075,5,False,0,0,0,15901,190,72,7.0,False,8,True,0,0,0,17613,220,44,6.8,True,27.374966666666666,-1712,-3,0,262,264,-2
BR1_2714677035,4,False,1,0,0,16077,211,60,7.0,True,5,True,0,0,0,16550,220,56,7.0,False,26.0385,-473,-1,1,271,276,-5
BR1_2731865042,8,True,1,0,0,16567,170,48,6.6,False,11,False,0,0,0,18827,205,64,7.0,True,25.387783333333335,-2260,-3,1,218,269,-51
BR1_2731821408,8,False,0,1,1,19813,224,58,7.4,False,8,True,1,0,0,18657,239,60,7.4,True,29.5714,1156,0,-1,282,299,-17
BR1_2725968887,7,False,1,0,0,16352,223,64,7.0,False,3,True,0,0,0,14477,199,56,6.6,True,26.994983333333334,1875,4,1,287,255,32
BR1_2729094862,10,False,1,0,1,21246,275,52,7.6,True,7,True,0,1,0,20238,265,71,7.8,False,27.607133333333334,1008,3,1,327,336,-9
BR1_2729069418,9,True,0,1,0,20795,222,60,7.2,True,7,False,0,0,0,18206,237,40,7.0,False,28.455283333333334,2589,2,0,282,277,5
BR1_2731179342,6,False,1,1,0,18830,272,72,7.8,True,3,True,0,0,0,16049,221,72,7.2,False,28.698183333333333,2781,3,1,344,293,51
BR1_2731314199,4,True,0,1,0,15645,215,47,6.6,True,11,False,1,0,0,18361,230,48,6.6,False,27.179266666666667,-2716,-7,-1,262,278,-16
BR1_2718012084,10,False,0,0,0,19426,236,60,7.4,True,11,True,1,1,0,21789,253,68,7.2,False,28.988766666666667,-2363,-1,-1,296,321,-25
BR1_2727079538,5,False,0,0,0,15593,172,58,6.8,False,5,True,0,0,0,18010,256,57,7.2,True,29.360383333333335,-2417,0,0,230,313,-83
BR1_2725910739,2,True,0,0,0,13774,205,52,6.6,False,5,False,0,1,0,16761,237,56,7.0,True,26.0867,-2987,-3,0,257,293,-36
BR1_2731104190,9,True,0,0,0,18855,210,56,7.4,True,7,False,1,0,0,19818,277,56,7.6,False,28.806216666666668,-963,2,-1,266,333,-67
BR1_2731082492,6,False,0,1,0,20009,259,68,7.2,False,8,True,1,0,0,18301,224,68,7.4,True,28.212783333333334,1708,-2,-1,327,292,35
BR1_2731249125,9,True,1,0,0,19000,205,68,7.4,True,8,False,0,1,0,19097,253,72,7.2,False,29.96335,-97,1,1,273,325,-52
BR1_2730128801,7,True,0,0,0,18145,233,68,7.0,False,8,False,1,1,0,18315,244,56,7.6,True,29.689666666666668,-170,-1,-1,301,300,1
BR1_2728541267,15,True,0,0,0,21521,198,48,7.2,False,8,False,1,0,0,18188,162,52,6.8,True,29.376883333333332,3333,7,-1,246,214,32
BR1_2728508890,9,False,0,0,0,17998,172,46,6.6,False,11,True,1,0,0,19392,189,50,6.6,True,28.20025,-1394,-2,-1,218,239,-21
BR1_2730764908,5,True,0,0,0,17459,255,56,7.8,True,2,False,0,0,0,16622,288,48,7.2,False,29.786833333333334,837,3,0,311,336,-25
BR1_2729417896,15,True,1,0,1,22109,227,60,7.0,False,13,False,0,0,0,20182,198,52,7.0,True,28.676283333333334,1927,2,1,287,250,37
BR1_2731204924,11,True,1,0,0,20092,256,56,7.8,False,7,False,0,0,0,18023,220,60,7.2,True,29.520116666666667,2069,4,1,312,280,32
BR1_2731841561,9,False,1,0,0,18946,244,64,7.4,True,10,True,0,0,0,19399,239,52,7.4,False,28.744983333333334,-453,-1,1,308,291,17
BR1_2731089079,13,True,1,0,0,20061,223,64,7.4,True,6,False,0,0,0,16334,191,44,7.0,False,26.863183333333332,3727,7,1,287,235,52
BR1_2730766293,4,True,0,0,0,15051,197,60,6.6,True,6,False,0,0,0,16334,210,44,7.0,False,25.008533333333332,-1283,-2,0,257,254,3
BR1_2729938592,3,True,0,1,0,16116,223,42,7.2,True,11,False,0,0,0,20132,228,40,7.4,False,28.53795,-4016,-8,0,265,268,-3
BR1_2713667210,6,True,0,1,0,17594,241,66,7.0,True,7,False,1,0,0,17236,201,61,6.8,False,26.809633333333334,358,-1,-1,307,262,45
BR1_2731775925,5,False,0,0,0,16590,235,56,7.0,True,5,True,1,0,0,16089,222,48,6.8,False,27.29531666666667,501,0,-1,291,270,21
BR1_2731715445,7,False,0,1,0,18237,219,59,7.0,False,6,True,0,0,0,17407,211,58,7.0,True,28.0183,830,1,0,278,269,9
BR1_2725879220,7,False,0,0,0,18127,230,52,7.0,False,9,True,1,1,0,18780,211,80,7.2,True,28.942183333333332,-653,-2,-1,282,291,-9
BR1_2725850828,5,False,1,0,0,17500,227,87,8.0,True,6,True,0,1,0,17687,238,72,7.6,False,28.948383333333332,-187,-1,1,314,310,4
BR1_2731445445,9,True,1,0,0,19967,267,63,7.2,False,6,False,0,0,0,17508,214,52,6.6,True,28.565916666666666,2459,3,1,330,266,64
BR1_2731813061,8,True,0,0,0,20310,232,60,7.4,False,4,False,0,0,0,14442,174,40,7.0,True,29.97675,5868,4,0,292,214,78
BR1_2731787373,6,True,0,0,0,15899,200,48,6.6,False,7,False,1,0,0,16740,202,64,7.0,True,26.227783333333335,-841,-1,-1,248,266,-18
BR1_2731497236,8,False,0,0,0,17125,204,44,6.8,True,14,True,1,0,0,20541,209,72,7.0,False,25.508666666666667,-3416,-6,-1,248,281,-33
BR1_2731469872,9,False,0,0,0,18464,244,51,6.8,False,8,True,0,1,0,19250,245,52,7.0,True,27.52505,-786,1,0,295,297,-2
BR1_2731586095,13,True,0,0,0,20233,276,64,7.6,False,3,False,1,1,0,16382,213,55,7.0,True,28.910583333333335,3851,10,-1,340,268,72
BR1_2729237034,7,False,1,1,0,18597,227,76,7.6,True,8,True,0,0,0,18618,238,56,7.4,False,28.6301,-21,-1,1,303,294,9
BR1_2731617545,4,True,0,0,0,14302,173,46,6.4,False,6,False,0,0,0,15862,185,60,6.8,True,27.02245,-1560,-2,0,219,245,-26
BR1_2731727373,6,False,0,0,0,18981,259,52,7.2,False,10,True,1,1,0,20842,257,64,7.4,True,28.173766666666666,-1861,-4,-1,311,321,-10
BR1_2731236554,10,False,0,0,0,19206,215,64,7.2,True,9,True,1,0,0,16973,176,48,6.6,False,27.009133333333335,2233,1,-1,279,224,55
BR1_2731956587,5,True,1,0,0,18232,223,80,7.2,False,13,False,0,0,0,20160,229,67,7.4,True,27.715833333333332,-1928,-8,1,303,296,7
BR1_2731782100,8,False,0,1,0,16316,153,71,6.6,False,11,True,1,0,0,18001,202,56,6.8,True,26.02178333333333,-1685,-3,-1,224,258,-34
BR1_2731631904,12,False,0,0,1,21819,223,64,7.6,True,5,True,0,0,0,15119,174,38,6.8,False,27.60568333333333,6700,7,0,287,212,75
BR1_2731555818,10,True,0,0,0,20391,258,56,7.4,False,9,False,1,1,0,21017,258,64,7.6,True,29.888583333333333,-626,1,-1,314,322,-8
BR1_2718854586,7,False,0,0,0,19454,223,68,7.2,False,11,True,1,1,0,20819,228,76,7.6,True,27.831516666666666,-1365,-4,-1,291,304,-13
BR1_2731219442,15,True,1,0,0,18947,195,52,6.8,True,5,False,0,0,0,14829,203,48,6.4,False,25.113716666666665,4118,10,1,247,251,-4
BR1_2726172571,12,True,0,0,0,20259,228,56,7.6,True,3,False,0,1,0,17022,242,57,7.0,False,28.173766666666666,3237,9,0,284,299,-15
BR1_2724972815,5,True,0,0,0,16601,221,64,7.0,True,8,False,1,0,0,17303,215,50,7.4,False,29.739983333333335,-702,-3,-1,285,265,20
BR1_2724954168,6,False,0,0,0,16943,206,64,6.8,True,10,True,1,0,0,18111,208,63,7.0,False,27.04005,-1168,-4,-1,270,271,-1
BR1_2724933422,8,True,0,1,1,19218,246,48,7.4,False,8,False,1,0,0,18922,237,67,7.4,True,27.9988,296,0,-1,294,304,-10
BR1_2724914539,8,False,1,0,0,18216,256,56,7.6,True,5,True,0,0,0,18250,252,68,7.4,False,27.803966666666668,-34,3,1,312,320,-8
BR1_2723652644,8,False,0,0,0,17040,185,50,6.6,False,9,True,1,1,0,17967,193,56,6.8,True,25.121883333333333,-927,-1,-1,235,249,-14
BR1_2714465727,5,False,0,0,0,14420,169,56,6.6,False,5,True,0,1,0,16205,224,51,6.8,True,26.33005,-1785,0,0,225,275,-50
BR1_2731956420,4,False,1,0,0,17053,244,68,7.4,False,8,True,0,1,0,18403,224,67,7.4,True,29.49565,-1350,-4,1,312,291,21
BR1_2731655886,10,False,1,0,0,17279,181,48,6.6,True,5,True,0,0,0,15864,220,64,6.8,False,26.2042,1415,5,1,229,284,-55
BR1_2731058345,0,False,0,0,0,13200,194,52,6.4,False,7,True,1,0,0,17494,230,48,6.8,True,25.765133333333335,-4294,-7,-1,246,278,-32
BR1_2730718173,8,True,1,0,0,17064,210,46,6.8,True,2,False,0,0,0,14825,238,48,6.6,False,25.76565,2239,6,1,256,286,-30
BR1_2731642256,6,True,0,0,0,16703,241,52,6.8,True,1,False,1,1,0,14328,202,68,7.0,False,26.58935,2375,5,-1,293,270,23
BR1_2731096443,6,True,0,1,0,18869,253,56,7.6,False,5,False,1,0,0,17085,226,64,7.4,True,28.165433333333333,1784,1,-1,309,290,19
BR1_2730593306,8,True,0,1,0,19254,243,60,7.2,True,6,False,0,0,0,17406,248,56,7.2,False,27.009183333333333,1848,2,0,303,304,-1
BR1_2730829547,10,True,1,1,0,19247,204,76,7.4,True,7,False,0,0,0,18498,228,68,7.4,False,27.629783333333332,749,3,1,280,296,-16
BR1_2727674276,3,False,0,0,0,15693,220,64,7.2,False,10,True,1,1,0,19233,217,48,7.0,True,25.053083333333333,-3540,-7,-1,284,265,19
BR1_2727313874,10,True,1,0,1,19568,223,60,7.2,True,9,False,0,1,0,20278,222,52,7.4,False,29.58813333333333,-710,1,1,283,274,9
BR1_2716871418,4,True,0,0,0,15349,201,44,6.6,False,7,False,1,1,0,16778,217,52,7.0,True,27.090833333333332,-1429,-3,-1,245,269,-24
BR1_2716845394,5,False,0,0,0,16447,246,40,6.6,True,8,True,1,0,0,16245,175,44,6.8,False,25.415133333333333,202,-3,-1,286,219,67
BR1_2731563575,8,True,0,1,0,18398,234,39,7.0,True,12,False,0,0,0,20388,247,64,7.6,False,28.54885,-1990,-4,0,273,311,-38
BR1_2731525264,8,True,0,1,0,19714,227,64,7.4,True,12,False,1,0,0,22173,255,84,8.2,False,29.501883333333332,-2459,-4,-1,291,339,-48
BR1_2731628815,3,False,0,0,0,16519,246,55,7.2,False,10,True,0,1,0,19620,231,44,7.6,True,28.1696,-3101,-7,0,301,275,26
BR1_2730774530,5,False,1,0,0,15888,227,61,7.0,False,3,True,0,0,0,14769,218,54,6.6,True,27.239183333333333,1119,2,1,288,272,16
BR1_2725224157,8,True,1,1,0,20030,272,75,7.8,True,3,False,0,0,0,16573,260,52,7.2,False,28.266483333333333,3457,5,1,347,312,35
BR1_2731696276,9,False,0,0,0,18661,214,43,6.8,False,11,True,0,0,0,18376,226,40,6.8,True,25.27655,285,-2,0,257,266,-9
BR1_2731750481,6,True,1,0,0,16333,206,60,7.2,False,4,False,0,1,0,15886,202,56,7.4,True,29.669,447,2,1,266,258,8
BR1_2727310616,16,True,1,0,0,23168,270,53,7.4,True,6,False,0,1,0,17684,201,68,7.4,False,27.9925,5484,10,1,323,269,54
BR1_2730627972,8,True,1,0,0,18708,242,52,7.2,True,10,False,0,1,0,19225,207,48,6.8,False,27.93555,-517,-2,1,294,255,39
BR1_2730614458,8,True,1,0,0,17800,209,57,6.8,True,7,False,0,0,0,16824,217,44,7.0,False,26.3465,976,1,1,266,261,5
BR1_2730670110,9,False,0,0,0,17889,205,52,7.4,False,8,True,0,0,0,18449,225,48,7.4,True,27.70805,-560,1,0,257,273,-16
BR1_2730609550,13,True,0,1,0,21241,270,52,7.8,False,7,False,0,0,0,18644,219,63,6.8,True,28.468033333333334,2597,6,0,322,282,40
BR1_2729840171,8,True,1,0,0,19189,236,64,7.6,True,4,False,0,0,0,17468,227,60,7.2,False,27.599,1721,4,1,300,287,13
BR1_2726048107,4,False,0,0,0,16065,244,48,7.0,True,6,True,0,0,0,16027,227,50,6.8,False,25.40726666666667,38,-2,0,292,277,15
BR1_2731247361,6,True,0,0,0,17651,251,57,7.2,False,6,False,1,0,0,17270,225,50,7.4,True,28.093083333333333,381,0,-1,308,275,33
BR1_2731933114,9,False,0,0,0,16921,177,56,6.4,False,11,True,1,0,0,18806,196,56,6.8,True,27.296216666666666,-1885,-2,-1,233,252,-19
BR1_2730505632,10,True,0,0,0,18232,190,43,6.6,True,13,False,1,0,0,19044,190,68,7.2,False,27.0379,-812,-3,-1,233,258,-25
BR1_2730479419,8,True,1,0,0,20087,280,52,7.6,True,7,False,0,0,0,18776,251,64,7.4,False,27.868216666666665,1311,1,1,332,315,17
BR1_2730467333,6,False,1,0,1,20327,257,80,7.8,True,6,True,0,1,0,18821,223,64,7.2,False,28.447266666666668,1506,0,1,337,287,50
BR1_2730770427,10,False,0,1,0,17581,209,44,6.4,True,7,True,1,0,0,16523,170,64,6.6,False,26.074033333333333,1058,3,-1,253,234,19
BR1_2731728657,10,False,1,0,0,17870,226,48,7.0,True,9,True,0,1,0,19618,202,61,7.2,False,29.689283333333332,-1748,1,1,274,263,11
BR1_2730696724,13,True,0,1,0,22295,237,72,8.0,True,6,False,0,0,0,18067,231,59,7.2,False,28.567066666666665,4228,7,0,309,290,19
BR1_2729181373,5,True,1,0,0,15861,232,47,6.8,True,2,False,0,1,0,14513,221,48,6.8,False,26.4801,1348,3,1,279,269,10
BR1_2729169857,10,True,1,0,0,19081,225,67,7.4,False,8,False,0,1,0,19676,233,76,7.6,True,29.774833333333333,-595,2,1,292,309,-17
BR1_2719585962,4,True,1,0,0,16469,215,57,7.2,False,6,False,0,1,0,17916,224,78,7.6,True,29.68715,-1447,-2,1,272,302,-30
BR1_2731850684,10,False,1,0,0,18454,233,64,7.2,True,11,True,0,1,0,21831,233,64,7.6,False,29.533083333333334,-3377,-1,1,297,297,0
BR1_2731825069,8,True,0,0,0,16968,222,60,7.4,True,3,False,0,0,0,15341,244,64,7.2,False,26.510533333333335,1627,5,0,282,308,-26
BR1_2731619577,2,False,0,0,0,15945,247,64,7.0,False,5,True,1,0,0,17753,267,64,7.2,True,28.164066666666667,-1808,-3,-1,311,331,-20
BR1_2730754540,9,False,0,0,0,18423,218,52,7.0,True,4,True,0,0,0,15391,174,52,6.6,False,28.1961,3032,5,0,270,226,44
BR1_2730705920,10,True,1,0,0,19199,227,56,7.6,True,6,False,0,1,0,18127,234,64,7.2,False,29.0935,1072,4,1,283,298,-15
BR1_2730677232,9,True,1,1,0,19147,225,51,7.4,True,5,False,0,0,0,18257,273,52,7.6,False,29.173216666666665,890,4,1,276,325,-49
BR1_2731737461,5,False,0,0,0,16183,211,52,7.2,True,8,True,1,0,0,17365,191,60,7.0,False,28.95345,-1182,-3,-1,263,251,12
BR1_2731299743,7,False,0,0,0,17776,211,48,7.0,True,11,True,1,0,0,20928,248,72,7.4,False,28.162783333333334,-3152,-4,-1,259,320,-61
BR1_2730739915,12,False,1,1,0,20328,222,60,7.2,True,8,True,0,0,0,17077,200,56,6.8,False,28.419216666666667,3251,4,1,282,256,26
BR1_2728470008,2,False,0,0,0,15437,219,64,7.2,True,8,True,0,0,0,17871,242,60,7.6,False,29.118183333333334,-2434,-6,0,283,302,-19
BR1_2731648711,5,False,0,0,0,15731,184,51,6.6,False,3,True,0,0,0,15191,223,48,6.8,True,26.5225,540,2,0,235,271,-36
BR1_2730770165,8,False,0,0,0,17038,191,56,6.8,False,7,True,0,0,0,17329,224,68,7.4,True,28.63195,-291,1,0,247,292,-45
BR1_2731643959,9,True,1,0,0,20269,254,43,7.2,True,6,False,0,1,0,17321,223,52,7.2,False,29.83716666666667,2948,3,1,297,275,22
BR1_2731168483,12,True,1,0,0,20790,257,46,7.8,True,4,False,0,1,0,16369,184,44,7.2,False,27.652733333333334,4421,8,1,303,228,75
BR1_2731950685,6,True,0,1,0,17013,203,51,6.8,False,7,False,1,0,0,17412,241,60,7.0,True,26.00825,-399,-1,-1,254,301,-47
BR1_2731689882,9,True,1,0,0,18807,250,64,7.8,True,8,False,0,1,0,17589,244,52,7.6,False,28.80925,1218,1,1,314,296,18
BR1_2730863431,4,False,0,0,0,14765,210,47,6.8,True,12,True,0,0,0,18922,237,64,7.4,False,25.44825,-4157,-8,0,257,301,-44
BR1_2730847635,7,True,1,0,0,17095,207,44,6.6,True,6,False,0,0,0,16800,230,64,7.0,False,26.797866666666668,295,1,1,251,294,-43
BR1_2722658294,5,True,0,0,0,17262,237,66,7.2,False,16,False,1,0,0,21654,231,56,7.8,True,28.97745,-4392,-11,-1,303,287,16
BR1_2722322700,15,False,1,0,1,23231,246,68,7.8,True,6,True,0,1,0,18019,229,63,6.8,False,27.969316666666668,5212,9,1,314,292,22
BR1_2721987430,11,True,0,0,0,19785,235,52,7.4,False,7,False,1,0,0,18730,238,72,7.2,True,28.494516666666666,1055,4,-1,287,310,-23
BR1_2712038703,10,False,1,0,0,17457,229,42,6.8,False,11,True,0,0,0,17589,206,48,6.8,True,25.27355,-132,-1,1,271,254,17
BR1_2700059964,15,True,1,1,0,22488,221,73,7.4,True,9,False,0,0,0,19535,217,58,6.8,False,29.674216666666666,2953,6,1,294,275,19
BR1_2729627241,3,False,1,0,0,15467,206,55,6.8,False,8,True,0,1,0,18044,215,48,7.0,True,25.059716666666667,-2577,-5,1,261,263,-2
BR1_2731670760,9,False,0,1,0,21036,248,80,7.8,True,12,True,1,0,0,19256,195,59,7.4,False,29.7494,1780,-3,-1,328,254,74
BR1_2730640803,3,True,1,0,0,16011,227,48,7.2,False,5,False,0,1,0,17250,241,52,7.4,True,28.836116666666666,-1239,-2,1,275,293,-18
BR1_2730111691,12,True,1,0,0,20496,222,64,7.2,True,5,False,0,0,0,15341,225,48,6.8,False,26.682333333333332,5155,7,1,286,273,13
BR1_2730085688,9,True,0,0,0,16995,199,48,6.8,True,5,False,1,0,0,15682,192,45,6.8,False,27.065633333333334,1313,4,-1,247,237,10
BR1_2726063045,9,False,0,0,0,17403,206,68,7.2,True,8,True,1,0,0,17845,225,50,7.2,False,27.139866666666666,-442,1,-1,274,275,-1
BR1_2715776373,4,False,0,0,0,16632,196,47,7.0,False,11,True,1,0,0,19763,247,56,7.2,True,29.52625,-3131,-7,-1,243,303,-60
BR1_2728294417,4,False,0,0,0,16131,223,56,7.0,True,7,True,1,0,0,16511,190,60,7.2,False,25.642883333333334,-380,-3,-1,279,250,29
BR1_2731169649,4,True,0,0,0,16372,220,40,6.8,False,5,False,1,1,0,19895,271,62,7.4,True,29.464116666666666,-3523,-1,-1,260,333,-73
BR1_2731458744,12,True,0,0,0,19932,187,52,6.4,True,20,False,0,1,0,21815,188,60,7.0,False,26.477616666666666,-1883,-8,0,239,248,-9
BR1_2726481915,15,True,1,1,0,21148,225,68,7.4,True,5,False,0,0,0,15619,188,52,7.0,False,28.46705,5529,10,1,293,240,53
BR1_2724943430,8,False,0,0,0,18781,254,69,7.4,False,7,True,1,0,0,17811,213,68,7.2,True,29.558666666666667,970,1,-1,323,281,42
BR1_2731787144,3,True,0,0,0,14566,197,56,6.8,False,2,False,1,1,0,14841,223,64,7.0,True,27.4505,-275,1,-1,253,287,-34
BR1_2716573347,6,True,0,1,0,16452,197,60,7.0,True,9,False,0,0,0,17397,230,48,6.8,False,27.45575,-945,-3,0,257,278,-21
BR1_2731428546,9,True,1,0,0,18363,237,48,7.4,True,8,False,0,1,0,18612,238,64,7.4,False,29.5554,-249,1,1,285,302,-17
BR1_2731080196,6,False,0,0,0,16731,182,56,6.6,False,15,True,1,0,0,21199,195,52,7.2,True,25.310916666666667,-4468,-9,-1,238,247,-9
BR1_2729973892,4,False,0,1,0,18290,260,60,7.4,True,7,True,0,0,0,17686,226,52,7.2,False,27.8735,604,-3,0,320,278,42
BR1_2728837738,13,True,0,0,0,20023,225,47,6.8,True,12,False,0,0,0,16420,170,40,7.0,False,25.899383333333333,3603,1,0,272,210,62
BR1_2728818913,6,True,0,0,0,16563,225,61,7.2,True,4,False,1,1,0,15431,210,50,7.0,False,25.488766666666667,1132,2,-1,286,260,26
BR1_2717107220,5,True,0,0,0,16633,209,56,7.4,True,7,False,1,0,0,18604,232,68,7.4,False,29.973383333333334,-1971,-2,-1,265,300,-35
BR1_2731525128,6,True,0,0,0,16452,210,48,6.8,False,5,False,0,0,0,16009,209,52,6.6,True,26.025116666666666,443,1,0,258,261,-3
BR1_2720341647,5,False,0,1,0,16366,240,51,7.2,True,4,True,0,0,0,14939,177,52,6.8,False,25.721083333333333,1427,1,0,291,229,62
BR1_2731934592,6,False,0,0,0,16073,224,56,7.0,False,10,True,1,0,0,18780,211,60,7.0,True,25.7825,-2707,-4,-1,280,271,9
BR1_2727318221,8,True,0,0,0,17212,194,48,6.6,False,12,False,1,0,0,18434,168,56,6.6,True,27.300083333333333,-1222,-4,-1,242,224,18
BR1_2728333017,8,True,1,0,0,17775,215,64,6.8,True,2,False,0,1,0,15200,231,46,6.8,False,26.57695,2575,6,1,279,277,2
BR1_2728292752,9,False,1,0,0,19363,259,64,7.2,True,7,True,0,0,0,16001,188,48,6.6,False,27.29615,3362,2,1,323,236,87
BR1_2731855600,10,True,1,1,0,21601,230,72,7.4,True,7,False,0,0,0,18560,227,60,7.0,False,29.1717,3041,3,1,302,287,15
BR1_2730143837,13,True,0,1,0,20748,204,60,7.0,False,13,False,1,0,0,23049,238,64,7.4,True,28.565266666666666,-2301,0,-1,264,302,-38
BR1_2730085543,8,True,1,0,0,17455,224,56,7.0,False,1,False,0,1,0,14222,234,56,6.8,True,26.401183333333332,3233,7,1,280,290,-10
BR1_2731309945,8,True,1,0,0,16745,236,40,6.8,True,6,False,0,0,0,16717,214,64,7.0,False,26.9058,28,2,1,276,278,-2
BR1_2720948174,2,False,0,0,0,14946,235,68,7.4,False,5,True,0,0,0,16806,218,75,7.2,True,26.201666666666668,-1860,-3,0,303,293,10
BR1_2720936001,6,True,0,1,0,16445,190,51,6.6,False,10,False,1,0,0,18293,207,48,7.0,True,25.185266666666667,-1848,-4,-1,241,255,-14
BR1_2720921883,4,True,0,0,0,15333,209,52,7.0,True,3,False,0,0,0,15699,244,56,7.0,False,25.52905,-366,1,0,261,300,-39
BR1_2716569979,12,True,0,1,0,18823,235,48,7.0,True,7,False,1,0,0,16571,190,54,6.6,False,25.373716666666667,2252,5,-1,283,244,39
BR1_2720194748,10,False,0,1,0,19470,215,49,7.2,True,4,True,1,0,0,14584,176,68,6.8,False,25.2835,4886,6,-1,264,244,20
BR1_2717658916,7,True,0,0,0,19169,255,56,7.6,True,5,False,1,1,0,16435,190,74,7.2,False,28.494016666666667,2734,2,-1,311,264,47
BR1_2731944999,4,False,0,0,0,17154,235,44,7.4,False,8,True,1,0,0,18335,227,70,7.2,True,28.818883333333332,-1181,-4,-1,279,297,-18
BR1_2730779876,6,False,0,1,0,19433,264,52,7.4,True,12,True,1,0,0,20145,246,50,7.4,False,29.15355,-712,-6,-1,316,296,20
BR1_2730292442,6,False,0,1,0,16576,223,50,6.8,True,2,True,1,0,0,13948,195,58,6.8,False,26.758683333333334,2628,4,-1,273,253,20
BR1_2731548807,9,True,0,0,0,18406,220,52,7.4,False,11,False,0,1,0,21290,268,60,7.6,True,28.25261666666667,-2884,-2,0,272,328,-56
BR1_2729760674,3,False,0,0,0,16199,215,61,7.0,False,14,True,1,0,0,22278,263,60,7.8,True,27.5364,-6079,-11,-1,276,323,-47
BR1_2729090537,9,True,0,0,0,18004,220,47,7.0,False,5,False,0,1,0,17519,256,48,7.2,True,28.505316666666666,485,4,0,267,304,-37
BR1_2729568043,6,False,0,0,0,16149,221,40,6.6,False,7,True,1,0,0,16797,219,51,6.4,True,27.3647,-648,-1,-1,261,270,-9
BR1_2722697490,6,False,1,1,0,17988,249,52,7.6,False,9,True,0,0,0,18939,242,56,7.2,True,28.165733333333332,-951,-3,1,301,298,3
BR1_2722694456,8,True,1,0,0,18947,259,56,7.4,True,11,False,0,1,0,20187,234,44,7.6,False,27.557183333333334,-1240,-3,1,315,278,37
BR1_2722690242,12,False,1,1,1,22838,252,52,7.4,False,11,True,0,0,0,20304,233,40,7.4,True,28.8633,2534,1,1,304,273,31
BR1_2722684506,10,True,0,0,0,17665,208,40,7.0,False,7,False,0,0,0,17104,207,56,6.8,True,27.396283333333333,561,3,0,248,263,-15
BR1_2730750671,11,True,0,0,0,16668,129,40,6.6,False,10,False,1,0,0,17511,167,59,7.2,True,26.613883333333334,-843,1,-1,169,226,-57
BR1_2731779909,5,True,0,1,0,18593,255,68,7.6,True,6,False,1,0,0,17925,263,64,7.6,False,28.97465,668,-1,-1,323,327,-4
BR1_2731761362,13,True,1,0,0,19957,234,44,7.2,True,6,False,0,1,0,15855,189,60,6.8,False,26.0911,4102,7,1,278,249,29
BR1_2731705689,9,False,1,0,0,19372,262,55,7.4,False,8,True,0,0,0,17475,201,44,7.0,True,27.832066666666666,1897,1,1,317,245,72
BR1_2727860847,12,True,0,1,0,19812,216,64,7.2,True,3,False,1,0,0,13970,199,48,6.6,False,27.172266666666665,5842,9,-1,280,247,33
BR1_2727825737,4,False,0,0,0,16381,220,50,7.0,False,11,True,0,1,0,20580,220,72,7.8,True,28.101016666666666,-4199,-7,0,270,292,-22
BR1_2727807806,7,False,1,0,0,16888,219,60,6.8,True,9,True,0,0,0,17993,160,56,6.6,False,27.1439,-1105,-2,1,279,216,63
BR1_2729571618,4,False,1,0,0,17719,241,60,7.2,True,8,True,0,1,0,18937,249,68,7.8,False,29.142316666666666,-1218,-4,1,301,317,-16
BR1_2731923188,10,True,1,0,0,19461,232,48,7.4,False,5,False,0,0,0,16750,225,60,7.2,True,28.060833333333335,2711,5,1,280,285,-5
BR1_2721276417,2,False,1,0,0,14737,216,47,6.6,False,8,True,0,0,0,17716,230,52,7.0,True,25.582516666666667,-2979,-6,1,263,282,-19
BR1_2712622607,6,True,0,1,0,16515,219,63,7.0,True,6,False,1,0,0,15925,207,72,7.0,False,26.161983333333332,590,0,-1,282,279,3
BR1_2731951392,9,True,1,0,0,19316,244,52,7.4,False,8,False,0,0,0,18772,226,83,7.4,True,28.844216666666668,544,1,1,296,309,-13
BR1_2726655587,4,True,1,1,0,17348,228,68,7.4,False,4,False,0,0,0,18001,253,68,7.4,True,29.745466666666665,-653,0,1,296,321,-25
BR1_2720353433,4,False,0,1,0,15644,175,44,6.4,False,8,True,1,0,0,17743,232,68,7.0,True,25.6647,-2099,-4,-1,219,300,-81
BR1_2731348154,4,False,0,0,0,14277,188,44,6.4,False,7,True,1,0,0,16699,202,56,7.0,True,26.093466666666668,-2422,-3,-1,232,258,-26
BR1_2731335131,5,False,0,0,0,16591,214,56,6.8,False,10,True,0,1,0,17048,185,64,6.8,True,27.084316666666666,-457,-5,0,270,249,21
BR1_2727091908,3,False,0,0,0,14194,184,38,6.4,False,6,True,1,1,0,16978,233,62,7.0,True,26.294816666666666,-2784,-3,-1,222,295,-73
BR1_2725862174,9,True,1,0,0,18417,209,56,7.0,True,4,False,0,0,0,15471,222,56,6.8,False,25.932033333333333,2946,5,1,265,278,-13
BR1_2731359441,8,False,0,0,0,16312,173,48,6.8,False,9,True,1,0,0,17449,182,60,6.6,True,25.587783333333334,-1137,-1,-1,221,242,-21
BR1_2731726550,14,True,1,1,0,21116,263,72,7.8,True,2,False,0,0,0,15121,220,60,6.8,False,29.4075,5995,12,1,335,280,55
BR1_2731757612,3,False,0,1,0,16756,210,48,6.8,True,9,True,1,0,0,18213,218,56,7.2,False,29.12115,-1457,-6,-1,258,274,-16
BR1_2730545022,13,True,0,0,0,19531,202,55,6.8,True,8,False,1,1,0,17690,221,56,7.0,False,25.765,1841,5,-1,257,277,-20
BR1_2731852929,11,True,0,1,0,19955,269,42,7.4,True,7,False,1,0,0,17681,194,54,7.0,False,29.962133333333334,2274,4,-1,311,248,63
BR1_2731830861,9,False,0,1,0,18329,195,42,6.6,True,8,True,1,0,0,16712,167,42,6.4,False,25.1953,1617,1,-1,237,209,28
BR1_2731746671,5,False,1,1,0,15310,206,56,6.4,True,7,True,0,0,0,16381,202,38,6.8,False,26.677183333333332,-1071,-2,1,262,240,22
BR1_2718285971,13,True,1,0,0,21546,241,79,7.8,True,5,False,0,1,0,17078,205,64,7.4,False,28.81126666666667,4468,8,1,320,269,51
BR1_2714197331,10,True,1,0,0,18384,186,41,7.0,False,13,False,0,0,0,20680,241,56,7.6,True,28.73035,-2296,-3,1,227,297,-70
BR1_2713577099,7,True,0,1,0,18639,251,60,7.4,True,5,False,1,0,0,16945,229,48,7.4,False,27.566283333333335,1694,2,-1,311,277,34
BR1_2717494859,6,True,1,0,0,17262,232,60,7.4,True,7,False,0,1,0,18000,243,60,7.2,False,27.679216666666665,-738,-1,1,292,303,-11
BR1_2727710514,9,False,1,0,0,19181,257,64,7.4,True,7,True,0,0,0,17422,205,60,7.2,False,29.2009,1759,2,1,321,265,56
BR1_2731725343,7,True,1,0,0,17233,235,52,6.4,True,1,False,0,0,0,12734,177,40,6.4,False,26.7095,4499,6,1,287,217,70
BR1_2729691974,5,False,0,0,0,15232,186,48,6.6,False,5,True,1,0,0,15676,204,44,6.8,True,26.5951,-444,0,-1,234,248,-14
BR1_2731789302,7,False,0,0,0,15876,208,44,6.6,False,5,True,0,0,0,16281,214,68,7.0,True,27.394016666666666,-405,2,0,252,282,-30
BR1_2731919675,7,False,0,0,0,17330,208,60,7.0,True,6,True,0,0,0,16916,207,52,6.8,False,27.406,414,1,0,268,259,9
BR1_2731423040,8,False,1,0,0,18778,220,60,7.4,True,9,True,0,0,0,18920,268,56,7.6,False,28.700066666666668,-142,-1,1,280,324,-44
BR1_2731709091,8,True,1,0,0,16766,196,66,7.2,True,3,False,0,1,0,14113,178,48,6.8,False,27.429216666666665,2653,5,1,262,226,36
BR1_2731302005,7,False,0,0,0,16854,186,66,6.8,False,10,True,1,0,0,17540,178,40,6.6,True,27.057166666666667,-686,-3,-1,252,218,34
BR1_2722668031,10,True,1,0,0,17933,169,56,6.4,True,7,False,0,0,0,15654,155,52,6.2,False,25.327783333333333,2279,3,1,225,207,18
BR1_2731225943,10,True,0,0,0,17666,219,62,6.8,False,6,False,1,0,0,15576,195,44,6.6,True,25.125166666666665,2090,4,-1,281,239,42
BR1_2731434005,8,False,0,0,1,18173,213,40,6.4,True,6,True,1,1,0,16406,178,50,6.4,False,25.896016666666668,1767,2,-1,253,228,25
BR1_2729435368,8,True,0,0,0,16089,179,49,6.2,False,11,False,1,0,0,19682,232,48,6.8,True,26.61385,-3593,-3,-1,228,280,-52
BR1_2727967683,1,False,0,0,0,14170,225,59,6.4,False,9,True,1,0,0,18506,244,59,7.0,True,25.150766666666666,-4336,-8,-1,284,303,-19
BR1_2711131131,5,False,0,0,0,15562,213,42,7.0,False,9,True,1,1,0,17049,191,64,7.0,True,27.00025,-1487,-4,-1,255,255,0
BR1_2711043974,1,False,1,0,0,16276,290,64,7.4,False,2,True,0,1,0,17485,302,68,7.4,True,28.222383333333333,-1209,-1,1,354,370,-16
BR1_2710662208,7,False,1,0,0,17675,222,64,7.2,True,2,True,0,1,1,18356,248,64,7.2,False,29.054383333333334,-681,5,1,286,312,-26
BR1_2731255672,6,False,0,0,0,16384,230,60,7.2,True,10,True,0,0,0,17907,215,60,6.8,False,26.3305,-1523,-4,0,290,275,15
BR1_2731203568,4,False,0,0,0,15719,228,48,6.8,True,8,True,1,0,0,17446,217,52,7.0,False,26.154866666666667,-1727,-4,-1,276,269,7
BR1_2727463131,4,False,1,1,0,17106,226,60,7.4,False,9,True,0,0,0,19643,238,72,7.8,True,29.89865,-2537,-5,1,286,310,-24
BR1_2721975442,3,False,1,0,0,14172,168,52,6.6,False,12,True,0,0,0,18714,201,48,7.2,True,27.055,-4542,-9,1,220,249,-29
BR1_2721957150,3,True,0,0,0,14871,193,68,7.0,False,4,False,1,0,0,14960,182,46,7.0,True,26.117183333333333,-89,-1,-1,261,228,33
BR1_2721756935,5,False,0,1,0,17718,200,68,7.6,True,10,True,1,0,0,21122,255,80,7.6,False,29.730433333333334,-3404,-5,-1,268,335,-67
BR1_2723700585,8,False,1,0,0,17641,191,63,6.6,False,11,True,0,0,0,17211,180,36,6.2,True,27.353066666666667,430,-3,1,254,216,38
BR1_2730145416,10,False,0,0,0,19630,238,34,7.4,False,9,True,0,0,0,19070,262,61,7.2,True,29.233083333333333,560,1,0,272,323,-51
BR1_2729258118,9,False,0,0,0,16834,199,40,6.8,True,4,True,0,0,0,16917,248,68,6.8,False,25.098533333333332,-83,5,0,239,316,-77
BR1_2731650702,6,False,0,1,0,17020,213,56,7.0,False,14,True,1,0,0,19885,184,36,7.0,True,29.234016666666665,-2865,-8,-1,269,220,49
BR1_2731306317,6,True,0,1,0,18150,231,42,7.0,True,8,False,0,0,0,18240,206,71,7.6,False,28.1213,-90,-2,0,273,277,-4
BR1_2714911841,8,True,1,0,0,19005,247,56,7.6,True,6,False,0,0,0,17444,236,72,7.2,False,28.56285,1561,2,1,303,308,-5
BR1_2729159814,12,False,1,0,0,19264,190,52,7.2,False,12,True,0,0,0,20027,191,56,7.0,True,28.460166666666666,-763,0,1,242,247,-5
BR1_2731829978,7,False,0,0,0,16142,207,44,6.8,True,1,True,0,0,0,13740,177,60,6.4,False,26.431516666666667,2402,6,0,251,237,14
BR1_2731773776,4,False,0,0,0,16307,234,48,7.2,False,9,True,1,1,0,20081,267,80,7.4,True,27.764716666666665,-3774,-5,-1,282,347,-65
BR1_2730241328,7,False,0,0,0,17006,196,40,6.6,True,8,True,0,0,0,16370,186,50,6.6,False,26.844833333333334,636,-1,0,236,236,0
BR1_2728040523,4,False,0,0,0,15262,187,52,6.8,False,8,True,1,0,0,17062,204,51,6.6,True,27.087233333333334,-1800,-4,-1,239,255,-16
BR1_2731315028,9,True,0,0,0,18084,248,52,6.8,False,8,False,1,0,0,16675,191,64,7.0,True,27.40505,1409,1,-1,300,255,45
BR1_2729609669,5,False,1,1,0,15043,205,59,6.8,False,8,True,0,0,0,17064,202,80,7.6,True,26.53548333333333,-2021,-3,1,264,282,-18
BR1_2725277736,11,False,1,0,0,18854,212,59,7.4,False,8,True,0,1,0,18835,238,56,7.4,True,28.724066666666666,19,3,1,271,294,-23
BR1_2729105696,11,True,0,0,0,17324,156,55,6.6,False,9,False,0,0,0,18691,189,51,6.4,True,25.14375,-1367,2,0,211,240,-29
BR1_2726304130,3,False,1,0,0,15703,249,69,7.2,True,7,True,0,1,0,17542,224,54,7.2,False,27.082066666666666,-1839,-4,1,318,278,40
BR1_2729991293,9,True,1,0,0,19821,245,64,7.4,True,3,False,0,1,0,16154,221,60,7.0,False,29.10781666666667,3667,6,1,309,281,28
BR1_2729969606,8,False,1,1,0,16451,189,44,6.2,False,5,True,0,0,0,16354,196,40,6.6,True,26.057383333333334,97,3,1,233,236,-3
BR1_2729114231,5,False,0,0,0,15619,190,56,6.8,False,9,True,0,1,0,18283,216,52,6.8,True,25.861366666666665,-2664,-4,0,246,268,-22
BR1_2731216114,10,True,0,0,0,17356,179,43,6.2,False,10,False,1,0,0,16789,179,53,6.6,True,26.664116666666665,567,0,-1,222,232,-10
BR1_2731304562,15,True,0,0,1,23576,215,56,7.6,True,8,False,1,0,0,18290,204,52,7.2,False,28.960483333333332,5286,7,-1,271,256,15
BR1_2730868008,7,False,1,1,0,19197,244,72,7.6,True,10,True,0,0,0,19435,244,40,7.4,False,27.609983333333332,-238,-3,1,316,284,32
BR1_2731852670,11,True,0,0,0,19553,213,48,7.0,True,4,False,0,0,0,16468,237,52,7.0,False,25.55705,3085,7,0,261,289,-28
BR1_2731816173,11,False,0,0,0,17793,173,38,6.4,False,9,True,1,1,0,17305,193,53,6.8,True,26.65195,488,2,-1,211,246,-35
BR1_2731021265,14,True,1,1,0,18972,210,55,7.0,True,4,False,0,0,0,15841,231,56,6.6,False,26.007916666666667,3131,10,1,265,287,-22
BR1_2730192529,7,False,0,0,0,18406,201,72,7.0,False,11,True,0,0,0,20257,249,51,7.4,True,28.37473333333333,-1851,-4,0,273,300,-27
BR1_2730801154,5,True,1,0,0,15789,185,60,6.8,True,3,False,0,0,0,15434,242,52,6.8,False,25.125433333333334,355,2,1,245,294,-49
BR1_2729010674,6,False,1,0,0,15990,211,42,6.6,False,11,True,0,0,0,19674,232,62,7.2,True,27.0999,-3684,-5,1,253,294,-41
BR1_2725846361,6,False,0,1,0,16993,219,72,7.4,True,7,True,1,0,0,16770,232,60,7.4,False,25.87761666666667,223,-1,-1,291,292,-1
BR1_2725997812,9,True,0,1,0,16982,184,60,7.0,False,4,False,1,0,0,14851,200,44,6.4,True,26.336366666666667,2131,5,-1,244,244,0
BR1_2725783638,10,True,0,0,0,17909,194,64,7.4,True,5,False,0,0,0,14984,192,48,6.8,False,25.6052,2925,5,0,258,240,18
BR1_2730483307,14,True,0,1,1,23456,247,82,7.8,True,5,False,1,0,0,16900,209,47,7.0,False,27.78386666666667,6556,9,-1,329,256,73
BR1_2731421806,3,True,0,1,0,17020,251,68,7.2,True,5,False,1,0,0,17251,224,48,7.2,False,29.221633333333333,-231,-2,-1,319,272,47
BR1_2731647633,4,False,0,0,0,16627,194,52,7.0,False,10,True,0,1,0,21381,269,56,7.4,True,29.891483333333333,-4754,-6,0,246,325,-79
BR1_2730853973,1,False,0,1,0,16205,238,68,7.8,False,6,True,1,0,0,17811,251,68,7.8,True,29.251483333333333,-1606,-5,-1,306,319,-13
BR1_2730803382,7,True,0,1,0,18791,248,38,7.0,False,8,False,0,0,1,19469,214,66,7.2,True,29.223133333333333,-678,-1,0,286,280,6
BR1_2725338389,9,True,1,0,0,17824,248,48,6.8,True,4,False,0,1,0,16260,216,64,6.8,False,25.166716666666666,1564,5,1,296,280,16
BR1_2729125281,10,False,0,0,0,18953,213,66,6.8,True,8,True,0,0,0,15835,178,32,6.2,False,27.215716666666665,3118,2,0,279,210,69
BR1_2719834275,5,True,1,0,0,17763,248,77,7.6,True,0,False,0,1,0,14321,217,61,7.2,False,27.949783333333333,3442,5,1,325,278,47
BR1_2728226820,3,True,0,0,0,14899,236,36,6.8,False,1,False,1,0,0,14361,217,67,7.0,True,27.385883333333332,538,2,-1,272,284,-12
BR1_2728150968,2,True,1,1,0,15598,233,55,7.0,True,1,False,0,0,0,14377,214,56,6.8,False,25.494033333333334,1221,1,1,288,270,18
BR1_2731765775,12,False,0,0,0,20690,202,44,7.2,False,15,True,1,1,0,21786,219,68,7.2,True,29.199483333333333,-1096,-3,-1,246,287,-41
BR1_2731821559,13,True,0,0,0,19034,169,56,7.2,False,15,False,1,0,0,20970,224,44,7.2,True,29.24425,-1936,-2,-1,225,268,-43
BR1_2731803037,5,True,0,0,0,17671,246,47,7.2,False,8,False,1,1,0,18599,210,68,7.4,True,28.590066666666665,-928,-3,-1,293,278,15
BR1_2726402761,3,False,0,1,0,17007,226,65,7.0,False,11,True,1,0,0,20904,255,74,7.6,True,28.149616666666667,-3897,-8,-1,291,329,-38
BR1_2726341224,7,False,0,0,0,19328,221,88,7.4,False,11,True,1,1,0,21301,277,68,7.8,True,27.90673333333333,-1973,-4,-1,309,345,-36
BR1_2731490237,8,True,1,0,0,16582,190,48,6.8,False,8,False,0,1,0,17120,189,48,6.6,True,25.528016666666666,-538,0,1,238,237,1
BR1_2730924766,3,True,1,1,0,16309,221,75,7.2,False,5,False,0,0,0,17773,226,64,7.4,True,28.269433333333332,-1464,-2,1,296,290,6
BR1_2727857820,13,True,0,0,0,19639,195,45,6.8,True,8,False,0,0,0,17269,189,50,6.6,False,26.724883333333334,2370,5,0,240,239,1
BR1_2726308167,9,True,1,0,0,17373,206,54,6.6,False,8,False,0,0,0,16449,170,37,6.4,True,27.279466666666668,924,1,1,260,207,53
BR1_2731847321,18,True,1,0,0,22018,229,50,7.4,True,6,False,0,0,0,17124,209,57,7.0,False,29.650566666666666,4894,12,1,279,266,13
BR1_2731214898,11,True,0,0,0,17300,151,31,6.2,False,13,False,0,0,0,18761,179,37,6.8,True,26.92295,-1461,-2,0,182,216,-34
BR1_2731190922,9,True,1,0,0,17309,163,31,6.0,False,11,False,0,1,0,17827,186,48,6.6,True,26.055016666666667,-518,-2,1,194,234,-40
BR1_2729242212,6,False,0,1,0,18087,238,56,7.2,False,12,True,0,0,0,20315,217,48,7.4,True,29.56975,-2228,-6,0,294,265,29
BR1_2724733285,5,False,0,1,0,15386,215,48,6.8,True,11,True,1,0,0,19029,246,60,7.2,False,27.217066666666668,-3643,-6,-1,263,306,-43
BR1_2731367561,11,False,0,0,0,18492,205,40,7.0,True,10,True,1,1,0,16873,176,56,6.4,False,26.554033333333333,1619,1,-1,245,232,13
BR1_2718594372,9,True,0,1,0,19227,234,64,7.2,True,7,False,0,0,0,17719,219,52,7.6,False,29.304916666666667,1508,2,0,298,271,27
BR1_2718570782,7,False,0,0,0,15975,212,52,6.4,True,6,True,0,1,0,17214,210,72,6.8,False,25.28075,-1239,1,0,264,282,-18
BR1_2718172924,6,False,0,0,0,18228,251,70,7.4,False,5,True,1,1,0,17976,223,62,7.4,True,29.55355,252,1,-1,321,285,36
BR1_2731639954,5,True,0,0,0,16217,196,56,6.8,True,7,False,1,0,0,16383,184,48,6.8,False,27.149,-166,-2,-1,252,232,20
BR1_2731584704,7,False,0,0,0,16842,232,48,7.0,False,8,True,1,0,0,16180,176,48,6.6,True,25.668033333333334,662,-1,-1,280,224,56
BR1_2731826583,3,False,0,1,0,15750,219,58,7.2,False,9,True,1,0,0,18198,218,70,7.2,True,29.346666666666668,-2448,-6,-1,277,288,-11
BR1_2730797974,7,True,0,0,0,16095,161,41,6.2,False,10,False,0,1,0,17674,197,51,6.8,True,26.377283333333335,-1579,-3,0,202,248,-46
BR1_2730199503,5,True,1,0,0,17330,251,60,7.6,True,4,False,0,1,0,16781,228,56,7.2,False,29.074533333333335,549,1,1,311,284,27
BR1_2731568062,11,False,0,1,0,20992,241,56,7.8,True,5,True,1,0,0,19299,251,72,7.6,False,30.0,1693,6,-1,297,323,-26
BR1_2729696114,7,False,0,0,0,16403,184,60,6.4,False,13,True,1,0,0,19602,220,44,6.8,True,25.352116666666667,-3199,-6,-1,244,264,-20
BR1_2726038729,5,False,1,0,0,15000,186,48,6.6,True,9,True,0,0,0,17232,210,44,7.0,False,25.50715,-2232,-4,1,234,254,-20
BR1_2725259207,6,True,0,0,0,17121,248,59,7.4,True,3,False,0,0,0,14474,224,51,6.6,False,25.965983333333334,2647,3,0,307,275,32
BR1_2731252250,9,True,1,0,0,18675,228,64,7.4,True,9,False,0,0,0,18278,217,40,7.0,False,29.91245,397,0,1,292,257,35
BR1_2731589072,8,True,1,0,0,19453,238,68,7.4,True,6,False,0,0,0,18046,233,72,7.8,False,29.55955,1407,2,1,306,305,1
BR1_2729672801,9,False,1,0,0,17476,196,60,7.2,True,2,True,0,0,0,13417,165,52,6.6,False,27.443483333333333,4059,7,1,256,217,39
BR1_2729568912,5,False,0,0,0,17857,249,54,7.4,False,8,True,1,1,0,18732,246,68,7.8,True,28.851516666666665,-875,-3,-1,303,314,-11
BR1_2729161795,7,True,1,1,0,17193,220,64,7.2,False,10,False,0,0,0,20524,240,72,7.4,True,28.4255,-3331,-3,1,284,312,-28
BR1_2731857091,5,False,0,0,0,15985,227,60,7.0,True,4,True,0,1,0,15075,193,46,7.0,False,26.40405,910,1,0,287,239,48
BR1_2731841492,10,True,1,0,0,20334,250,60,7.4,True,4,False,0,0,0,16461,213,68,7.0,False,29.28565,3873,6,1,310,281,29
BR1_2730143818,5,True,1,1,0,18691,269,87,7.6,True,5,False,0,0,0,17756,238,52,7.2,False,27.83955,935,0,1,356,290,66
BR1_2729665653,9,True,0,0,0,15977,181,44,6.2,False,14,False,0,1,0,18940,194,56,6.6,True,26.441083333333335,-2963,-5,0,225,250,-25
BR1_2729479914,3,True,0,0,0,16322,206,64,7.2,False,10,False,1,1,0,20116,232,68,7.4,True,28.803916666666666,-3794,-7,-1,270,300,-30
BR1_2729719923,6,True,0,0,0,17238,220,68,7.2,False,4,False,0,0,0,17962,249,63,7.4,True,28.98755,-724,2,0,288,312,-24
BR1_2730304634,5,False,1,0,0,17208,226,47,7.0,False,5,True,0,0,0,16023,224,48,6.6,True,25.71003333333333,1185,0,1,273,272,1
BR1_2729868803,7,True,1,1,0,18380,239,56,7.2,True,2,False,0,0,0,16018,239,52,7.0,False,28.597783333333332,2362,5,1,295,291,4
BR1_2729863069,6,False,0,0,0,17867,258,69,7.2,True,8,True,1,1,0,18925,228,62,7.2,False,29.59095,-1058,-2,-1,327,290,37
BR1_2731533390,5,False,0,1,0,16059,174,47,6.8,True,8,True,1,0,0,15803,156,48,6.2,False,26.968983333333334,256,-3,-1,221,204,17
BR1_2729362232,7,True,0,0,0,17398,198,52,6.8,False,18,False,0,0,0,22865,226,61,7.6,True,29.179966666666665,-5467,-11,0,250,287,-37
BR1_2720680723,3,False,1,0,0,17038,246,52,7.2,False,6,True,0,1,0,19387,256,83,7.8,True,28.306066666666666,-2349,-3,1,298,339,-41
BR1_2720613644,6,True,1,0,0,17615,232,56,6.8,True,5,False,0,0,0,15138,196,44,6.6,False,26.259616666666666,2477,1,1,288,240,48
BR1_2730258375,11,True,1,1,0,18932,196,52,6.8,True,13,False,0,0,0,18910,181,45,6.4,False,26.3601,22,-2,1,248,226,22
BR1_2731863084,12,True,1,1,1,21979,212,71,7.6,True,2,False,0,0,0,14754,226,43,7.0,False,27.949033333333333,7225,10,1,283,269,14
BR1_2729149736,7,True,1,0,0,17057,185,56,6.4,True,11,False,0,0,0,18329,196,44,6.8,False,25.203333333333333,-1272,-4,1,241,240,1
BR1_2729033742,5,True,0,0,0,16381,207,52,7.2,True,5,False,0,0,0,17826,238,60,7.2,False,27.501966666666668,-1445,0,0,259,298,-39
BR1_2731808300,9,False,1,0,0,18098,184,57,7.4,True,10,True,0,0,0,18868,224,62,7.4,False,28.427066666666665,-770,-1,1,241,286,-45
BR1_2729601289,6,True,0,1,0,16981,235,64,7.2,False,5,False,1,0,0,15332,197,52,6.6,True,26.146683333333332,1649,1,-1,299,249,50
BR1_2731602670,5,False,1,0,0,16764,219,68,7.2,False,7,True,0,0,0,17310,239,56,7.0,True,25.141233333333332,-546,-2,1,287,295,-8
BR1_2729674722,7,False,0,0,0,16968,221,60,7.0,True,7,True,0,0,0,16881,211,48,6.8,False,27.09345,87,0,0,281,259,22
BR1_2731822509,10,True,0,0,0,18257,203,62,7.2,False,8,False,1,0,0,17666,201,61,7.0,True,26.2628,591,2,-1,265,262,3
BR1_2731343110,10,True,0,1,0,21122,270,68,7.6,True,4,False,1,0,0,17682,246,64,7.4,False,27.525716666666668,3440,6,-1,338,310,28
BR1_2731547355,9,True,1,1,0,17233,186,59,7.0,True,5,False,0,0,0,16212,232,56,6.6,False,25.562183333333333,1021,4,1,245,288,-43
BR1_2731529349,6,True,0,1,0,17524,211,55,7.0,False,7,False,1,0,0,16582,177,72,7.0,True,27.41045,942,-1,-1,266,249,17
BR1_2730764455,5,False,0,0,0,16324,209,48,6.8,False,10,True,1,1,0,18694,215,55,7.4,True,26.57335,-2370,-5,-1,257,270,-13
BR1_2731553248,7,False,1,0,0,18884,241,54,7.6,False,4,True,0,1,0,17326,184,94,7.4,True,28.758766666666666,1558,3,1,295,278,17
BR1_2731537325,8,False,1,0,0,16436,150,56,6.8,False,12,True,0,1,0,21350,248,55,7.6,True,28.1435,-4914,-4,1,206,303,-97
BR1_2730055491,10,False,0,1,0,18320,196,64,6.8,True,4,True,0,0,0,15179,194,52,6.4,False,27.059,3141,6,0,260,246,14
BR1_2730253883,12,True,0,0,0,18424,234,48,7.0,False,7,False,1,0,0,16516,198,36,6.8,True,26.182066666666667,1908,5,-1,282,234,48
BR1_2713582497,4,False,1,0,0,16289,224,56,6.8,False,15,True,0,0,0,21365,243,64,7.6,True,29.135183333333334,-5076,-11,1,280,307,-27
BR1_2731953221,14,False,0,0,0,20716,238,40,7.8,True,7,True,0,1,0,18859,252,68,7.4,False,29.566333333333333,1857,7,0,278,320,-42
BR1_2722313814,8,True,0,0,0,19823,260,76,7.4,True,9,False,0,1,0,18827,255,39,7.2,False,28.0369,996,-1,0,336,294,42
BR1_2722301077,6,True,0,0,0,17208,197,60,7.0,False,11,False,1,0,0,19108,216,60,7.2,True,25.070233333333334,-1900,-5,-1,257,276,-19
BR1_2730647183,7,False,0,0,0,18375,230,64,7.2,False,10,True,1,0,0,18612,159,56,6.8,True,25.133033333333334,-237,-3,-1,294,215,79
BR1_2728596844,7,False,1,0,0,18390,244,56,7.4,False,7,True,0,0,0,18102,230,59,7.2,True,27.683633333333333,288,0,1,300,289,11
BR1_2731628093,7,True,0,0,0,18906,250,52,7.6,False,4,False,0,0,0,16334,235,64,7.4,True,28.0206,2572,3,0,302,299,3
BR1_2731857103,7,True,0,1,0,16933,193,56,7.0,False,9,False,1,0,0,17429,186,52,6.6,True,27.4285,-496,-2,-1,249,238,11
BR1_2729577524,5,True,1,0,0,18509,264,56,7.6,True,5,False,0,1,0,18263,258,59,7.6,False,29.976916666666668,246,0,1,320,317,3
BR1_2729276734,9,False,1,0,0,18556,240,52,7.4,False,7,True,0,1,0,19617,258,68,7.4,True,27.713416666666667,-1061,2,1,292,326,-34
BR1_2730816737,3,True,1,0,0,15156,223,76,7.0,False,7,False,0,0,0,16446,200,36,6.6,True,26.504033333333332,-1290,-4,1,299,236,63
BR1_2730384069,7,False,0,0,0,18553,220,80,7.6,True,8,True,1,1,0,19260,274,48,7.4,False,28.82,-707,-1,-1,300,322,-22
BR1_2731565342,10,True,1,0,0,20269,219,67,7.4,False,5,False,0,1,0,18444,235,72,7.4,True,29.082716666666666,1825,5,1,286,307,-21
BR1_2730845706,11,True,1,1,0,20884,253,68,7.2,False,8,False,0,0,0,19015,224,52,7.0,True,29.823616666666666,1869,3,1,321,276,45
BR1_2730353165,4,False,0,0,0,16573,199,56,7.0,False,14,True,1,1,0,21446,239,68,7.4,True,29.37475,-4873,-10,-1,255,307,-52
BR1_2731616668,5,False,0,0,0,15993,203,63,7.2,False,4,True,1,0,0,15305,195,60,7.0,True,26.5644,688,1,-1,266,255,11
BR1_2731597923,5,False,1,1,0,17027,193,56,6.8,False,10,True,0,0,0,21216,229,64,7.2,True,28.685566666666666,-4189,-5,1,249,293,-44
BR1_2730286677,5,True,1,0,0,16976,219,56,7.2,True,5,False,0,1,1,18461,256,56,7.6,False,29.093216666666667,-1485,0,1,275,312,-37
BR1_2730266150,5,False,0,0,0,16181,210,58,6.4,False,10,True,1,1,0,18046,206,60,6.8,True,25.99145,-1865,-5,-1,268,266,2
BR1_2730991118,9,False,0,0,0,16478,193,32,6.8,False,9,True,1,0,0,17396,205,68,6.6,True,26.68945,-918,0,-1,225,273,-48
BR1_2730846764,2,False,0,1,0,15453,199,63,6.8,False,12,True,1,0,0,19871,207,56,6.8,True,27.3659,-4418,-10,-1,262,263,-1
BR1_2730836099,9,False,0,1,0,20171,246,41,7.2,True,8,True,1,0,0,19105,251,67,7.4,False,29.125133333333334,1066,1,-1,287,318,-31
BR1_2731722124,11,True,1,0,0,18727,195,48,7.2,True,6,False,0,0,0,16420,184,51,6.8,False,26.12465,2307,5,1,243,235,8
BR1_2724290506,10,False,1,1,0,19224,209,36,6.8,True,8,True,0,0,0,16851,178,52,6.8,False,25.561633333333333,2373,2,1,245,230,15
BR1_2717169095,5,False,0,0,0,16736,243,48,7.2,False,8,True,1,0,0,17367,217,40,6.4,True,25.66365,-631,-3,-1,291,257,34
BR1_2727066260,7,False,1,0,0,17219,216,48,7.4,True,8,True,0,0,0,20107,238,60,7.4,False,29.021716666666666,-2888,-1,1,264,298,-34
BR1_2724139324,10,True,1,0,0,19245,235,52,7.4,True,8,False,0,0,0,17900,248,52,7.8,False,28.4558,1345,2,1,287,300,-13
BR1_2731715750,12,False,0,1,0,20553,181,76,7.4,False,11,True,0,0,0,20665,230,56,7.6,True,29.43485,-112,1,0,257,286,-29
BR1_2727853886,10,True,1,0,0,18098,224,44,6.6,True,6,False,0,1,0,16057,174,56,6.6,False,26.524433333333334,2041,4,1,268,230,38
BR1_2731292784,9,False,0,0,0,20349,239,59,7.0,False,15,True,1,1,0,22052,180,52,7.2,True,29.203366666666668,-1703,-6,-1,298,232,66
BR1_2730646741,9,True,0,1,0,16658,189,51,6.6,False,14,False,1,0,0,19847,214,45,6.8,True,26.1151,-3189,-5,-1,240,259,-19
BR1_2731712977,3,False,0,0,0,16743,260,60,7.0,False,7,True,1,1,0,19169,248,68,7.4,True,28.2563,-2426,-4,-1,320,316,4
BR1_2731690260,8,False,0,0,0,18270,200,52,7.0,False,12,True,0,0,0,19719,237,52,7.4,True,28.508016666666666,-1449,-4,0,252,289,-37
BR1_2731062715,4,False,0,0,0,15906,193,44,6.8,False,12,True,0,0,0,18310,201,48,6.8,True,26.539233333333332,-2404,-8,0,237,249,-12
BR1_2731862365,9,True,0,0,0,18637,215,56,7.0,True,8,False,1,0,0,16899,211,76,7.0,False,27.233366666666665,1738,1,-1,271,287,-16
BR1_2729930694,12,False,0,1,0,20117,220,60,7.4,True,13,True,1,0,0,21135,224,48,7.4,False,29.678366666666665,-1018,-1,-1,280,272,8
BR1_2731245132,6,False,0,0,0,17863,224,64,7.0,False,7,True,1,0,0,18480,239,67,7.6,True,28.663166666666665,-617,-1,-1,288,306,-18
BR1_2730864148,6,False,0,0,0,16952,225,52,7.0,False,9,True,0,1,0,16329,152,56,6.4,True,26.986716666666666,623,-3,0,277,208,69
BR1_2730850334,7,False,0,0,0,18232,229,52,7.4,True,9,True,0,0,0,18052,210,52,7.2,False,29.2107,180,-2,0,281,262,19
BR1_2731592230,5,False,0,0,0,17518,229,72,7.2,False,11,True,0,1,0,19903,224,59,7.8,True,27.882016666666665,-2385,-6,0,301,283,18
BR1_2731339889,2,True,1,0,0,15063,233,55,6.6,False,8,False,0,0,0,16582,240,40,6.8,True,26.964266666666667,-1519,-6,1,288,280,8
BR1_2731311589,7,False,0,1,0,17908,227,64,7.2,True,6,True,0,0,0,16071,226,48,7.0,False,25.75385,1837,1,0,291,274,17
BR1_2731332320,6,True,0,0,0,18571,210,84,7.8,False,10,False,0,1,0,19849,223,52,7.6,True,27.695316666666667,-1278,-4,0,294,275,19
BR1_2731248094,8,True,0,1,0,18619,243,64,7.6,True,1,False,1,0,0,15493,245,60,7.0,False,27.961016666666666,3126,7,-1,307,305,2
BR1_2731866325,8,True,1,1,0,15725,188,36,6.6,True,2,False,0,0,0,13139,161,52,6.2,False,25.927933333333332,2586,6,1,224,213,11
BR1_2724101563,6,False,1,0,0,17937,206,68,7.0,True,6,True,0,1,0,18093,237,60,7.2,False,27.780266666666666,-156,0,1,274,297,-23
BR1_2723120873,8,False,0,1,0,18579,227,48,7.2,False,12,True,1,0,0,20834,243,68,7.4,True,27.958583333333333,-2255,-4,-1,275,311,-36
BR1_2723087816,2,False,0,0,1,15855,195,60,7.2,False,15,True,1,1,0,23627,262,72,7.6,True,29.617316666666667,-7772,-13,-1,255,334,-79
BR1_2731797723,10,False,1,0,0,19493,252,62,7.2,True,8,True,0,0,0,18478,224,47,7.4,False,28.527266666666666,1015,2,1,314,271,43
BR1_2724383584,6,False,0,1,0,17624,189,56,7.0,False,13,True,1,0,1,22066,225,46,7.4,True,29.34326666666667,-4442,-7,-1,245,271,-26
BR1_2731750330,12,False,1,0,0,19406,181,56,6.8,True,7,True,0,1,0,16978,209,52,6.8,False,27.289516666666668,2428,5,1,237,261,-24
BR1_2730215760,9,False,0,1,0,16625,178,52,6.6,False,11,True,0,0,0,17950,185,51,6.6,True,27.10905,-1325,-2,0,230,236,-6
BR1_2731788368,10,False,1,1,0,17947,204,67,6.8,True,4,True,0,0,0,15767,188,54,6.6,False,26.611816666666666,2180,6,1,271,242,29
BR1_2729496749,5,False,0,1,0,17434,256,58,7.6,False,5,True,1,0,0,18734,275,58,7.8,True,28.032866666666667,-1300,0,-1,314,333,-19
BR1_2727516846,9,False,0,1,0,18889,202,72,7.0,True,8,True,0,0,0,17104,204,44,6.8,False,26.045683333333333,1785,1,0,274,248,26
BR1_2729974215,2,True,0,1,0,15892,241,40,7.4,True,2,False,1,0,0,16097,232,69,7.0,False,28.155133333333332,-205,0,-1,281,301,-20
BR1_2729949721,8,False,0,0,0,17533,208,68,7.4,False,8,True,0,0,0,18465,216,56,7.2,True,28.078316666666666,-932,0,0,276,272,4
BR1_2729926602,4,True,1,0,0,17673,265,76,7.8,True,2,False,0,1,0,16233,215,82,7.4,False,28.333283333333334,1440,2,1,341,297,44
BR1_2729907931,6,True,0,1,0,15808,175,60,6.8,False,5,False,1,0,0,16938,227,60,7.0,True,26.87625,-1130,1,-1,235,287,-52
BR1_2731618373,5,True,0,0,0,17168,220,64,7.2,False,14,False,0,0,0,19922,235,52,7.6,True,28.529516666666666,-2754,-9,0,284,287,-3
BR1_2731654336,5,True,0,0,0,16170,228,60,6.8,True,3,False,0,0,0,14906,191,48,6.4,False,27.099333333333334,1264,2,0,288,239,49
BR1_2731602788,8,True,0,0,0,17401,203,51,6.6,False,7,False,0,0,0,16564,189,48,6.6,True,26.274233333333335,837,1,0,254,237,17
BR1_2731951446,9,True,0,0,0,16168,184,44,6.6,False,11,False,0,0,0,17805,154,56,6.8,True,26.088433333333334,-1637,-2,0,228,210,18
BR1_2731928648,7,True,1,0,0,17686,239,56,7.0,True,3,False,0,0,0,15108,195,48,6.6,False,26.5844,2578,4,1,295,243,52
BR1_2731730125,9,True,1,0,0,17138,228,48,7.0,True,12,False,0,1,0,19589,169,48,6.8,False,26.9574,-2451,-3,1,276,217,59
BR1_2730766928,5,True,0,0,0,16380,196,69,7.0,True,6,False,0,0,0,16081,227,55,7.2,False,26.713783333333332,299,-1,0,265,282,-17
BR1_2720361166,12,True,1,0,0,19122,205,52,6.6,True,7,False,0,0,0,16826,194,60,6.4,False,26.986933333333333,2296,5,1,257,254,3
BR1_2731781897,5,True,0,0,0,15733,219,54,7.0,True,4,False,0,0,0,14981,232,56,6.8,False,26.688033333333333,752,1,0,273,288,-15
BR1_2731952180,9,True,1,0,0,17784,208,59,7.2,False,7,False,0,0,0,15849,216,48,6.8,True,27.245033333333332,1935,2,1,267,264,3
BR1_2726517329,10,True,0,1,0,20517,252,53,7.4,True,7,False,1,0,0,17606,225,40,7.4,False,29.209333333333333,2911,3,-1,305,265,40
BR1_2726422406,16,True,0,0,0,23028,228,55,7.2,True,7,False,0,1,0,18704,206,60,7.4,False,28.5989,4324,9,0,283,266,17
BR1_2730265747,10,True,0,0,0,17953,189,60,7.0,False,10,False,1,0,0,17063,190,56,6.6,True,26.9572,890,0,-1,249,246,3
BR1_2726953092,3,True,0,0,0,16273,245,72,7.4,False,6,False,1,1,1,18813,229,56,7.6,True,28.955816666666667,-2540,-3,-1,317,285,32
BR1_2726922306,9,True,1,0,0,18368,215,51,7.0,False,11,False,0,1,0,19346,223,60,7.4,True,29.781183333333335,-978,-2,1,266,283,-17
BR1_2731845035,8,True,1,0,0,18464,231,55,7.2,False,3,False,0,1,0,16988,237,64,7.2,True,28.7494,1476,5,1,286,301,-15
BR1_2731823350,5,False,1,0,1,17071,199,43,6.8,True,7,True,0,0,0,17287,208,52,7.0,False,28.40886666666667,-216,-2,1,242,260,-18
BR1_2731443729,12,False,0,1,0,22541,276,56,7.4,True,10,True,1,0,0,18313,211,64,7.4,False,29.008016666666666,4228,2,-1,332,275,57
BR1_2731221691,15,True,1,0,0,20950,246,52,7.6,False,10,False,0,0,0,18443,219,56,7.2,True,28.69825,2507,5,1,298,275,23
BR1_2731196160,11,True,0,1,0,18173,172,48,6.4,True,10,False,0,0,0,18001,200,48,6.8,False,27.3336,172,1,0,220,248,-28
BR1_2731559683,7,False,0,1,0,16233,194,40,6.8,False,7,True,1,0,0,17123,202,60,6.8,True,26.609066666666667,-890,0,-1,234,262,-28
BR1_2731548585,11,True,0,0,0,19086,222,36,7.0,False,8,False,0,0,0,19199,247,72,7.8,True,28.83345,-113,3,0,258,319,-61
BR1_2727634776,10,True,0,1,0,19201,203,60,7.0,False,9,False,0,0,0,19409,227,48,7.4,True,29.109583333333333,-208,1,0,263,275,-12
BR1_2731258994,7,True,1,0,0,16648,215,48,6.8,True,3,False,0,1,0,15342,215,60,7.0,False,27.0303,1306,4,1,263,275,-12
BR1_2721825982,13,True,1,0,0,20717,282,52,7.4,True,5,False,0,1,0,17884,242,56,7.4,False,29.176383333333334,2833,8,1,334,298,36
BR1_2731803758,5,False,0,1,0,16278,225,40,6.8,False,7,True,0,0,0,16993,185,60,6.6,True,25.76781666666667,-715,-2,0,265,245,20
BR1_2724874275,7,True,1,1,0,15662,213,44,6.8,False,4,False,0,0,0,15073,198,52,6.4,True,26.2321,589,3,1,257,250,7
BR1_2731623633,10,True,0,0,0,18204,196,56,7.0,True,8,False,0,0,0,16849,171,44,6.4,False,26.143333333333334,1355,2,0,252,215,37
BR1_2731671198,6,True,0,0,0,18110,253,56,7.4,False,8,False,1,0,0,19438,233,64,7.2,True,29.2339,-1328,-2,-1,309,297,12
BR1_2731653017,11,True,0,0,0,17298,195,40,7.0,False,4,False,0,0,0,15800,226,52,7.0,True,25.497216666666667,1498,7,0,235,278,-43
BR1_2731588384,12,True,1,0,0,20479,250,52,7.8,True,3,False,0,0,0,16395,213,52,7.0,False,27.707283333333333,4084,9,1,302,265,37
BR1_2731297889,2,False,0,1,0,15737,257,34,7.0,False,10,True,1,0,0,18588,237,58,7.2,True,27.588666666666665,-2851,-8,-1,291,295,-4
BR1_2725777024,7,True,0,1,0,17696,263,44,7.4,False,5,False,1,0,0,16285,204,56,7.0,True,27.557716666666668,1411,2,-1,307,260,47
BR1_2725694153,3,True,0,0,0,15368,251,60,7.0,True,0,False,0,0,0,14224,230,56,6.8,False,25.69311666666667,1144,3,0,311,286,25
BR1_2724777339,11,True,1,0,0,21940,239,72,7.8,False,9,False,0,0,0,18626,259,52,7.6,True,29.412766666666666,3314,2,1,311,311,0
BR1_2731172734,7,False,0,1,0,17894,210,52,6.8,True,10,True,1,0,0,17209,198,36,6.8,False,25.150433333333332,685,-3,-1,262,234,28
BR1_2731816262,9,False,1,0,1,19850,175,56,7.0,True,10,True,0,1,0,19307,194,44,7.0,False,27.931316666666667,543,-1,1,231,238,-7
BR1_2731516952,15,True,1,1,1,20778,179,45,7.0,True,8,False,0,0,0,16860,197,58,6.6,False,27.12685,3918,7,1,224,255,-31
BR1_2721907403,6,True,1,0,0,18135,275,56,7.4,True,7,False,0,1,0,18138,238,52,7.2,False,28.868233333333333,-3,-1,1,331,290,41
BR1_2721887392,8,True,0,1,1,18497,223,48,6.8,False,7,False,1,0,0,17156,202,52,6.8,True,25.933683333333335,1341,1,-1,271,254,17
BR1_2721866202,5,False,0,1,0,17395,213,56,7.4,False,11,True,1,0,0,19930,242,64,7.2,True,27.53075,-2535,-6,-1,269,306,-37
BR1_2721846039,2,False,1,0,0,16036,235,79,7.0,False,9,True,0,1,0,18963,224,52,7.4,True,29.10855,-2927,-7,1,314,276,38
BR1_2721819499,3,False,0,0,0,15093,207,60,6.8,False,8,True,1,0,0,17195,213,52,6.6,True,27.434183333333333,-2102,-5,-1,267,265,2
BR1_2730088543,7,False,0,0,0,17089,186,60,7.0,True,8,True,0,0,0,16367,191,40,6.6,False,25.358883333333335,722,-1,0,246,231,15
BR1_2726041494,13,True,0,1,0,21565,250,52,7.6,True,7,False,0,0,0,18213,235,56,7.2,False,28.972916666666666,3352,6,0,302,291,11
BR1_2729364380,6,True,1,0,0,16825,225,60,7.0,False,3,False,0,1,0,15590,199,60,7.0,True,26.630116666666666,1235,3,1,285,259,26
BR1_2731253246,5,False,0,0,0,16631,216,68,7.0,False,7,True,1,1,0,17268,210,68,6.8,True,27.20255,-637,-2,-1,284,278,6
BR1_2731730013,7,True,1,0,0,16351,214,44,6.8,True,3,False,0,0,0,14564,202,44,6.8,False,25.57115,1787,4,1,258,246,12
BR1_2722222248,8,True,1,0,0,16979,197,48,6.6,False,7,False,0,1,0,17706,216,61,7.0,True,26.434216666666668,-727,1,1,245,277,-32
BR1_2721738346,9,False,0,0,0,18877,254,60,7.6,False,9,True,1,1,0,18996,226,68,7.6,True,29.992,-119,0,-1,314,294,20
BR1_2721063309,5,False,1,0,0,15170,197,48,6.8,False,5,True,0,1,0,15933,228,56,6.6,True,26.618566666666666,-763,0,1,245,284,-39
BR1_2721035633,5,False,0,1,0,15420,181,44,6.8,False,6,True,1,0,0,17531,213,48,6.6,True,25.534883333333333,-2111,-1,-1,225,261,-36
BR1_2720770545,11,False,0,0,0,19525,217,54,6.8,True,10,True,1,0,0,18330,203,48,6.4,False,27.409566666666667,1195,1,-1,271,251,20
BR1_2731625969,7,True,1,1,0,16298,223,56,7.0,True,13,False,0,0,0,18964,196,43,7.0,False,25.588566666666665,-2666,-6,1,279,239,40
BR1_2731265988,9,True,0,0,0,19823,212,68,7.4,False,14,False,1,0,0,20326,212,60,7.6,True,28.68755,-503,-5,-1,280,272,8
BR1_2728428760,7,True,1,1,0,17855,241,88,7.6,True,3,False,0,0,0,14963,207,56,7.4,False,26.774466666666665,2892,4,1,329,263,66
BR1_2730048320,10,False,0,0,0,17323,181,59,7.0,True,6,True,1,0,0,15438,166,63,7.0,False,26.110716666666665,1885,4,-1,240,229,11
BR1_2729870704,3,False,0,0,0,14995,190,52,6.8,False,8,True,1,0,0,17403,236,51,7.2,True,25.27645,-2408,-5,-1,242,287,-45
BR1_2731545971,8,True,1,0,0,18579,258,50,7.4,True,7,False,0,1,0,17491,231,52,7.4,False,27.9027,1088,1,1,308,283,25
BR1_2712023094,6,False,0,0,0,15640,201,60,6.8,False,8,True,0,0,0,16796,212,51,6.6,True,27.131616666666666,-1156,-2,0,261,263,-2
BR1_2712006322,6,True,1,0,0,18952,227,76,7.4,False,6,False,0,0,0,17646,220,72,7.4,True,29.746783333333333,1306,0,1,303,292,11
BR1_2729616459,9,False,1,0,0,18848,208,60,6.8,True,8,True,0,1,0,19557,254,50,7.0,False,29.274533333333334,-709,1,1,268,304,-36
BR1_2729525135,8,False,1,0,0,16014,177,52,7.0,True,6,True,0,0,0,15274,204,40,6.8,False,27.1437,740,2,1,229,244,-15
BR1_2729353191,6,True,0,1,0,19296,239,60,7.2,True,3,False,1,0,0,15707,236,48,7.2,False,27.64281666666667,3589,3,-1,299,284,15
BR1_2731717874,13,True,0,0,1,20209,222,36,7.2,True,6,False,0,0,0,15525,183,52,6.8,False,25.287466666666667,4684,7,0,258,235,23
BR1_2729710485,6,True,0,0,0,17023,237,69,6.8,True,7,False,0,0,0,16266,232,34,7.0,False,27.099066666666666,757,-1,0,306,266,40
BR1_2725732456,6,True,0,0,0,16747,234,56,6.8,False,7,False,1,0,0,16505,224,72,7.2,True,26.858666666666668,242,-1,-1,290,296,-6
BR1_2720524191,5,False,0,0,0,16367,203,56,6.8,False,7,True,1,0,0,18175,244,80,7.2,True,26.767233333333333,-1808,-2,-1,259,324,-65
BR1_2729252585,7,True,0,0,0,17229,209,51,7.2,True,3,False,0,0,0,16470,237,53,7.2,False,29.0639,759,4,0,260,290,-30
BR1_2728767948,7,True,1,0,0,18224,245,64,7.2,True,9,False,0,1,0,19473,208,60,7.2,False,29.0294,-1249,-2,1,309,268,41
BR1_2728737106,6,True,0,1,0,18210,199,52,7.2,False,5,False,1,0,0,18009,244,76,7.4,True,28.5235,201,1,-1,251,320,-69
BR1_2731755645,4,False,0,0,0,14521,187,59,6.4,False,13,True,1,0,0,18150,187,56,7.2,True,25.531033333333333,-3629,-9,-1,246,243,3
BR1_2729162262,15,True,0,1,0,21282,223,46,6.8,True,12,False,0,0,0,17670,138,32,6.4,False,27.1078,3612,3,0,269,170,99
BR1_2729149334,5,True,0,1,0,17061,212,59,7.4,False,5,False,1,0,0,18003,229,68,7.2,True,27.809933333333333,-942,0,-1,271,297,-26
BR1_2730627209,3,False,0,0,0,15661,227,52,7.0,False,12,True,0,0,0,19656,236,60,7.6,True,29.291833333333333,-3995,-9,0,279,296,-17
BR1_2730722422,9,True,0,0,0,18309,208,52,6.6,True,4,False,0,0,0,15369,196,52,6.6,False,25.158916666666666,2940,5,0,260,248,12
BR1_2731964969,9,False,1,0,0,19062,237,68,7.6,False,7,True,0,1,1,20663,222,72,7.4,True,28.069866666666666,-1601,2,1,305,294,11
BR1_2729947703,8,True,0,0,0,18345,198,75,7.0,True,2,False,1,0,0,14739,215,60,6.8,False,26.78151666666667,3606,6,-1,273,275,-2
BR1_2730293893,8,False,1,0,0,18944,215,75,7.6,True,4,True,0,1,0,17498,220,60,7.6,False,27.6983,1446,4,1,290,280,10
BR1_2730267124,11,False,0,0,0,18254,219,40,6.8,False,4,True,0,0,0,15526,217,55,6.8,True,25.506966666666667,2728,7,0,259,272,-13
BR1_2723475010,8,True,1,0,0,18105,230,52,7.4,False,6,False,0,1,0,17478,221,55,7.4,True,29.944816666666668,627,2,1,282,276,6
BR1_2730246573,8,True,0,0,0,19015,229,64,7.4,True,6,False,1,1,0,17453,234,64,7.2,False,28.5168,1562,2,-1,293,298,-5
BR1_2730216741,5,False,0,0,0,14747,188,42,6.6,False,10,True,0,1,0,17776,188,48,6.6,True,26.476,-3029,-5,0,230,236,-6
BR1_2730191233,10,False,1,0,0,19920,235,60,7.4,True,9,True,0,0,0,18620,239,47,7.4,False,29.388883333333332,1300,1,1,295,286,9
BR1_2731468880,12,True,0,0,0,21470,271,48,7.6,True,3,False,1,0,0,16222,242,72,7.6,False,28.908683333333332,5248,9,-1,319,314,5
BR1_2730761948,13,True,0,1,0,21768,254,67,7.8,False,13,False,0,0,0,19914,234,51,7.6,True,29.5476,1854,0,0,321,285,36
BR1_2731818820,8,True,1,0,0,17618,199,48,6.8,True,2,False,0,0,0,14307,224,42,6.6,False,26.249966666666666,3311,6,1,247,266,-19
BR1_2731927980,6,False,1,1,0,16688,213,60,7.0,False,5,True,0,0,0,16280,222,68,6.8,True,26.6284,408,1,1,273,290,-17
BR1_2724029715,6,False,1,0,0,17950,246,67,7.4,True,5,True,0,1,0,17205,202,80,7.4,False,29.042366666666666,745,1,1,313,282,31
BR1_2723977431,3,True,0,0,0,16888,226,59,7.2,True,4,False,0,1,1,18607,282,56,7.4,False,28.1976,-1719,-1,0,285,338,-53
BR1_2731166520,5,True,0,0,0,15804,208,40,6.8,True,2,False,0,0,0,14511,207,36,6.4,False,25.131266666666665,1293,3,0,248,243,5
BR1_2724735030,4,False,0,1,1,18703,232,67,7.2,True,8,True,0,0,0,18042,228,56,7.2,False,29.136533333333333,661,-4,0,299,284,15
BR1_2724721941,6,True,0,0,0,16539,205,16,6.2,False,9,False,1,1,0,20051,246,52,7.4,True,29.462966666666667,-3512,-3,-1,221,298,-77
BR1_2724429051,3,True,0,0,0,14894,189,56,6.6,True,5,False,0,0,0,15510,206,52,7.0,False,27.060616666666668,-616,-2,0,245,258,-13
BR1_2728485141,6,True,0,0,0,15904,189,44,6.6,True,6,False,1,1,0,16418,201,44,6.6,False,25.063683333333334,-514,0,-1,233,245,-12
BR1_2725419105,8,False,0,1,0,18181,237,59,7.6,True,4,True,0,0,0,17359,243,61,7.4,False,28.667183333333334,822,4,0,296,304,-8
BR1_2726376999,10,True,1,0,0,18080,212,76,7.2,True,5,False,0,0,0,16835,224,48,7.0,False,26.91975,1245,5,1,288,272,16
BR1_2725789040,9,True,0,1,0,18045,197,52,7.2,False,10,False,0,0,0,19952,206,58,7.4,True,27.536416666666668,-1907,-1,0,249,264,-15
BR1_2730809308,9,True,0,0,0,18187,220,44,7.0,False,8,False,1,0,1,19725,226,64,7.2,True,29.05925,-1538,1,-1,264,290,-26
BR1_2730308114,3,False,0,0,0,16111,210,55,6.8,True,6,True,0,0,0,16810,232,68,7.2,False,25.931916666666666,-699,-3,0,265,300,-35
BR1_2729937362,8,True,0,0,0,18100,249,56,7.2,False,4,False,1,0,0,15647,213,60,7.0,True,26.068366666666666,2453,4,-1,305,273,32
BR1_2724295420,13,False,1,0,0,20922,223,48,7.0,True,9,True,0,1,0,18774,192,56,6.8,False,29.672166666666666,2148,4,1,271,248,23
BR1_2723832431,5,True,0,0,0,15612,192,36,6.2,False,13,False,1,0,0,19379,185,60,7.0,True,26.186183333333332,-3767,-8,-1,228,245,-17
BR1_2730540936,8,False,0,0,0,17032,168,44,6.8,False,10,True,0,0,0,18476,192,59,7.0,True,26.429266666666667,-1444,-2,0,212,251,-39
BR1_2730838076,3,True,1,0,0,17331,291,56,7.4,True,4,False,0,1,0,17540,249,68,7.4,False,27.648133333333334,-209,-1,1,347,317,30
BR1_2730812479,6,False,0,0,0,18815,244,60,7.2,True,6,True,1,0,0,16920,229,62,7.4,False,28.919483333333332,1895,0,-1,304,291,13
BR1_2719116855,3,False,0,0,0,15211,194,76,6.6,False,10,True,1,1,0,19091,256,64,7.2,True,26.206666666666667,-3880,-7,-1,270,320,-50
BR1_2729459184,4,True,0,1,1,19248,272,58,7.6,False,6,False,1,0,0,18492,250,57,7.6,True,27.92515,756,-2,-1,330,307,23
BR1_2729391928,7,True,1,0,0,18703,256,76,7.6,True,3,False,0,0,0,16515,210,52,7.0,False,27.91871666666667,2188,4,1,332,262,70
BR1_2731717884,8,False,1,0,0,18060,216,64,7.4,True,10,True,0,0,0,20038,244,60,7.4,False,27.909,-1978,-2,1,280,304,-24
BR1_2731262778,11,False,0,1,0,18213,229,47,7.2,False,8,True,1,0,0,17989,207,52,7.2,True,26.492816666666666,224,3,-1,276,259,17
BR1_2727960824,6,False,0,0,0,16912,220,45,6.8,False,7,True,1,0,0,17003,230,48,6.8,True,26.7557,-91,-1,-1,265,278,-13
BR1_2727855528,8,True,0,0,0,17645,227,48,7.2,False,4,False,0,0,0,16854,249,64,7.4,True,28.200983333333333,791,4,0,275,313,-38
BR1_2730165028,7,True,0,0,0,16839,223,52,6.8,False,1,False,0,0,0,13759,209,51,6.6,True,26.854216666666666,3080,6,0,275,260,15
BR1_2731903389,4,True,0,0,0,16383,226,52,6.6,True,3,False,0,0,0,15141,215,60,7.2,False,25.87365,1242,1,0,278,275,3
BR1_2731688306,8,True,0,0,0,16635,205,52,6.8,False,7,False,1,0,0,16268,201,56,7.0,True,27.439,367,1,-1,257,257,0
BR1_2730677345,12,False,0,1,0,19318,208,52,7.2,True,11,True,1,0,0,18845,202,44,6.6,False,29.6249,473,1,-1,260,246,14
BR1_2731343258,7,True,0,1,0,17823,214,68,6.8,True,6,False,0,0,0,15695,181,52,7.2,False,25.9178,2128,1,0,282,233,49
BR1_2731585232,10,True,0,0,0,19913,232,56,7.2,False,7,False,1,1,0,17823,206,52,7.0,True,28.67755,2090,3,-1,288,258,30
BR1_2730964170,8,True,0,1,0,17497,197,40,6.6,False,11,False,1,0,0,19463,212,56,6.8,True,25.246666666666666,-1966,-3,-1,237,268,-31
BR1_2730601102,11,True,1,0,0,19756,206,60,7.2,False,7,False,0,1,1,19601,233,50,7.4,True,28.708916666666667,155,4,1,266,283,-17
BR1_2725691003,8,True,1,0,0,17241,212,60,7.0,True,2,False,0,0,0,14653,225,64,7.0,False,27.429066666666667,2588,6,1,272,289,-17
BR1_2716271116,5,False,0,0,0,15596,177,72,6.8,False,11,True,0,1,0,18541,221,44,7.2,True,25.0544,-2945,-6,0,249,265,-16
BR1_2716248479,12,False,1,0,0,19521,199,56,7.4,False,9,True,0,0,1,21935,278,52,7.4,True,28.975133333333332,-2414,3,1,255,330,-75
BR1_2716223374,7,False,0,0,0,17553,200,52,7.4,False,7,True,1,0,0,18877,259,68,7.4,True,29.07245,-1324,0,-1,252,327,-75
BR1_2731753240,6,False,0,0,0,15914,210,52,6.6,False,7,True,1,1,0,17322,216,76,6.8,True,25.7368,-1408,-1,-1,262,292,-30
BR1_2729712162,12,True,0,1,0,18933,212,64,7.2,True,4,False,1,0,0,15338,194,44,6.4,False,26.6301,3595,8,-1,276,238,38
BR1_2731742203,8,False,0,0,0,16645,189,48,6.6,False,9,True,0,0,0,18346,225,56,7.2,True,26.1938,-1701,-1,0,237,281,-44
BR1_2731232907,7,True,0,1,0,18753,247,58,7.0,True,9,False,1,0,0,18948,218,70,7.6,False,29.057733333333335,-195,-2,-1,305,288,17
BR1_2729382145,10,False,0,0,0,18419,197,49,6.8,False,10,True,1,0,0,19299,207,59,7.0,True,28.71285,-880,0,-1,246,266,-20
BR1_2730652771,8,True,1,1,0,18808,237,66,7.0,True,5,False,0,0,0,15542,196,53,6.8,False,25.605416666666667,3266,3,1,303,249,54
BR1_2729346545,3,False,0,0,0,14333,206,44,6.6,False,7,True,1,1,0,16943,192,60,7.0,True,26.46165,-2610,-4,-1,250,252,-2
BR1_2731449677,9,True,0,0,0,18627,237,56,7.6,False,10,False,1,0,0,20596,257,68,7.4,True,28.986883333333335,-1969,-1,-1,293,325,-32
BR1_2731436978,12,True,0,0,0,20327,223,55,7.6,False,14,False,1,0,0,21731,232,60,7.6,True,28.014666666666667,-1404,-2,-1,278,292,-14
BR1_2730236376,6,False,0,0,0,18014,238,72,7.4,True,8,True,0,0,0,18406,236,62,7.4,False,28.575133333333333,-392,-2,0,310,298,12
BR1_2727448609,6,True,0,1,0,15873,199,68,7.2,True,2,False,0,0,0,14153,192,52,7.0,False,25.016016666666665,1720,4,0,267,244,23
BR1_2731834898,7,False,0,0,0,18933,212,48,7.2,False,10,True,1,0,0,19609,218,48,6.8,True,29.481016666666665,-676,-3,-1,260,266,-6
BR1_2731824242,14,True,0,0,0,21106,213,52,7.2,True,7,False,1,0,0,17464,209,56,7.0,False,28.379683333333332,3642,7,-1,265,265,0
BR1_2730627181,10,True,0,0,0,18521,198,44,6.8,False,16,False,0,0,0,23392,204,64,7.4,True,28.633733333333332,-4871,-6,0,242,268,-26
BR1_2731313874,10,True,1,0,0,18706,218,48,7.0,True,4,False,0,1,0,15579,208,56,6.8,False,26.0585,3127,6,1,266,264,2
BR1_2730975408,2,False,1,0,0,14936,214,76,6.8,False,7,True,0,0,0,16818,225,48,7.2,True,25.50545,-1882,-5,1,290,273,17
BR1_2731943513,5,True,0,1,0,18011,211,80,7.6,True,4,False,1,0,0,17216,250,69,7.4,False,29.993316666666665,795,1,-1,291,319,-28
BR1_2731028378,15,True,1,0,0,21849,237,60,7.6,True,7,False,0,0,0,17370,216,44,6.8,False,29.740666666666666,4479,8,1,297,260,37
BR1_2730956025,8,True,0,0,0,19140,252,52,7.6,False,11,False,1,0,0,19768,233,59,7.4,True,29.968466666666668,-628,-3,-1,304,292,12
BR1_2729710763,12,True,0,0,0,21006,252,60,7.8,False,6,False,1,0,0,17533,252,59,7.4,True,28.464483333333334,3473,6,-1,312,311,1
BR1_2717989550,5,False,0,1,0,18319,233,64,7.4,True,5,True,1,0,0,17670,251,64,7.6,False,28.080116666666665,649,0,-1,297,315,-18
BR1_2717882421,7,False,0,1,0,16999,210,56,7.0,False,5,True,1,0,0,16263,223,70,7.2,True,26.602616666666666,736,2,-1,266,293,-27
BR1_2715947290,6,False,0,0,0,15658,170,48,6.6,False,9,True,1,0,0,17995,195,64,7.2,True,25.859483333333333,-2337,-3,-1,218,259,-41
BR1_2730323721,3,False,0,1,1,18900,248,75,7.4,True,6,True,0,0,0,17847,246,44,7.6,False,29.220216666666666,1053,-3,0,323,290,33
BR1_2731954831,4,False,0,0,0,14881,201,48,6.4,False,11,True,1,0,0,19665,245,55,7.0,True,25.159116666666666,-4784,-7,-1,249,300,-51
BR1_2731725826,8,True,1,0,0,18440,204,50,6.6,True,10,False,0,0,0,18005,203,37,6.8,False,25.5276,435,-2,1,254,240,14
BR1_2731153536,12,True,0,0,0,19688,221,44,6.8,True,7,False,0,1,0,16519,185,38,6.8,False,26.46615,3169,5,0,265,223,42
BR1_2730496693,7,True,0,1,0,18368,227,56,6.8,True,12,False,1,0,1,21828,235,68,7.8,False,28.077783333333333,-3460,-5,-1,283,303,-20
BR1_2728760028,6,False,1,0,0,18885,232,60,7.2,False,10,True,0,0,0,19371,217,52,7.4,True,28.09485,-486,-4,1,292,269,23
BR1_2719153374,5,True,1,0,0,15959,205,52,6.8,False,8,False,0,1,0,16853,177,56,7.0,True,25.9499,-894,-3,1,257,233,24
BR1_2719137758,11,False,0,0,0,18761,244,62,7.4,True,4,True,1,0,0,15184,188,44,6.6,False,27.071183333333334,3577,7,-1,306,232,74
BR1_2730962518,6,True,0,0,0,16706,241,43,7.0,True,7,False,0,0,0,16752,208,68,7.0,False,27.45355,-46,-1,0,284,276,8
BR1_2730679450,4,True,0,0,0,15232,223,55,6.8,True,4,False,0,0,0,14994,191,51,6.8,False,26.70195,238,0,0,278,242,36
BR1_2728853053,9,False,1,0,0,17011,199,51,6.8,True,7,True,0,1,0,16999,199,56,7.0,False,27.347516666666667,12,2,1,250,255,-5
BR1_2729609491,5,False,1,0,0,18292,281,66,7.6,False,3,True,0,1,0,16518,226,56,7.2,True,28.039183333333334,1774,2,1,347,282,65
BR1_2722967569,4,True,0,0,0,16478,198,56,7.0,True,9,False,0,0,0,19306,243,56,7.4,False,29.934616666666667,-2828,-5,0,254,299,-45
BR1_2722912943,1,False,1,0,0,13626,183,52,6.2,False,13,True,0,0,1,21848,253,48,7.2,True,27.498533333333334,-8222,-12,1,235,301,-66
BR1_2731834572,3,True,0,1,0,17128,254,60,7.2,True,8,False,1,0,0,18952,243,68,7.4,False,27.61328333333333,-1824,-5,-1,314,311,3
BR1_2729871159,4,False,0,0,0,14738,201,56,6.8,False,5,True,1,1,0,15972,210,64,7.0,True,27.0382,-1234,-1,-1,257,274,-17
BR1_2729435701,11,True,0,0,0,20368,224,56,7.0,True,14,False,1,0,0,21068,234,52,7.2,False,29.458733333333335,-700,-3,-1,280,286,-6
BR1_2730519196,10,False,0,0,0,17444,146,52,5.8,False,7,True,1,0,0,16490,199,56,6.4,True,26.86691666666667,954,3,-1,198,255,-57
BR1_2730730221,4,False,1,0,0,17534,259,54,7.6,True,8,True,0,1,0,18635,235,57,7.4,False,28.415433333333333,-1101,-4,1,313,292,21
BR1_2730120422,7,False,0,0,0,15909,205,64,6.8,False,6,True,0,0,0,16980,230,56,7.2,True,26.437183333333333,-1071,1,0,269,286,-17
BR1_2731719840,9,True,0,1,0,17296,212,56,7.0,True,6,False,1,0,0,17088,231,56,6.6,False,26.9267,208,3,-1,268,287,-19
BR1_2731309779,6,True,1,0,0,17990,244,55,7.2,False,9,False,0,1,0,19640,252,52,7.6,True,29.850033333333332,-1650,-3,1,299,304,-5
BR1_2731903162,6,False,0,1,0,18501,207,96,7.6,True,11,True,1,0,0,21638,266,52,7.6,False,29.068266666666666,-3137,-5,-1,303,318,-15
BR1_2718627700,7,False,0,0,0,16068,168,48,6.4,True,8,True,0,0,0,16701,174,48,6.2,False,27.49755,-633,-1,0,216,222,-6
BR1_2707917256,6,False,0,0,0,16797,250,56,7.0,False,6,True,1,0,0,16255,210,59,7.0,True,26.332933333333333,542,0,-1,306,269,37
BR1_2700130164,8,True,0,0,0,17677,238,52,7.0,False,10,False,1,1,0,17963,202,44,7.0,True,26.80985,-286,-2,-1,290,246,44
BR1_2729105879,7,False,0,0,0,15671,169,42,6.6,False,11,True,1,1,0,18597,193,67,7.0,True,27.091533333333334,-2926,-4,-1,211,260,-49
BR1_2730854974,7,True,0,0,0,17834,193,58,6.8,False,10,False,1,1,0,21056,245,74,7.2,True,28.482566666666667,-3222,-3,-1,251,319,-68
BR1_2730849251,7,True,0,1,0,16856,183,55,6.8,True,6,False,0,0,0,15330,191,36,6.6,False,25.26575,1526,1,0,238,227,11
BR1_2731531553,12,True,1,0,0,18285,206,48,7.0,True,10,False,0,0,0,17407,209,38,7.0,False,27.17735,878,2,1,254,247,7
BR1_2730996792,7,True,1,0,0,18154,231,60,7.2,True,4,False,0,1,0,16651,224,64,7.2,False,28.817183333333332,1503,3,1,291,288,3
BR1_2730327832,4,False,1,1,0,16599,231,56,7.2,True,8,True,0,0,0,19671,242,60,7.4,False,29.746766666666666,-3072,-4,1,287,302,-15
BR1_2728187446,11,True,1,0,0,18501,207,60,7.0,True,8,False,0,0,0,16095,188,47,6.8,False,25.0826,2406,3,1,267,235,32
BR1_2715914341,7,False,0,0,0,17273,194,70,6.8,True,8,True,0,0,0,17170,177,56,7.0,False,26.2714,103,-1,0,264,233,31
BR1_2715861184,8,False,0,0,0,19207,262,52,7.4,False,12,True,1,1,0,20471,224,60,7.6,True,28.349483333333332,-1264,-4,-1,314,284,30
BR1_2715832197,1,False,1,0,0,14594,220,64,7.2,True,10,True,0,1,0,20154,265,60,7.6,False,27.586766666666666,-5560,-9,1,284,325,-41
BR1_2729654867,4,False,1,0,0,13831,161,48,6.4,False,3,True,0,0,0,15559,231,62,7.0,True,27.211033333333333,-1728,1,1,209,293,-84
BR1_2729628834,10,True,1,0,0,18689,185,44,6.6,True,4,False,0,0,0,16135,220,56,6.8,False,25.818033333333332,2554,6,1,229,276,-47
BR1_2731130135,2,False,0,1,0,16013,235,52,7.4,False,8,True,1,0,0,19398,263,68,7.6,True,28.440433333333335,-3385,-6,-1,287,331,-44
BR1_2731231187,7,False,0,0,0,16026,172,46,6.6,False,13,True,1,0,0,20259,236,54,6.8,True,26.887433333333334,-4233,-6,-1,218,290,-72
BR1_2729763666,13,True,0,0,0,18709,200,56,6.8,True,8,False,0,0,0,17234,160,51,6.4,False,25.1532,1475,5,0,256,211,45
BR1_2727814612,6,True,1,0,0,17284,209,49,7.0,True,7,False,0,0,0,17947,216,62,7.4,False,29.86745,-663,-1,1,258,278,-20
BR1_2731653397,13,True,1,1,0,20245,205,55,7.4,True,8,False,0,0,0,17151,207,48,7.2,False,28.84326666666667,3094,5,1,260,255,5
BR1_2731968298,5,True,1,0,0,16671,234,72,7.0,True,3,False,0,1,0,15391,215,60,7.0,False,26.433083333333332,1280,2,1,306,275,31
BR1_2729572856,8,False,0,1,0,17850,224,48,6.8,True,8,True,0,0,0,17622,214,64,7.0,False,25.358183333333333,228,0,0,272,278,-6
BR1_2724384457,11,True,1,0,0,19719,236,44,7.2,True,8,False,0,0,0,18534,206,52,7.4,False,29.96055,1185,3,1,280,258,22
BR1_2731394325,7,False,1,0,0,16345,192,44,6.6,True,7,True,0,0,0,17443,232,56,7.0,False,26.116066666666665,-1098,0,1,236,288,-52
BR1_2730884613,4,False,0,0,0,15108,212,64,7.0,True,3,True,0,0,0,15128,207,52,6.8,False,26.672166666666666,-20,1,0,276,259,17
BR1_2729117393,2,False,1,1,0,14237,194,48,6.4,False,9,True,0,0,0,16975,197,64,7.0,True,25.171766666666667,-2738,-7,1,242,261,-19
BR1_2722903379,7,False,0,0,0,17817,195,64,7.0,False,15,True,1,1,0,22252,221,64,8.0,True,28.046583333333334,-4435,-8,-1,259,285,-26
BR1_2731549939,5,True,0,0,0,16200,226,52,7.0,True,2,False,0,0,0,14677,227,52,6.8,False,25.5499,1523,3,0,278,279,-1
BR1_2730254754,10,False,1,0,0,19257,257,51,7.4,True,8,True,0,1,0,19700,252,60,7.4,False,28.910466666666668,-443,2,1,308,312,-4
BR1_2731943818,10,False,0,0,0,19471,253,58,7.2,False,10,True,1,1,0,20374,236,52,7.2,True,28.6664,-903,0,-1,311,288,23
BR1_2728668939,7,False,0,1,0,17186,208,44,7.0,True,7,True,0,0,0,16916,197,48,7.0,False,25.268816666666666,270,0,0,252,245,7
BR1_2713885637,6,True,0,0,0,17194,194,54,7.0,False,11,False,1,0,0,19790,229,51,7.4,True,29.051083333333334,-2596,-5,-1,248,280,-32
BR1_2713665311,10,False,1,1,0,18754,199,66,7.2,True,8,True,0,0,0,17249,210,52,6.8,False,25.58975,1505,2,1,265,262,3
BR1_2730098360,7,True,0,1,0,17089,213,48,6.6,True,10,False,1,0,0,18067,199,60,7.0,False,26.505133333333333,-978,-3,-1,261,259,2
BR1_2729082563,11,True,1,0,0,19895,212,68,7.4,True,5,False,0,1,0,17184,207,64,7.2,False,27.719333333333335,2711,6,1,280,271,9
BR1_2729887065,5,True,1,0,0,17550,248,57,7.4,True,4,False,0,1,0,16415,210,66,7.2,False,29.346966666666667,1135,1,1,305,276,29
BR1_2729589824,6,False,1,0,0,18084,226,64,7.2,True,11,True,0,1,0,20499,235,59,7.2,False,28.413533333333334,-2415,-5,1,290,294,-4
BR1_2727466279,5,True,0,0,0,17885,264,64,7.4,False,9,False,1,1,1,20706,255,72,7.6,True,28.1289,-2821,-4,-1,328,327,1
BR1_2725973299,6,False,1,1,0,17624,231,68,7.0,True,4,True,0,0,0,15420,202,44,6.6,False,26.464766666666666,2204,2,1,299,246,53
BR1_2731799899,3,False,0,0,0,14897,203,56,7.2,False,7,True,0,1,0,19659,224,64,7.6,True,29.8415,-4762,-4,0,259,288,-29
BR1_2731756528,2,False,0,0,0,14218,208,56,6.8,False,5,True,1,0,0,15529,196,52,7.0,True,25.466283333333333,-1311,-3,-1,264,248,16
BR1_2730565842,5,False,0,1,0,17567,227,56,7.4,True,3,True,1,0,0,15432,195,48,7.0,False,29.131833333333333,2135,2,-1,283,243,40
BR1_2723956919,10,False,1,0,0,20326,233,76,7.8,True,6,True,0,0,0,18331,266,60,7.6,False,28.033466666666666,1995,4,1,309,326,-17
BR1_2730249212,6,True,0,0,0,15764,175,52,6.4,False,8,False,0,1,0,16986,225,68,7.2,True,26.485783333333334,-1222,-2,0,227,293,-66
BR1_2731512123,5,False,0,0,0,16199,232,60,7.0,False,7,True,1,1,0,17066,234,64,7.0,True,27.0602,-867,-2,-1,292,298,-6
BR1_2731250911,10,False,1,0,0,19771,207,60,7.0,False,19,True,0,1,1,24734,226,58,7.2,True,28.604,-4963,-9,1,267,284,-17
BR1_2731747996,3,False,0,0,0,16138,226,64,7.0,False,5,True,0,1,0,17931,255,48,7.6,True,28.3235,-1793,-2,0,290,303,-13
BR1_2731712959,5,True,1,1,0,17228,264,40,7.6,False,8,False,0,0,0,19142,251,59,7.8,True,28.137416666666667,-1914,-3,1,304,310,-6
BR1_2728883134,6,False,0,1,0,16101,220,64,6.8,False,10,True,1,0,0,18053,234,60,7.0,True,25.66705,-1952,-4,-1,284,294,-10
BR1_2728691386,6,False,0,1,0,18085,244,48,7.4,True,12,True,1,0,0,21029,286,67,8.0,False,28.448266666666665,-2944,-6,-1,292,353,-61
BR1_2731745259,5,False,0,0,0,17643,262,64,7.4,True,5,True,0,0,0,18372,253,70,7.6,False,28.359,-729,0,0,326,323,3
BR1_2731715416,5,False,0,1,0,17675,255,70,7.8,True,6,True,1,0,0,17855,248,78,7.8,False,28.62005,-180,-1,-1,325,326,-1
BR1_2731553654,9,False,0,1,0,17764,199,60,7.0,True,6,True,0,0,0,16402,198,44,6.8,False,27.031683333333334,1362,3,0,259,242,17
BR1_2729771213,5,False,0,0,0,17432,264,56,7.4,False,8,True,1,1,0,19100,236,84,7.6,True,27.682016666666666,-1668,-3,-1,320,320,0
BR1_2726746079,8,True,1,0,0,16786,196,31,6.4,False,12,False,0,0,0,18769,181,72,7.0,True,26.120583333333332,-1983,-4,1,227,253,-26
BR1_2721133443,4,True,0,0,1,14911,187,47,6.4,False,9,False,1,0,0,18918,197,84,6.8,True,26.2356,-4007,-5,-1,234,281,-47
BR1_2731919563,5,False,0,1,0,16298,200,52,6.8,True,8,True,1,0,0,18008,229,67,7.2,False,25.1254,-1710,-3,-1,252,296,-44
BR1_2729847763,8,True,1,0,0,17918,207,48,7.0,True,8,False,0,0,0,18055,223,68,7.0,False,27.062916666666666,-137,0,1,255,291,-36
BR1_2731289134,5,True,0,0,0,17236,252,60,7.4,False,7,False,1,0,0,17876,235,52,7.4,True,28.536633333333334,-640,-2,-1,312,287,25
BR1_2731530616,4,True,1,0,0,15620,213,60,7.2,True,2,False,0,0,0,14724,226,62,6.8,False,26.880733333333332,896,2,1,273,288,-15
BR1_2731512219,9,True,0,0,0,17226,197,56,6.8,True,4,False,1,0,0,15210,194,62,6.8,False,26.141083333333334,2016,5,-1,253,256,-3
BR1_2731233641,4,True,0,0,0,17106,272,48,7.0,True,1,False,1,0,0,14557,228,56,6.8,False,29.594733333333334,2549,3,-1,320,284,36
BR1_2731780887,7,True,1,0,1,17810,225,48,6.6,True,2,False,0,1,0,14784,210,80,6.8,False,26.88065,3026,5,1,273,290,-17
BR1_2725150479,13,False,1,0,0,20552,208,63,7.6,True,8,True,0,0,0,17886,184,51,6.8,False,27.64345,2666,5,1,271,235,36
BR1_2731465551,12,False,1,0,0,19103,188,60,7.0,False,13,True,0,0,0,22104,252,88,8.0,True,29.14085,-3001,-1,1,248,340,-92
BR1_2728503651,10,False,0,0,0,16773,168,48,6.8,False,7,True,0,1,0,17286,204,48,6.8,True,27.29008333333333,-513,3,0,216,252,-36
BR1_2731637034,15,True,0,0,0,23584,252,71,7.6,True,7,False,1,1,0,18517,251,52,7.2,False,27.634933333333333,5067,8,-1,323,303,20
BR1_2731601150,9,False,1,0,0,17378,176,72,6.6,True,10,True,0,0,0,18575,216,64,7.0,False,26.417866666666665,-1197,-1,1,248,280,-32
BR1_2730786509,5,False,0,0,0,16846,222,62,7.4,False,12,True,1,0,1,21242,218,62,7.4,True,29.682683333333333,-4396,-7,-1,284,280,4
BR1_2731872966,4,True,0,0,0,15516,196,62,6.4,False,8,False,1,0,0,16610,186,58,6.8,True,25.7208,-1094,-4,-1,258,244,14
BR1_2729969043,5,False,0,0,0,15916,200,56,6.8,False,8,True,0,0,0,18342,243,48,7.0,True,25.656816666666668,-2426,-3,0,256,291,-35
BR1_2729927889,9,False,0,0,0,18195,176,56,7.0,False,10,True,0,0,0,17451,163,52,6.6,True,25.892616666666665,744,-1,0,232,215,17
BR1_2730395346,9,False,1,1,0,19342,239,64,7.6,False,9,True,0,0,0,20155,232,56,7.4,True,28.591966666666668,-813,0,1,303,288,15
BR1_2729772491,7,False,0,0,0,18193,230,48,7.8,False,5,True,1,0,0,18901,252,60,7.6,True,29.140866666666668,-708,2,-1,278,312,-34
BR1_2731626651,7,True,0,0,0,16272,185,52,6.6,False,10,False,1,0,0,18275,221,60,7.2,True,25.298366666666666,-2003,-3,-1,237,281,-44
BR1_2731477298,12,False,0,1,0,20851,206,59,7.2,True,10,True,1,0,0,18041,164,52,6.6,False,29.5654,2810,2,-1,265,216,49
BR1_2731974157,5,True,0,0,0,16515,204,56,7.2,False,10,False,1,0,0,18762,228,52,7.8,True,29.423866666666665,-2247,-5,-1,260,280,-20
BR1_2731821688,9,True,0,0,0,18462,240,65,7.2,True,4,False,0,0,0,16030,223,44,6.8,False,25.704833333333333,2432,5,0,305,267,38
BR1_2731471500,5,True,0,1,1,19773,259,80,7.8,True,4,False,1,0,0,17641,256,56,7.6,False,29.07818333333333,2132,1,-1,339,312,27
BR1_2730206397,7,False,1,0,0,18727,266,68,7.4,True,7,True,0,0,0,17989,227,56,7.4,False,29.852733333333333,738,0,1,334,283,51
BR1_2728311367,7,True,0,1,1,19753,242,50,7.0,True,8,False,1,0,0,17408,177,69,6.4,False,28.5413,2345,-1,-1,292,246,46
BR1_2718405549,22,True,0,1,0,22941,185,52,7.0,True,13,False,0,0,0,17582,131,32,6.4,False,26.095133333333333,5359,9,0,237,163,74
BR1_2730996921,11,False,0,0,0,20024,238,62,7.2,True,5,True,1,0,0,17560,239,76,7.4,False,29.637866666666667,2464,6,-1,300,315,-15
BR1_2730978776,10,True,1,0,0,20393,276,68,7.8,True,6,False,0,1,0,17333,233,56,7.4,False,27.73845,3060,4,1,344,289,55
BR1_2724477241,7,False,0,0,0,16713,226,60,7.2,False,6,True,1,0,0,16250,223,40,6.6,True,26.317183333333332,463,1,-1,286,263,23
BR1_2723655552,5,False,0,0,0,15742,214,52,6.8,True,4,True,0,0,0,14943,174,59,6.6,False,27.419316666666667,799,1,0,266,233,33
BR1_2722421638,3,False,0,0,0,14707,204,56,7.0,False,8,True,1,0,0,17716,219,64,7.0,True,25.012516666666667,-3009,-5,-1,260,283,-23
BR1_2724709987,8,False,1,1,0,18948,237,72,7.4,True,6,True,0,0,0,18154,244,48,7.2,False,29.9846,794,2,1,309,292,17
BR1_2731507056,8,True,0,0,0,17911,204,52,6.6,True,6,False,1,0,0,16613,204,48,7.0,False,27.0197,1298,2,-1,256,252,4
BR1_2730075258,9,False,0,0,0,17723,220,56,7.2,True,6,True,1,0,0,14849,195,39,6.6,False,25.236516666666667,2874,3,-1,276,234,42
BR1_2731603428,5,False,0,0,0,16211,206,60,7.2,False,5,True,1,0,0,15986,209,52,7.2,True,25.994333333333334,225,0,-1,266,261,5
BR1_2731018263,3,False,0,0,0,14353,188,56,7.0,False,6,True,1,0,0,16812,220,63,7.0,True,25.881966666666667,-2459,-3,-1,244,283,-39
BR1_2730830934,11,False,1,1,0,18883,200,56,7.4,True,7,True,0,0,0,17919,214,48,7.2,False,28.514,964,4,1,256,262,-6
BR1_2730688804,6,False,0,0,0,15991,182,56,6.8,False,12,True,1,1,0,18953,209,68,7.2,True,25.656983333333333,-2962,-6,-1,238,277,-39
BR1_2730759721,7,True,0,0,0,16754,189,64,6.8,True,6,False,0,0,0,16630,192,60,6.6,False,26.811683333333335,124,1,0,253,252,1
BR1_2731632172,1,False,0,1,0,15594,257,60,7.4,False,5,True,1,0,0,17601,251,68,7.6,True,27.695383333333332,-2007,-4,-1,317,319,-2
BR1_2731609676,7,True,0,1,0,18247,234,60,7.2,True,3,False,1,0,0,14775,216,64,7.0,False,26.009716666666666,3472,4,-1,294,280,14
BR1_2719103744,11,True,0,0,0,19733,254,56,7.0,True,5,False,1,0,0,15403,202,48,6.6,False,25.5599,4330,6,-1,310,250,60
BR1_2730439334,4,False,1,0,0,15977,236,50,6.8,True,7,True,0,0,0,17387,225,60,7.0,False,26.45245,-1410,-3,1,286,285,1
BR1_2729764938,6,False,1,0,0,15922,192,56,6.8,False,9,True,0,0,0,17539,208,52,7.0,True,25.687633333333334,-1617,-3,1,248,260,-12
BR1_2728028838,13,False,0,1,0,22426,234,64,7.4,True,11,True,1,0,0,20553,215,68,7.6,False,28.717616666666668,1873,2,-1,298,283,15
BR1_2731457219,9,False,1,1,0,16862,184,68,7.0,True,6,True,0,0,0,15646,202,43,6.6,False,27.279133333333334,1216,3,1,252,245,7
BR1_2731594647,5,False,0,1,0,16371,226,44,6.4,True,4,True,1,0,0,14996,205,46,6.6,False,25.3594,1375,1,-1,270,251,19
BR1_2731335457,3,False,1,0,0,16100,206,64,7.2,False,7,True,0,1,0,17635,209,64,7.2,True,27.798933333333334,-1535,-4,1,270,273,-3
BR1_2731571780,7,True,1,1,0,19779,264,76,7.4,False,6,False,0,0,0,17927,245,47,7.2,True,28.718733333333333,1852,1,1,340,292,48
BR1_2729325036,7,False,0,1,0,19030,235,68,7.4,False,7,True,1,0,0,17960,239,72,7.4,True,28.308933333333332,1070,0,-1,303,311,-8
BR1_2729245528,16,True,0,1,0,22420,218,52,7.4,False,10,False,1,0,0,17889,203,63,7.2,True,28.2718,4531,6,-1,270,266,4
BR1_2731875888,11,True,1,0,0,18063,186,40,7.0,False,8,False,0,0,0,16761,153,56,6.6,True,25.978816666666667,1302,3,1,226,209,17
BR1_2731849155,7,True,1,1,0,17431,219,64,7.0,False,5,False,0,0,0,16539,194,52,7.4,True,25.72,892,2,1,283,246,37
BR1_2727769899,10,False,1,1,0,18652,205,48,6.8,True,8,True,0,0,0,16840,185,36,6.8,False,26.783316666666668,1812,2,1,253,221,32
BR1_2731620632,8,True,0,0,0,19840,256,48,7.6,True,4,False,1,1,1,19302,260,64,7.4,False,27.931183333333333,538,4,-1,304,324,-20
BR1_2731604429,8,False,0,0,0,16323,193,40,6.6,False,8,True,0,0,0,18126,234,52,6.8,True,27.1514,-1803,0,0,233,286,-53
BR1_2730348726,7,True,0,1,0,17782,204,71,6.8,True,4,False,0,0,0,15533,225,43,6.8,False,25.899283333333333,2249,3,0,275,268,7
BR1_2731411537,5,False,0,1,0,15846,214,40,6.6,False,5,True,0,0,0,16277,199,48,6.8,True,27.42285,-431,0,0,254,247,7
BR1_2731430957,6,False,0,0,0,17666,241,44,7.0,False,13,True,1,1,0,24258,267,100,8.2,True,29.154916666666665,-6592,-7,-1,285,367,-82
BR1_2730930059,7,True,0,0,0,16612,209,60,7.0,True,3,False,1,0,0,14917,210,56,6.6,False,25.366016666666667,1695,4,-1,269,266,3
BR1_2730116927,10,True,1,1,0,18971,228,48,7.0,False,9,False,0,0,0,19083,234,52,7.0,True,27.8765,-112,1,1,276,286,-10
BR1_2722223997,14,False,0,0,0,19200,203,44,7.0,True,9,True,1,0,0,18011,218,44,7.0,False,25.760866666666665,1189,5,-1,247,262,-15
BR1_2731607016,6,True,1,0,0,17097,209,68,7.0,True,5,False,0,0,0,15428,192,48,6.6,False,25.802633333333333,1669,1,1,277,240,37
BR1_2730727889,4,False,0,0,0,16885,245,58,7.2,True,8,True,1,0,0,18280,250,48,7.4,False,28.826833333333333,-1395,-4,-1,303,298,5
BR1_2715684376,7,True,0,0,0,15978,226,46,6.6,False,7,False,1,0,0,16896,207,59,6.8,True,25.786416666666668,-918,0,-1,272,266,6
BR1_2715657810,12,True,1,0,0,19124,189,59,6.8,True,8,False,0,1,1,19300,204,48,6.6,False,25.601033333333334,-176,4,1,248,252,-4
BR1_2731879255,9,True,1,0,0,19854,270,67,7.8,False,3,False,0,0,0,16537,227,64,7.4,True,28.6158,3317,6,1,337,291,46
BR1_2731754618,0,False,1,0,0,14909,241,58,7.2,False,5,True,0,0,0,17781,267,54,7.6,True,29.223866666666666,-2872,-5,1,299,321,-22
BR1_2724640484,4,False,0,1,0,15853,157,60,6.8,False,13,True,1,0,0,19750,218,64,7.2,True,29.6914,-3897,-9,-1,217,282,-65
BR1_2728595197,9,True,0,1,0,17095,168,56,6.8,False,7,False,1,0,0,17062,205,56,6.4,True,27.012016666666668,33,2,-1,224,261,-37
BR1_2728820524,7,True,0,0,0,18342,245,67,7.4,True,4,False,1,0,0,16193,225,44,7.2,False,28.041283333333332,2149,3,-1,312,269,43
BR1_2726170928,7,True,0,0,0,16400,207,52,6.8,False,3,False,0,0,0,15252,204,68,6.8,True,26.668316666666666,1148,4,0,259,272,-13
BR1_2729920753,5,False,0,0,0,17034,240,56,7.2,False,8,True,1,0,0,19367,249,63,7.4,True,28.0522,-2333,-3,-1,296,312,-16
BR1_2727556641,11,False,1,0,0,20264,211,68,7.0,True,8,True,0,0,0,19697,237,56,7.0,False,29.45875,567,3,1,279,293,-14
BR1_2731861023,13,True,1,0,0,20418,212,64,7.4,True,6,False,0,1,0,18303,206,64,7.0,False,29.62035,2115,7,1,276,270,6
BR1_2730847577,2,False,0,1,0,16481,247,72,7.4,False,8,True,1,0,0,18929,259,72,7.8,True,27.864933333333333,-2448,-6,-1,319,331,-12
BR1_2722534557,8,False,0,1,0,19749,239,56,7.4,False,7,True,0,0,0,19098,264,84,7.8,True,28.585266666666666,651,1,0,295,348,-53
BR1_2722089211,7,False,0,1,0,17564,211,60,7.2,False,10,True,1,0,0,20716,258,52,7.4,True,29.3433,-3152,-3,-1,271,310,-39
BR1_2727864785,5,False,1,1,0,15581,189,60,6.6,False,7,True,0,0,0,16981,226,60,6.8,True,26.271116666666668,-1400,-2,1,249,286,-37
BR1_2730201905,12,True,0,0,0,20292,232,52,7.4,False,10,False,1,1,0,20025,240,55,7.4,True,27.895,267,2,-1,284,295,-11
BR1_2726175380,2,True,1,0,0,16638,242,56,7.0,True,4,False,0,1,0,17133,238,56,7.4,False,28.976033333333334,-495,-2,1,298,294,4
BR1_2730767790,7,True,1,0,0,17066,237,67,7.0,True,3,False,0,0,0,14652,178,52,6.4,False,25.07015,2414,4,1,304,230,74
BR1_2728708132,7,False,0,0,0,17055,210,52,6.6,True,12,True,0,0,0,18849,206,48,6.6,False,26.319666666666667,-1794,-5,0,262,254,8
BR1_2731735979,15,True,0,1,0,21246,203,60,7.6,False,6,False,1,0,0,17403,195,52,7.0,True,27.522816666666667,3843,9,-1,263,247,16
BR1_2722490485,8,False,0,1,0,18972,224,64,7.6,True,9,True,0,0,0,17781,183,44,7.2,False,28.3509,1191,-1,0,288,227,61
BR1_2731807852,4,True,0,0,0,15217,218,60,6.8,False,2,False,1,0,0,14526,215,60,7.0,True,26.7709,691,2,-1,278,275,3
BR1_2728317010,6,False,1,1,0,18181,232,72,7.6,True,6,True,0,0,0,17918,242,56,7.2,False,28.950783333333334,263,0,1,304,298,6
BR1_2728292916,7,False,0,0,0,15795,168,50,6.4,True,7,True,0,0,0,17296,224,54,6.8,False,25.6694,-1501,0,0,218,278,-60
BR1_2726173919,6,False,1,0,0,16240,208,48,6.6,False,7,True,0,1,0,16197,199,48,6.8,True,26.6676,43,-1,1,256,247,9
BR1_2726147870,3,True,0,0,0,13936,194,35,6.4,False,4,False,1,0,0,14460,173,60,6.8,True,27.178566666666665,-524,-1,-1,229,233,-4
BR1_2730693808,15,False,1,0,0,21749,250,67,7.4,True,6,True,0,0,0,17640,240,53,7.0,False,29.220716666666668,4109,9,1,317,293,24
BR1_2731506491,10,True,1,0,0,18152,228,56,7.0,False,4,False,0,0,0,14870,193,40,6.8,True,26.094583333333333,3282,6,1,284,233,51
BR1_2730982599,2,False,1,0,0,14618,216,67,7.2,True,5,True,0,0,0,15731,198,64,7.0,False,27.42728333333333,-1113,-3,1,283,262,21
BR1_2730856268,11,False,0,0,0,19062,237,44,7.2,False,8,True,0,1,0,20103,239,56,7.4,True,29.403783333333333,-1041,3,0,281,295,-14
BR1_2723601267,4,False,0,0,0,14967,193,52,6.6,False,9,True,1,1,0,19141,219,64,7.2,True,26.651433333333333,-4174,-5,-1,245,283,-38
BR1_2731699529,12,False,1,1,0,20026,221,56,7.6,True,6,True,0,0,0,18649,230,56,7.2,False,28.5277,1377,6,1,277,286,-9
BR1_2730663648,4,False,0,1,0,15186,176,73,6.6,False,5,True,1,0,0,15690,188,40,6.6,True,26.37155,-504,-1,-1,249,228,21
BR1_2731960763,4,True,1,0,0,16181,228,48,7.0,True,2,False,0,0,0,14054,196,56,7.2,False,25.445933333333333,2127,2,1,276,252,24
BR1_2730833530,6,True,1,1,0,17154,223,52,6.8,True,6,False,0,0,0,15693,191,48,7.0,False,25.56886666666667,1461,0,1,275,239,36
BR1_2730257413,8,True,1,0,0,19154,220,68,7.4,True,6,False,0,1,1,19306,285,58,7.6,False,29.04085,-152,2,1,288,343,-55
BR1_2731502101,16,True,1,0,0,20218,229,60,7.2,True,7,False,0,0,0,16216,197,54,6.2,False,26.68905,4002,9,1,289,251,38
BR1_2730848052,10,True,1,0,0,17745,204,52,6.4,True,3,False,0,0,0,15085,205,60,6.6,False,25.989633333333334,2660,7,1,256,265,-9
BR1_2719289968,8,True,1,0,0,19519,256,64,7.6,True,5,False,0,1,0,17264,242,68,7.4,False,27.812366666666666,2255,3,1,320,310,10
BR1_2727984392,10,True,1,0,0,17925,220,56,7.4,False,4,False,0,0,0,15821,226,40,6.6,True,25.660033333333335,2104,6,1,276,266,10
BR1_2727955577,8,True,0,0,0,19198,228,60,7.4,True,2,False,1,0,0,15025,193,63,7.0,False,27.785233333333334,4173,6,-1,288,256,32
BR1_2728328305,2,False,0,1,0,14550,208,48,6.8,True,5,True,1,0,0,15273,183,68,6.8,False,25.376666666666665,-723,-3,-1,256,251,5
BR1_2731741527,6,True,0,1,0,18661,220,64,7.6,False,9,False,1,0,0,19911,249,76,7.8,True,28.7776,-1250,-3,-1,284,325,-41
BR1_2731533792,10,True,0,1,0,20205,237,66,7.4,False,7,False,1,0,0,17973,235,72,7.4,True,28.019666666666666,2232,3,-1,303,307,-4
BR1_2725178538,7,True,0,0,0,17133,233,40,6.8,True,6,False,0,0,0,15457,207,36,6.8,False,25.157416666666666,1676,1,0,273,243,30
BR1_2725153027,8,True,1,0,0,17829,213,56,7.4,True,5,False,0,0,0,15880,198,71,6.8,False,27.260383333333333,1949,3,1,269,269,0
BR1_2731748071,9,False,0,0,0,16973,181,48,6.8,False,9,True,1,1,0,19116,203,56,6.8,True,26.1053,-2143,0,-1,229,259,-30
BR1_2731363018,8,False,0,0,0,17361,201,60,7.2,False,11,True,0,0,0,20918,230,52,7.4,True,29.680633333333333,-3557,-3,0,261,282,-21
BR1_2725933591,13,False,1,0,0,18124,208,36,6.8,True,12,True,0,1,0,18965,184,60,6.8,False,27.296533333333333,-841,1,1,244,244,0
BR1_2731737109,6,True,0,1,0,17712,228,54,7.2,True,5,False,0,0,0,16904,213,60,7.4,False,29.894183333333334,808,1,0,282,273,9
BR1_2731710776,5,True,0,0,0,17124,218,56,7.0,True,6,False,1,0,0,15688,209,59,6.6,False,27.313666666666666,1436,-1,-1,274,268,6
BR1_2723255494,2,False,0,0,0,14687,225,52,7.0,False,5,True,1,0,0,16904,228,60,7.0,True,25.140533333333334,-2217,-3,-1,277,288,-11
BR1_2731684769,7,True,0,1,0,16542,202,60,6.8,True,4,False,1,0,0,14592,169,56,6.6,False,25.69375,1950,3,-1,262,225,37
BR1_2724876775,2,False,1,0,0,15950,249,68,7.2,False,10,True,0,1,0,19027,242,64,7.6,True,28.51096666666667,-3077,-8,1,317,306,11
BR1_2731229668,4,True,1,1,0,15781,189,72,7.2,True,2,False,0,0,0,14932,240,56,6.6,False,25.0206,849,2,1,261,296,-35
BR1_2729128946,8,True,0,1,0,19437,254,48,7.4,False,8,False,1,0,0,18404,231,64,7.2,True,27.804733333333335,1033,0,-1,302,295,7
BR1_2729086012,12,False,0,1,0,20309,238,56,7.4,True,8,True,0,0,0,17831,179,56,6.8,False,29.376916666666666,2478,4,0,294,235,59
BR1_2720843259,13,False,0,1,0,20793,238,51,7.8,True,8,True,1,0,0,17910,206,63,7.2,False,28.6399,2883,5,-1,289,269,20
BR1_2731078579,8,True,1,0,0,19064,218,65,7.0,True,5,False,0,0,0,16535,217,46,6.8,False,28.4379,2529,3,1,283,263,20
BR1_2731064558,9,False,0,0,0,16666,181,40,6.8,False,10,True,0,0,0,19485,227,48,7.0,True,25.037966666666666,-2819,-1,0,221,275,-54
BR1_2730625069,9,False,1,1,0,18296,215,52,7.0,True,2,True,0,0,0,14175,211,48,6.6,False,26.66655,4121,7,1,267,259,8
BR1_2731583591,8,False,0,0,0,19008,228,72,7.6,False,6,True,1,1,0,17332,212,64,7.4,True,29.42941666666667,1676,2,-1,300,276,24
BR1_2731526616,3,False,0,0,0,14735,203,56,6.6,False,11,True,0,1,0,18705,214,76,7.2,True,26.53933333333333,-3970,-8,0,259,290,-31
BR1_2725171000,7,True,0,1,0,17589,212,53,7.0,True,6,False,1,0,0,16381,196,54,7.0,False,25.542433333333335,1208,1,-1,265,250,15
BR1_2727070780,3,True,1,0,0,15609,210,64,6.8,False,3,False,0,1,0,15869,233,56,7.0,True,25.985016666666667,-260,0,1,274,289,-15
BR1_2727053330,9,False,1,1,0,19643,232,54,7.2,True,10,True,0,0,0,19362,232,57,7.4,False,29.58085,281,-1,1,286,289,-3
BR1_2729770848,3,True,0,0,0,15021,191,52,6.8,False,12,False,1,1,0,18381,184,60,7.2,True,25.466533333333334,-3360,-9,-1,243,244,-1
BR1_2731499295,12,False,0,0,0,21200,246,52,7.8,True,11,True,0,1,0,20449,234,64,7.8,False,27.517216666666666,751,1,0,298,298,0
BR1_2730583442,5,False,0,0,0,15698,232,48,6.8,False,4,True,1,1,0,15301,196,56,6.8,True,27.3938,397,1,-1,280,252,28
BR1_2731620398,1,False,0,0,0,13799,206,48,6.6,False,6,True,1,0,0,17014,211,59,6.8,True,25.08745,-3215,-5,-1,254,270,-16
BR1_2730561556,11,True,1,1,0,19189,231,56,7.2,True,4,False,0,0,0,15214,208,48,6.4,False,25.8236,3975,7,1,287,256,31
BR1_2729584980,7,False,1,0,0,16220,204,44,6.4,True,3,True,0,0,0,15139,183,68,6.4,False,25.79065,1081,4,1,248,251,-3
BR1_2729526469,8,False,0,1,0,18847,194,72,7.0,False,8,True,1,0,0,18084,194,48,7.0,True,29.79928333333333,763,0,-1,266,242,24
BR1_2725127707,4,True,0,0,0,16181,254,56,7.0,True,2,False,1,0,0,14128,216,52,6.8,False,25.087616666666666,2053,2,-1,310,268,42
BR1_2725255924,7,False,0,0,0,17448,212,56,6.6,False,9,True,1,0,0,16878,172,40,6.6,True,25.281116666666666,570,-2,-1,268,212,56
BR1_2722685830,5,False,0,0,0,17004,223,52,6.8,True,5,True,1,0,0,16325,202,60,6.8,False,27.152283333333333,679,0,-1,275,262,13
BR1_2722679487,6,True,0,0,0,16984,213,52,7.2,True,3,False,1,0,0,14554,189,40,6.6,False,25.418983333333333,2430,3,-1,265,229,36
BR1_2731972237,12,True,0,0,0,19939,214,64,7.2,True,4,False,1,0,0,15939,226,44,6.8,False,27.71705,4000,8,-1,278,270,8
BR1_2731955240,7,True,0,1,0,19466,284,64,7.4,False,4,False,1,0,0,16717,263,60,7.2,True,29.58181666666667,2749,3,-1,348,323,25
BR1_2728380602,0,False,0,1,0,14756,231,64,7.4,False,4,True,1,0,0,19302,275,75,7.6,True,28.796083333333332,-4546,-4,-1,295,350,-55
BR1_2723927477,7,True,1,1,1,18952,220,60,7.0,True,5,False,0,0,0,16356,207,43,6.6,False,27.051716666666668,2596,2,1,280,250,30
BR1_2731364492,3,False,1,0,0,17593,253,68,7.6,False,6,True,0,0,0,18583,262,64,7.6,True,28.91875,-990,-3,1,321,326,-5
BR1_2731667396,7,True,1,0,0,16928,221,63,7.2,True,1,False,0,0,0,14675,226,64,7.0,False,25.90045,2253,6,1,284,290,-6
BR1_2731644471,5,True,1,0,0,16215,221,56,7.0,True,2,False,0,0,0,14501,210,68,7.0,False,27.406816666666668,1714,3,1,277,278,-1
BR1_2721854442,14,False,0,0,0,21526,271,60,7.8,True,7,True,0,0,0,18635,222,59,7.0,False,29.206416666666666,2891,7,0,331,281,50
BR1_2721761645,12,False,0,0,0,19323,181,32,6.6,False,18,True,0,0,0,20724,159,40,6.4,True,26.803766666666668,-1401,-6,0,213,199,14
BR1_2729443622,6,False,0,1,0,18593,241,64,7.4,False,11,True,1,0,0,20398,270,52,7.6,True,29.4956,-1805,-5,-1,305,322,-17
BR1_2729371843,9,True,0,1,0,20884,261,64,7.8,True,3,False,1,0,0,16409,241,60,7.2,False,28.851583333333334,4475,6,-1,325,301,24
BR1_2729348792,5,False,1,0,0,15615,185,64,6.4,True,5,True,0,0,0,15171,198,48,6.4,False,26.151,444,0,1,249,246,3
BR1_2730043518,14,False,0,0,0,20644,225,36,7.4,True,10,True,0,0,0,17795,202,46,7.0,False,28.540216666666666,2849,4,0,261,248,13
BR1_2726923336,10,True,0,0,0,19359,217,68,7.6,False,7,False,1,1,0,17970,248,62,7.6,True,29.009766666666668,1389,3,-1,285,310,-25
BR1_2730219510,13,True,1,0,0,19016,203,64,7.0,False,9,False,0,0,0,16752,181,56,6.8,True,27.100916666666667,2264,4,1,267,237,30
BR1_2726359759,10,True,0,1,0,19181,216,88,7.4,True,5,False,1,0,0,16229,207,56,6.8,False,26.479016666666666,2952,5,-1,304,263,41
BR1_2720852247,8,True,0,0,0,17105,212,32,6.8,False,12,False,1,0,0,19466,206,64,6.8,True,26.94025,-2361,-4,-1,244,270,-26
BR1_2726799401,2,True,0,1,0,16976,264,68,7.6,True,0,False,1,0,0,15825,267,72,7.6,False,29.05205,1151,2,-1,332,339,-7
BR1_2731028631,9,True,0,1,0,18741,262,36,7.8,False,10,False,1,0,0,19582,254,48,7.4,True,27.93723333333333,-841,-1,-1,298,302,-4
BR1_2731768340,7,False,0,0,0,15894,177,32,6.2,False,3,True,0,1,0,15024,193,48,6.2,True,26.1995,870,4,0,209,241,-32
BR1_2731256278,11,False,1,0,0,18747,205,52,7.0,False,6,True,0,1,0,18380,212,52,7.0,True,27.5227,367,5,1,257,264,-7
BR1_2730793396,7,True,0,0,0,16469,216,56,7.0,True,10,False,0,0,0,17155,187,52,7.0,False,25.018233333333335,-686,-3,0,272,239,33
BR1_2723643153,5,False,1,0,0,15724,204,52,6.6,True,6,True,0,0,0,16406,233,40,6.8,False,27.210383333333333,-682,-1,1,256,273,-17
BR1_2731482532,7,True,1,1,0,19642,235,78,7.6,True,9,False,0,0,0,18620,219,52,7.2,False,29.454666666666668,1022,-2,1,313,271,42
BR1_2731525889,9,True,0,0,0,19218,249,56,7.6,False,5,False,1,1,0,17647,251,60,7.8,True,27.686983333333334,1571,4,-1,305,311,-6
BR1_2730635474,6,False,0,1,0,17968,244,56,7.0,False,12,True,1,0,0,19689,227,54,7.0,True,28.1524,-1721,-6,-1,300,281,19
BR1_2720967880,4,False,1,1,0,17652,224,72,7.4,True,7,True,0,0,0,19205,243,64,7.6,False,28.144216666666665,-1553,-3,1,296,307,-11
BR1_2731932982,7,True,1,0,0,16953,226,56,6.8,True,4,False,0,0,0,15336,200,56,6.8,False,26.73925,1617,3,1,282,256,26
BR1_2731920865,6,False,0,0,0,18156,227,45,7.4,False,14,True,1,0,0,21619,261,74,7.8,True,28.16375,-3463,-8,-1,272,335,-63
